,root_id,hemisphere,type,column_id,x,y,p,q,coords
0,720575940603042272,right,Mi1,1,-6,13,12,1,"-6,13"
1,720575940603200428,right,Mi1,2,-8,2,9,-7,"-8,2"
2,720575940603327916,right,Mi1,3,6,-12,-12,0,"6,-12"
3,720575940603935334,right,Mi1,4,-5,-21,-6,-15,"-5,-21"
4,720575940633953965,right,Mi1,5,-1,16,9,7,"-1,16"
5,720575940604151008,right,Mi1,6,-2,-4,0,-4,"-2,-4"
6,720575940604191456,right,Mi1,7,-6,-6,3,-9,"-6,-6"
7,720575940604255712,right,Mi1,8,-4,26,17,9,"-4,26"
8,720575940604508332,right,Mi1,9,4,9,0,9,"4,9"
9,720575940604687532,right,Mi1,10,5,-15,-13,-2,"5,-15"
10,720575940604714929,right,Mi1,11,7,-14,-14,0,"7,-14"
11,720575940604947657,right,Mi1,12,-7,9,11,-2,"-7,9"
12,720575940605029856,right,Mi1,13,-1,-26,-12,-14,"-1,-26"
13,720575940638990911,right,Mi1,14,0,-27,-14,-13,"0,-27"
14,720575940605215665,right,Mi1,15,2,-3,-4,1,"2,-3"
15,720575940605262880,right,Mi1,16,-2,-16,-6,-10,"-2,-16"
16,720575940630193255,right,Mi1,17,1,-5,-4,-1,"1,-5"
17,720575940605478321,right,Mi1,18,5,-16,-13,-3,"5,-16"
18,720575940606042814,right,Mi1,19,-7,17,15,2,"-7,17"
19,720575940613120741,right,Mi1,20,3,-11,-9,-2,"3,-11"
20,720575940606333385,right,Mi1,21,-2,19,11,8,"-2,19"
21,720575940606654386,right,Mi1,22,-1,3,2,1,"-1,3"
22,720575940606665564,right,Mi1,23,-3,-16,-5,-11,"-3,-16"
23,720575940606712777,right,Mi1,24,-1,-10,-4,-6,"-1,-10"
24,720575940606721801,right,Mi1,25,-9,3,10,-7,"-9,3"
25,720575940606944898,right,Mi1,26,1,-3,-3,0,"1,-3"
26,720575940636050271,right,Mi1,27,0,-25,-13,-12,"0,-25"
27,720575940607385283,right,Mi1,28,5,6,-2,8,"5,6"
28,720575940607730780,right,Mi1,29,-1,-3,-1,-2,"-1,-3"
29,720575940607787138,right,Mi1,30,6,16,2,14,"6,16"
30,720575940608157635,right,Mi1,31,0,16,8,8,"0,16"
31,720575940608211780,right,Mi1,32,0,12,6,6,"0,12"
32,720575940608278281,right,Mi1,33,3,18,6,12,"3,18"
33,720575940608309771,right,Mi1,34,6,18,3,15,"6,18"
34,720575940629485041,right,Mi1,35,1,-24,-13,-11,"1,-24"
35,720575940608431061,right,Mi1,36,6,8,-2,10,"6,8"
36,720575940608553155,right,Mi1,37,1,5,1,4,"1,5"
37,720575940608810798,right,Mi1,38,0,-2,-1,-1,"0,-2"
38,720575940608927534,right,Mi1,39,0,20,10,10,"0,20"
39,720575940609063800,right,Mi1,40,-2,-6,-1,-5,"-2,-6"
40,720575940620343000,right,Mi1,41,-3,28,17,11,"-3,28"
41,720575940609453010,right,Mi1,42,-1,14,8,6,"-1,14"
42,720575940609463620,right,Mi1,43,-5,18,14,4,"-5,18"
43,720575940609555406,right,Mi1,44,5,-10,-10,0,"5,-10"
44,720575940610007598,right,Mi1,45,-5,-1,4,-5,"-5,-1"
45,720575940610177941,right,Mi1,46,-5,15,12,3,"-5,15"
46,720575940618350804,right,Mi1,47,-9,-1,8,-9,"-9,-1"
47,720575940610277956,right,Mi1,48,-4,-22,-7,-15,"-4,-22"
48,720575940610316664,right,Mi1,49,4,-4,-6,2,"4,-4"
49,720575940610418296,right,Mi1,50,-2,21,12,9,"-2,21"
50,720575940639131876,right,Mi1,51,0,-19,-10,-9,"0,-19"
51,720575940610438898,right,Mi1,52,-1,-22,-10,-12,"-1,-22"
52,720575940610460402,right,Mi1,53,5,14,2,12,"5,14"
53,720575940610533582,right,Mi1,54,-4,3,5,-2,"-4,3"
54,720575940629500777,right,Mi1,55,-4,-11,-2,-9,"-4,-11"
55,720575940610578786,right,Mi1,56,1,-13,-8,-5,"1,-13"
56,720575940610580578,right,Mi1,57,6,-11,-12,1,"6,-11"
57,720575940610674090,right,Mi1,58,3,12,3,9,"3,12"
58,720575940610695338,right,Mi1,59,-2,2,3,-1,"-2,2"
59,720575940610739882,right,Mi1,60,-8,8,12,-4,"-8,8"
60,720575940610740394,right,Mi1,61,-4,-4,2,-6,"-4,-4"
61,720575940617264245,right,Mi1,62,0,-29,-15,-14,"0,-29"
62,720575940610772174,right,Mi1,63,4,12,2,10,"4,12"
63,720575940610903854,right,Mi1,64,4,-23,-16,-7,"4,-23"
64,720575940614850088,right,Mi1,65,-1,28,15,13,"-1,28"
65,720575940610952198,right,Mi1,66,2,15,5,10,"2,15"
66,720575940610952982,right,Mi1,67,-2,-13,-5,-8,"-2,-13"
67,720575940610953478,right,Mi1,68,3,16,5,11,"3,16"
68,720575940610979590,right,Mi1,69,1,8,3,5,"1,8"
69,720575940611054798,right,Mi1,70,-4,21,14,7,"-4,21"
70,720575940611126648,right,Mi1,71,-2,-3,0,-3,"-2,-3"
71,720575940629277289,right,Mi1,72,0,-28,-14,-14,"0,-28"
72,720575940617282747,right,Mi1,73,2,2,-1,3,"2,2"
73,720575940611216867,right,Mi1,74,-1,-9,-4,-5,"-1,-9"
74,720575940611352469,right,Mi1,75,-6,14,13,1,"-6,14"
75,720575940611361378,right,Mi1,76,-3,-4,1,-5,"-3,-4"
76,720575940611362965,right,Mi1,77,2,-5,-5,0,"2,-5"
77,720575940619780731,right,Mi1,78,2,20,8,12,"2,20"
78,720575940611489746,right,Mi1,79,2,1,-2,3,"2,1"
79,720575940611524835,right,Mi1,80,4,13,2,11,"4,13"
80,720575940611551857,right,Mi1,81,6,-2,-7,5,"6,-2"
81,720575940611625238,right,Mi1,82,-7,7,10,-3,"-7,7"
82,720575940611685489,right,Mi1,83,2,-21,-13,-8,"2,-21"
83,720575940611686513,right,Mi1,84,-2,12,8,4,"-2,12"
84,720575940611704689,right,Mi1,85,4,-22,-15,-7,"4,-22"
85,720575940611751347,right,Mi1,86,-5,-7,1,-8,"-5,-7"
86,720575940611778290,right,Mi1,87,1,11,4,7,"1,11"
87,720575940611780450,right,Mi1,88,7,4,-5,9,"7,4"
88,720575940611838577,right,Mi1,89,1,-19,-11,-8,"1,-19"
89,720575940611882725,right,Mi1,90,-4,5,6,-1,"-4,5"
90,720575940611884773,right,Mi1,91,-1,6,4,2,"-1,6"
91,720575940612031694,right,Mi1,92,0,9,4,5,"0,9"
92,720575940612109619,right,Mi1,93,-6,3,7,-4,"-6,3"
93,720575940612162227,right,Mi1,94,5,18,4,14,"5,18"
94,720575940612334810,right,Mi1,95,4,-21,-15,-6,"4,-21"
95,720575940612352114,right,Mi1,96,1,-10,-6,-4,"1,-10"
96,720575940612393000,right,Mi1,97,-5,2,6,-4,"-5,2"
97,720575940612410481,right,Mi1,98,-1,-12,-5,-7,"-1,-12"
98,720575940612556438,right,Mi1,99,4,15,3,12,"4,15"
99,720575940612562525,right,Mi1,100,2,-10,-7,-3,"2,-10"
100,720575940612727550,right,Mi1,101,-7,6,10,-4,"-7,6"
101,720575940637260133,right,Mi1,102,3,13,3,10,"3,13"
102,720575940627920792,right,Mi1,103,7,9,-3,12,"7,9"
103,720575940612855219,right,Mi1,104,-1,-27,-13,-14,"-1,-27"
104,720575940612944298,right,Mi1,105,3,22,8,14,"3,22"
105,720575940613073918,right,Mi1,106,-7,11,12,-1,"-7,11"
106,720575940613127574,right,Mi1,107,8,-2,-9,7,"8,-2"
107,720575940630446970,right,Mi1,108,-3,-12,-3,-9,"-3,-12"
108,720575940613416744,right,Mi1,109,4,-5,-7,2,"4,-5"
109,720575940629500265,right,Mi1,110,-7,0,7,-7,"-7,0"
110,720575940613616559,right,Mi1,111,2,-24,-14,-10,"2,-24"
111,720575940613638290,right,Mi1,112,-6,1,6,-5,"-6,1"
112,720575940613676975,right,Mi1,113,-2,4,4,0,"-2,4"
113,720575940613700305,right,Mi1,114,2,-13,-9,-4,"2,-13"
114,720575940613709983,right,Mi1,115,-4,2,5,-3,"-4,2"
115,720575940613857251,right,Mi1,116,-1,-8,-3,-5,"-1,-8"
116,720575940613919135,right,Mi1,117,-8,-2,7,-9,"-8,-2"
117,720575940635540887,right,Mi1,118,3,1,-3,4,"3,1"
118,720575940613956242,right,Mi1,119,-2,6,5,1,"-2,6"
119,720575940613994898,right,Mi1,120,-1,-1,0,-1,"-1,-1"
120,720575940614047500,right,Mi1,121,-8,4,10,-6,"-8,4"
121,720575940614104774,right,Mi1,122,-5,9,9,0,"-5,9"
122,720575940640879779,right,Mi1,123,-8,10,13,-3,"-8,10"
123,720575940625061885,right,Mi1,124,1,-7,-5,-2,"1,-7"
124,720575940614212258,right,Mi1,125,5,9,-1,10,"5,9"
125,720575940614282134,right,Mi1,126,3,11,2,9,"3,11"
126,720575940614448059,right,Mi1,127,0,15,7,8,"0,15"
127,720575940614486782,right,Mi1,128,3,-22,-14,-8,"3,-22"
128,720575940614503285,right,Mi1,129,0,-13,-7,-6,"0,-13"
129,720575940614518678,right,Mi1,130,2,12,4,8,"2,12"
130,720575940614545851,right,Mi1,131,-6,20,16,4,"-6,20"
131,720575940614570705,right,Mi1,132,2,4,0,4,"2,4"
132,720575940614650163,right,Mi1,133,-3,20,13,7,"-3,20"
133,720575940622000993,right,Mi1,134,-5,-18,-4,-14,"-5,-18"
134,720575940614750870,right,Mi1,135,-3,-22,-8,-14,"-3,-22"
135,720575940614779026,right,Mi1,136,0,3,1,2,"0,3"
136,720575940606057900,right,Mi1,137,5,-7,-9,2,"5,-7"
137,720575940614924946,right,Mi1,138,0,27,13,14,"0,27"
138,720575940614935249,right,Mi1,139,1,-14,-8,-6,"1,-14"
139,720575940631369078,right,Mi1,140,3,8,1,7,"3,8"
140,720575940614968938,right,Mi1,141,5,-23,-17,-6,"5,-23"
141,720575940621337025,right,Mi1,142,-2,-18,-7,-11,"-2,-18"
142,720575940615088034,right,Mi1,143,-4,16,12,4,"-4,16"
143,720575940628423592,right,Mi1,144,7,-11,-13,2,"7,-11"
144,720575940615266866,right,Mi1,145,0,4,2,2,"0,4"
145,720575940615279419,right,Mi1,146,1,-6,-4,-2,"1,-6"
146,720575940615420358,right,Mi1,147,1,21,9,12,"1,21"
147,720575940615649366,right,Mi1,148,-7,-11,1,-12,"-7,-11"
148,720575940615658713,right,Mi1,149,6,-14,-13,-1,"6,-14"
149,720575940615702621,right,Mi1,150,-8,5,10,-5,"-8,5"
150,720575940615811807,right,Mi1,151,-3,-14,-4,-10,"-3,-14"
151,720575940615836450,right,Mi1,152,3,-15,-11,-4,"3,-15"
152,720575940615908353,right,Mi1,153,8,0,-8,8,"8,0"
153,720575940615912916,right,Mi1,154,-8,0,8,-8,"-8,0"
154,720575940630600951,right,Mi1,155,-8,13,14,-1,"-8,13"
155,720575940616085917,right,Mi1,156,-9,1,9,-8,"-9,1"
156,720575940616095259,right,Mi1,157,-1,-7,-3,-4,"-1,-7"
157,720575940616097653,right,Mi1,158,3,-5,-6,1,"3,-5"
158,720575940613102053,right,Mi1,159,7,7,-4,11,"7,7"
159,720575940616111221,right,Mi1,160,-2,20,12,8,"-2,20"
160,720575940618902811,right,Mi1,161,4,-14,-11,-3,"4,-14"
161,720575940616168276,right,Mi1,162,-4,-2,3,-5,"-4,-2"
162,720575940616176852,right,Mi1,163,-9,7,12,-5,"-9,7"
163,720575940616304925,right,Mi1,164,-1,-2,0,-2,"-1,-2"
164,720575940616367133,right,Mi1,165,4,16,4,12,"4,16"
165,720575940616496102,right,Mi1,166,0,18,9,9,"0,18"
166,720575940616553541,right,Mi1,167,0,-17,-9,-8,"0,-17"
167,720575940616558405,right,Mi1,168,-1,17,9,8,"-1,17"
168,720575940616572992,right,Mi1,169,0,-18,-9,-9,"0,-18"
169,720575940616748096,right,Mi1,170,-5,1,5,-4,"-5,1"
170,720575940616787061,right,Mi1,171,6,-20,-16,-4,"6,-20"
171,720575940628618920,right,Mi1,172,1,22,10,12,"1,22"
172,720575940628729617,right,Mi1,173,2,-25,-15,-10,"2,-25"
173,720575940617027257,right,Mi1,174,4,-15,-12,-3,"4,-15"
174,720575940617029009,right,Mi1,175,-6,-7,2,-9,"-6,-7"
175,720575940617037969,right,Mi1,176,-2,13,8,5,"-2,13"
176,720575940617076258,right,Mi1,177,-2,-1,1,-2,"-2,-1"
177,720575940609758217,right,Mi1,178,2,11,3,8,"2,11"
178,720575940617213557,right,Mi1,179,-5,-16,-3,-13,"-5,-16"
179,720575940617320331,right,Mi1,180,2,-27,-16,-11,"2,-27"
180,720575940628314643,right,Mi1,181,1,-4,-3,-1,"1,-4"
181,720575940617449506,right,Mi1,182,7,-10,-12,2,"7,-10"
182,720575940617509716,right,Mi1,183,-5,-15,-3,-12,"-5,-15"
183,720575940617578267,right,Mi1,184,-6,-5,3,-8,"-6,-5"
184,720575940617620509,right,Mi1,185,2,-11,-8,-3,"2,-11"
185,720575940617637204,right,Mi1,186,-1,26,14,12,"-1,26"
186,720575940617817693,right,Mi1,187,3,21,7,14,"3,21"
187,720575940617839832,right,Mi1,188,-5,17,13,4,"-5,17"
188,720575940617882342,right,Mi1,189,6,13,0,13,"6,13"
189,720575940636293739,right,Mi1,190,-3,-5,0,-5,"-3,-5"
190,720575940613508210,right,Mi1,191,-1,-11,-5,-6,"-1,-11"
191,720575940618995028,right,Mi1,192,7,10,-2,12,"7,10"
192,720575940618013745,right,Mi1,193,-5,4,7,-3,"-5,4"
193,720575940622893150,right,Mi1,194,0,-5,-3,-2,"0,-5"
194,720575940618148766,right,Mi1,195,-3,-1,2,-3,"-3,-1"
195,720575940618156702,right,Mi1,196,-1,8,5,3,"-1,8"
196,720575940606398240,right,Mi1,197,0,-20,-10,-10,"0,-20"
197,720575940638102384,right,Mi1,198,6,2,-5,7,"6,2"
198,720575940627088330,right,Mi1,199,0,-12,-6,-6,"0,-12"
199,720575940618358838,right,Mi1,200,-5,12,11,1,"-5,12"
200,720575940618364325,right,Mi1,201,-8,9,12,-3,"-8,9"
201,720575940618389054,right,Mi1,202,-1,27,14,13,"-1,27"
202,720575940618420278,right,Mi1,203,3,-1,-4,3,"3,-1"
203,720575940618490782,right,Mi1,204,5,-2,-6,4,"5,-2"
204,720575940618491038,right,Mi1,205,5,-6,-8,2,"5,-6"
205,720575940628589032,right,Mi1,206,-3,5,5,0,"-3,5"
206,720575940618710813,right,Mi1,207,1,29,13,16,"1,29"
207,720575940618728606,right,Mi1,208,5,-21,-16,-5,"5,-21"
208,720575940618739136,right,Mi1,209,-3,-8,-1,-7,"-3,-8"
209,720575940618795099,right,Mi1,210,-6,8,10,-2,"-6,8"
210,720575940618826314,right,Mi1,211,-7,-1,6,-7,"-7,-1"
211,720575940628637672,right,Mi1,212,2,-16,-10,-6,"2,-16"
212,720575940619121713,right,Mi1,213,3,-4,-5,1,"3,-4"
213,720575940619213771,right,Mi1,214,-5,3,6,-3,"-5,3"
214,720575940627967101,right,Mi1,215,6,7,-3,10,"6,7"
215,720575940619265140,right,Mi1,216,2,19,7,12,"2,19"
216,720575940619308653,right,Mi1,217,6,15,1,14,"6,15"
217,720575940619962422,right,Mi1,218,2,10,3,7,"2,10"
218,720575940619471440,right,Mi1,219,6,-4,-8,4,"6,-4"
219,720575940619519061,right,Mi1,220,2,-6,-5,-1,"2,-6"
220,720575940619619510,right,Mi1,221,-7,3,8,-5,"-7,3"
221,720575940619624374,right,Mi1,222,-3,26,16,10,"-3,26"
222,720575940619624630,right,Mi1,223,-2,26,15,11,"-2,26"
223,720575940636275124,right,Mi1,224,0,5,2,3,"0,5"
224,720575940636051551,right,Mi1,225,2,-26,-15,-11,"2,-26"
225,720575940619876890,right,Mi1,226,5,19,4,15,"5,19"
226,720575940619905919,right,Mi1,227,-7,5,9,-4,"-7,5"
227,720575940619944360,right,Mi1,228,-7,1,7,-6,"-7,1"
228,720575940627757208,right,Mi1,229,5,2,-4,6,"5,2"
229,720575940619967435,right,Mi1,230,2,9,2,7,"2,9"
230,720575940619977087,right,Mi1,231,4,-12,-10,-2,"4,-12"
231,720575940619997121,right,Mi1,232,-4,13,10,3,"-4,13"
232,720575940627723416,right,Mi1,233,4,-13,-11,-2,"4,-13"
233,720575940632787816,right,Mi1,234,1,3,0,3,"1,3"
234,720575940647860532,right,Mi1,235,4,11,1,10,"4,11"
235,720575940620101870,right,Mi1,236,-1,4,3,1,"-1,4"
236,720575940620115541,right,Mi1,237,-2,27,15,12,"-2,27"
237,720575940631284342,right,Mi1,238,-8,-3,6,-9,"-8,-3"
238,720575940632129295,right,Mi1,239,-6,6,9,-3,"-6,6"
239,720575940620139781,right,Mi1,240,-4,-3,2,-5,"-4,-3"
240,720575940620159960,right,Mi1,241,2,-17,-11,-6,"2,-17"
241,720575940620183066,right,Mi1,242,-4,6,7,-1,"-4,6"
242,720575940620210014,right,Mi1,243,-1,-21,-10,-11,"-1,-21"
243,720575940620233899,right,Mi1,244,-4,-12,-2,-10,"-4,-12"
244,720575940620298754,right,Mi1,245,-5,-3,3,-6,"-5,-3"
245,720575940615240103,right,Mi1,246,-4,15,11,4,"-4,15"
246,720575940620415568,right,Mi1,247,-4,-15,-4,-11,"-4,-15"
247,720575940632932143,right,Mi1,248,-6,0,6,-6,"-6,0"
248,720575940620462177,right,Mi1,249,2,-12,-8,-4,"2,-12"
249,720575940643285645,right,Mi1,250,-1,1,1,0,"-1,1"
250,720575940620500801,right,Mi1,251,-1,-14,-6,-8,"-1,-14"
251,720575940620525076,right,Mi1,252,3,23,8,15,"3,23"
252,720575940620552973,right,Mi1,253,5,16,3,13,"5,16"
253,720575940620655854,right,Mi1,254,3,-24,-15,-9,"3,-24"
254,720575940620728710,right,Mi1,255,-6,-13,-1,-12,"-6,-13"
255,720575940620739494,right,Mi1,256,5,-20,-15,-5,"5,-20"
256,720575940622913285,right,Mi1,257,2,21,8,13,"2,21"
257,720575940620780270,right,Mi1,258,-4,-17,-5,-12,"-4,-17"
258,720575940620811892,right,Mi1,259,-7,-5,4,-9,"-7,-5"
259,720575940620826900,right,Mi1,260,-3,19,12,7,"-3,19"
260,720575940620857776,right,Mi1,261,-1,13,7,6,"-1,13"
261,720575940620859574,right,Mi1,262,1,-11,-7,-4,"1,-11"
262,720575940620916389,right,Mi1,263,-3,4,5,-1,"-3,4"
263,720575940620922644,right,Mi1,264,-1,-6,-2,-4,"-1,-6"
264,720575940621003457,right,Mi1,265,-6,-1,5,-6,"-6,-1"
265,720575940621096686,right,Mi1,266,-1,-25,-12,-13,"-1,-25"
266,720575940621304229,right,Mi1,267,-6,2,7,-5,"-6,2"
267,720575940621181424,right,Mi1,268,7,-6,-10,4,"7,-6"
268,720575940621183624,right,Mi1,269,2,-19,-12,-7,"2,-19"
269,720575940621189358,right,Mi1,270,1,-8,-5,-3,"1,-8"
270,720575940629040714,right,Mi1,271,4,6,-1,7,"4,6"
271,720575940623946851,right,Mi1,272,3,-2,-4,2,"3,-2"
272,720575940621252451,right,Mi1,273,-6,23,17,6,"-6,23"
273,720575940621263014,right,Mi1,274,6,4,-4,8,"6,4"
274,720575940619899294,right,Mi1,275,-8,-1,7,-8,"-8,-1"
275,720575940621269603,right,Mi1,276,2,3,-1,4,"2,3"
276,720575940616848140,right,Mi1,277,7,-3,-9,6,"7,-3"
277,720575940644639904,right,Mi1,278,-5,10,10,0,"-5,10"
278,720575940621308912,right,Mi1,279,-4,8,8,0,"-4,8"
279,720575940621314440,right,Mi1,280,-6,-14,-1,-13,"-6,-14"
280,720575940621321608,right,Mi1,281,-9,2,10,-8,"-9,2"
281,720575940621447350,right,Mi1,282,0,26,13,13,"0,26"
282,720575940621491226,right,Mi1,283,-4,4,6,-2,"-4,4"
283,720575940621505718,right,Mi1,284,0,25,12,13,"0,25"
284,720575940621526655,right,Mi1,285,6,-18,-15,-3,"6,-18"
285,720575940621528703,right,Mi1,286,0,-24,-12,-12,"0,-24"
286,720575940621548543,right,Mi1,287,-5,13,11,2,"-5,13"
287,720575940637238373,right,Mi1,288,-1,30,16,14,"-1,30"
288,720575940621585276,right,Mi1,289,-1,11,6,5,"-1,11"
289,720575940639022911,right,Mi1,290,5,-24,-17,-7,"5,-24"
290,720575940621643132,right,Mi1,291,7,2,-6,8,"7,2"
291,720575940621647996,right,Mi1,292,-4,18,13,5,"-4,18"
292,720575940621683973,right,Mi1,293,4,-17,-13,-4,"4,-17"
293,720575940618392157,right,Mi1,294,1,-20,-11,-9,"1,-20"
294,720575940621723283,right,Mi1,295,-2,29,16,13,"-2,29"
295,720575940660975745,right,Mi1,296,1,-18,-10,-8,"1,-18"
296,720575940621756336,right,Mi1,297,7,-9,-12,3,"7,-9"
297,720575940621852042,right,Mi1,298,-5,5,7,-2,"-5,5"
298,720575940621902674,right,Mi1,299,-4,12,10,2,"-4,12"
299,720575940630416766,right,Mi1,300,4,-18,-13,-5,"4,-18"
300,720575940621959185,right,Mi1,301,-5,16,13,3,"-5,16"
301,720575940622033110,right,Mi1,302,2,17,6,11,"2,17"
302,720575940622087245,right,Mi1,303,-5,22,16,6,"-5,22"
303,720575940619393349,right,Mi1,304,6,5,-4,9,"6,5"
304,720575940622206442,right,Mi1,305,-7,4,9,-5,"-7,4"
305,720575940626861712,right,Mi1,306,3,7,0,7,"3,7"
306,720575940622211241,right,Mi1,307,5,-25,-18,-7,"5,-25"
307,720575940621699521,right,Mi1,308,-5,8,9,-1,"-5,8"
308,720575940622263815,right,Mi1,309,-6,12,12,0,"-6,12"
309,720575940625383944,right,Mi1,310,2,22,9,13,"2,22"
310,720575940622286669,right,Mi1,311,-7,15,14,1,"-7,15"
311,720575940622304895,right,Mi1,312,4,-7,-8,1,"4,-7"
312,720575940622447344,right,Mi1,313,7,3,-6,9,"7,3"
313,720575940622468681,right,Mi1,314,-9,5,11,-6,"-9,5"
314,720575940622490381,right,Mi1,315,-3,-6,0,-6,"-3,-6"
315,720575940622516104,right,Mi1,316,5,-4,-7,3,"5,-4"
316,720575940627216484,right,Mi1,317,-5,-4,3,-7,"-5,-4"
317,720575940622617736,right,Mi1,318,4,-19,-14,-5,"4,-19"
318,720575940622622502,right,Mi1,319,-2,5,4,1,"-2,5"
319,720575940622697992,right,Mi1,320,-2,-5,-1,-4,"-2,-5"
320,720575940622718344,right,Mi1,321,8,4,-6,10,"8,4"
321,720575940622747772,right,Mi1,322,2,26,11,15,"2,26"
322,720575940615261235,right,Mi1,323,-7,-13,0,-13,"-7,-13"
323,720575940622780118,right,Mi1,324,3,24,9,15,"3,24"
324,720575940622838408,right,Mi1,325,5,1,-5,6,"5,1"
325,720575940622864169,right,Mi1,326,2,16,6,10,"2,16"
326,720575940622930019,right,Mi1,327,5,3,-4,7,"5,3"
327,720575940622933444,right,Mi1,328,5,-9,-10,1,"5,-9"
328,720575940622954189,right,Mi1,329,0,24,12,12,"0,24"
329,720575940623989247,right,Mi1,330,3,3,-2,5,"3,3"
330,720575940622977791,right,Mi1,331,1,-15,-9,-6,"1,-15"
331,720575940621269696,right,Mi1,332,4,-26,-17,-9,"4,-26"
332,720575940623160614,right,Mi1,333,0,-21,-11,-10,"0,-21"
333,720575940623221774,right,Mi1,334,1,-26,-14,-12,"1,-26"
334,720575940633004359,right,Mi1,335,2,8,2,6,"2,8"
335,720575940623328184,right,Mi1,336,0,23,11,12,"0,23"
336,720575940623530032,right,Mi1,337,-5,-6,2,-8,"-5,-6"
337,720575940623566472,right,Mi1,338,-1,0,1,-1,"-1,0"
338,720575940623571555,right,Mi1,339,6,11,-1,12,"6,11"
339,720575940623604149,right,Mi1,340,-4,17,12,5,"-4,17"
340,720575940623627460,right,Mi1,341,6,-17,-15,-2,"6,-17"
341,720575940623628105,right,Mi1,342,2,-15,-10,-5,"2,-15"
342,720575940630505463,right,Mi1,343,-3,27,16,11,"-3,27"
343,720575940623666320,right,Mi1,344,-2,-15,-6,-9,"-2,-15"
344,720575940629077191,right,Mi1,345,3,-12,-9,-3,"3,-12"
345,720575940623738365,right,Mi1,346,-7,-9,2,-11,"-7,-9"
346,720575940621407470,right,Mi1,347,-5,-13,-2,-11,"-5,-13"
347,720575940631147484,right,Mi1,348,3,14,4,10,"3,14"
348,720575940623820523,right,Mi1,349,-5,-14,-2,-12,"-5,-14"
349,720575940623877828,right,Mi1,350,1,15,6,9,"1,15"
350,720575940623942408,right,Mi1,351,-1,-17,-8,-9,"-1,-17"
351,720575940623948432,right,Mi1,352,-2,28,16,12,"-2,28"
352,720575940637643950,right,Mi1,353,2,24,10,14,"2,24"
353,720575940624121322,right,Mi1,354,-2,-26,-11,-15,"-2,-26"
354,720575940624136485,right,Mi1,355,-7,-6,4,-10,"-7,-6"
355,720575940624177900,right,Mi1,356,0,22,11,11,"0,22"
356,720575940624185904,right,Mi1,357,4,17,4,13,"4,17"
357,720575940624217528,right,Mi1,358,-3,17,11,6,"-3,17"
358,720575940624234644,right,Mi1,359,2,23,9,14,"2,23"
359,720575940624292158,right,Mi1,360,-5,19,14,5,"-5,19"
360,720575940624322341,right,Mi1,361,0,-7,-4,-3,"0,-7"
361,720575940624328167,right,Mi1,362,2,-20,-12,-8,"2,-20"
362,720575940624335399,right,Mi1,363,7,-4,-9,5,"7,-4"
363,720575940624654570,right,Mi1,364,4,4,-2,6,"4,4"
364,720575940633149324,right,Mi1,365,4,7,-1,8,"4,7"
365,720575940624374013,right,Mi1,366,-5,-20,-5,-15,"-5,-20"
366,720575940624402761,right,Mi1,367,-6,-15,-2,-13,"-6,-15"
367,720575940619333701,right,Mi1,368,-4,-20,-6,-14,"-4,-20"
368,720575940624467644,right,Mi1,369,5,-5,-8,3,"5,-5"
369,720575940618786205,right,Mi1,370,-3,21,13,8,"-3,21"
370,720575940624599836,right,Mi1,371,6,-5,-9,4,"6,-5"
371,720575940624624432,right,Mi1,372,1,-2,-2,0,"1,-2"
372,720575940618697506,right,Mi1,373,1,-21,-12,-9,"1,-21"
373,720575940629763663,right,Mi1,374,2,13,4,9,"2,13"
374,720575940624689610,right,Mi1,375,-6,7,9,-2,"-6,7"
375,720575940624733769,right,Mi1,376,-7,-10,2,-12,"-7,-10"
376,720575940624769771,right,Mi1,377,0,7,3,4,"0,7"
377,720575940624785934,right,Mi1,378,-3,18,12,6,"-3,18"
378,720575940634360546,right,Mi1,379,3,-17,-12,-5,"3,-17"
379,720575940624940675,right,Mi1,380,-1,29,15,14,"-1,29"
380,720575940624950676,right,Mi1,381,-8,-9,3,-12,"-8,-9"
381,720575940624951560,right,Mi1,382,3,-6,-6,0,"3,-6"
382,720575940625153836,right,Mi1,383,-6,11,11,0,"-6,11"
383,720575940625223954,right,Mi1,384,-6,-2,5,-7,"-6,-2"
384,720575940625225085,right,Mi1,385,-3,-18,-6,-12,"-3,-18"
385,720575940625269822,right,Mi1,386,-6,19,15,4,"-6,19"
386,720575940625273118,right,Mi1,387,-1,-15,-7,-8,"-1,-15"
387,720575940625276958,right,Mi1,388,3,19,6,13,"3,19"
388,720575940625410441,right,Mi1,389,-6,-16,-2,-14,"-6,-16"
389,720575940625428368,right,Mi1,390,-6,-9,1,-10,"-6,-9"
390,720575940625448394,right,Mi1,391,4,-3,-6,3,"4,-3"
391,720575940625474106,right,Mi1,392,-4,7,7,0,"-4,7"
392,720575940625478458,right,Mi1,393,-1,22,12,10,"-1,22"
393,720575940625483322,right,Mi1,394,-7,-8,3,-11,"-7,-8"
394,720575940625496720,right,Mi1,395,0,-22,-11,-11,"0,-22"
395,720575940625303788,right,Mi1,396,-1,10,6,4,"-1,10"
396,720575940625547909,right,Mi1,397,-3,-19,-7,-12,"-3,-19"
397,720575940625568010,right,Mi1,398,-3,22,14,8,"-3,22"
398,720575940625577912,right,Mi1,399,-4,-24,-8,-16,"-4,-24"
399,720575940625581605,right,Mi1,400,1,-29,-16,-13,"1,-29"
400,720575940625614101,right,Mi1,401,-2,-19,-8,-11,"-2,-19"
401,720575940625668868,right,Mi1,402,3,26,10,16,"3,26"
402,720575940629504105,right,Mi1,403,-2,-12,-4,-8,"-2,-12"
403,720575940625724618,right,Mi1,404,-1,20,11,9,"-1,20"
404,720575940625800209,right,Mi1,405,3,10,2,8,"3,10"
405,720575940625813054,right,Mi1,406,1,-25,-14,-11,"1,-25"
406,720575940625817768,right,Mi1,407,-5,-10,0,-10,"-5,-10"
407,720575940625840146,right,Mi1,408,-6,-4,4,-8,"-6,-4"
408,720575940625924995,right,Mi1,409,0,-3,-2,-1,"0,-3"
409,720575940634589922,right,Mi1,410,-2,-2,1,-3,"-2,-2"
410,720575940625981327,right,Mi1,411,-5,-19,-5,-14,"-5,-19"
411,720575940626026005,right,Mi1,412,-6,21,16,5,"-6,21"
412,720575940626064456,right,Mi1,413,-2,-7,-2,-5,"-2,-7"
413,720575940626085264,right,Mi1,414,4,21,6,15,"4,21"
414,720575940626089609,right,Mi1,415,6,12,0,12,"6,12"
415,720575940626104648,right,Mi1,416,3,-8,-7,-1,"3,-8"
416,720575940621454427,right,Mi1,417,-6,-10,1,-11,"-6,-10"
417,720575940626175619,right,Mi1,418,-2,15,9,6,"-2,15"
418,720575940626192771,right,Mi1,419,-3,-11,-3,-8,"-3,-11"
419,720575940626222681,right,Mi1,420,6,-3,-8,5,"6,-3"
420,720575940626235644,right,Mi1,421,-1,12,7,5,"-1,12"
421,720575940626252303,right,Mi1,422,-7,-4,5,-9,"-7,-4"
422,720575940621659046,right,Mi1,423,3,-18,-12,-6,"3,-18"
423,720575940626290172,right,Mi1,424,-3,-2,2,-4,"-3,-2"
424,720575940626298364,right,Mi1,425,3,20,7,13,"3,20"
425,720575940626298567,right,Mi1,426,-3,0,3,-3,"-3,0"
426,720575940643285389,right,Mi1,427,5,-18,-14,-4,"5,-18"
427,720575940626425219,right,Mi1,428,-2,23,13,10,"-2,23"
428,720575940626436733,right,Mi1,429,-2,14,9,5,"-2,14"
429,720575940618931229,right,Mi1,430,-3,-7,-1,-6,"-3,-7"
430,720575940626525982,right,Mi1,431,-2,-10,-3,-7,"-2,-10"
431,720575940609925589,right,Mi1,432,-5,7,8,-1,"-5,7"
432,720575940626607110,right,Mi1,433,0,-8,-4,-4,"0,-8"
433,720575940626644496,right,Mi1,434,-3,7,6,1,"-3,7"
434,720575940626666312,right,Mi1,435,5,-17,-14,-3,"5,-17"
435,720575940626684689,right,Mi1,436,0,-15,-8,-7,"0,-15"
436,720575940626697609,right,Mi1,437,-3,12,9,3,"-3,12"
437,720575940635896255,right,Mi1,438,2,27,11,16,"2,27"
438,720575940626774026,right,Mi1,439,-3,-9,-2,-7,"-3,-9"
439,720575940626810442,right,Mi1,440,1,23,10,13,"1,23"
440,720575940626850678,right,Mi1,441,3,-16,-11,-5,"3,-16"
441,720575940626852201,right,Mi1,442,-5,25,17,8,"-5,25"
442,720575940626888720,right,Mi1,443,-6,4,8,-4,"-6,4"
443,720575940626900086,right,Mi1,444,4,-10,-9,-1,"4,-10"
444,720575940626917635,right,Mi1,445,-2,8,6,2,"-2,8"
445,720575940632811112,right,Mi1,446,2,-14,-9,-5,"2,-14"
446,720575940626971560,right,Mi1,447,-1,2,2,0,"-1,2"
447,720575940627984650,right,Mi1,448,0,30,15,15,"0,30"
448,720575940627053329,right,Mi1,449,6,-16,-14,-2,"6,-16"
449,720575940640572733,right,Mi1,450,2,-9,-7,-2,"2,-9"
450,720575940627080945,right,Mi1,451,4,20,6,14,"4,20"
451,720575940627082329,right,Mi1,452,1,-9,-6,-3,"1,-9"
452,720575940627116318,right,Mi1,453,3,25,9,16,"3,25"
453,720575940627147080,right,Mi1,454,5,-12,-11,-1,"5,-12"
454,720575940636071519,right,Mi1,455,7,-7,-11,4,"7,-7"
455,720575940627160143,right,Mi1,456,0,21,10,11,"0,21"
456,720575940625653652,right,Mi1,457,-2,17,10,7,"-2,17"
457,720575940627167253,right,Mi1,458,5,0,-5,5,"5,0"
458,720575940627176566,right,Mi1,459,5,-3,-7,4,"5,-3"
459,720575940627177491,right,Mi1,460,-3,-20,-7,-13,"-3,-20"
460,720575940627189622,right,Mi1,461,7,-5,-10,5,"7,-5"
461,720575940627231290,right,Mi1,462,-1,18,10,8,"-1,18"
462,720575940627273274,right,Mi1,463,5,17,3,14,"5,17"
463,720575940627344783,right,Mi1,464,4,0,-4,4,"4,0"
464,720575940634689561,right,Mi1,465,3,0,-3,3,"3,0"
465,720575940627395345,right,Mi1,466,1,14,6,8,"1,14"
466,720575940627476040,right,Mi1,467,-2,-20,-8,-12,"-2,-20"
467,720575940627539653,right,Mi1,468,-3,11,8,3,"-3,11"
468,720575940627611517,right,Mi1,469,-7,13,13,0,"-7,13"
469,720575940627669239,right,Mi1,470,4,-9,-9,0,"4,-9"
470,720575940621710831,right,Mi1,471,3,-26,-16,-10,"3,-26"
471,720575940627733447,right,Mi1,472,1,25,11,14,"1,25"
472,720575940627763582,right,Mi1,473,-4,23,15,8,"-4,23"
473,720575940627764350,right,Mi1,474,-3,-17,-6,-11,"-3,-17"
474,720575940632155922,right,Mi1,475,-4,-1,3,-4,"-4,-1"
475,720575940627864305,right,Mi1,476,-1,15,8,7,"-1,15"
476,720575940627882490,right,Mi1,477,-3,2,4,-2,"-3,2"
477,720575940627928698,right,Mi1,478,-7,16,15,1,"-7,16"
478,720575940625774631,right,Mi1,479,-2,10,7,3,"-2,10"
479,720575940627963978,right,Mi1,480,3,-19,-13,-6,"3,-19"
480,720575940627970122,right,Mi1,481,4,-8,-8,0,"4,-8"
481,720575940628087913,right,Mi1,482,1,17,7,10,"1,17"
482,720575940628107881,right,Mi1,483,2,-7,-6,-1,"2,-7"
483,720575940628157595,right,Mi1,484,3,-9,-8,-1,"3,-9"
484,720575940628177738,right,Mi1,485,-3,-3,1,-4,"-3,-3"
485,720575940628196908,right,Mi1,486,0,1,0,1,"0,1"
486,720575940628273468,right,Mi1,487,1,-1,-2,1,"1,-1"
487,720575940628951036,right,Mi1,488,7,5,-5,10,"7,5"
488,720575940628359223,right,Mi1,489,-3,10,8,2,"-3,10"
489,720575940615590034,right,Mi1,490,-5,6,8,-2,"-5,6"
490,720575940628437776,right,Mi1,491,7,-1,-8,7,"7,-1"
491,720575940628439356,right,Mi1,492,-7,-2,6,-8,"-7,-2"
492,720575940628444688,right,Mi1,493,-3,23,14,9,"-3,23"
493,720575940644342688,right,Mi1,494,0,29,14,15,"0,29"
494,720575940610934340,right,Mi1,495,4,5,-2,7,"4,5"
495,720575940632814648,right,Mi1,496,7,8,-3,11,"7,8"
496,720575940628544828,right,Mi1,497,6,1,-6,7,"6,1"
497,720575940628576335,right,Mi1,498,6,10,-1,11,"6,10"
498,720575940628590235,right,Mi1,499,5,10,0,10,"5,10"
499,720575940628748816,right,Mi1,500,7,-8,-11,3,"7,-8"
500,720575940628863994,right,Mi1,501,1,2,0,2,"1,2"
501,720575940628877161,right,Mi1,502,5,8,-1,9,"5,8"
502,720575940628892432,right,Mi1,503,3,17,5,12,"3,17"
503,720575940629042639,right,Mi1,504,-2,9,6,3,"-2,9"
504,720575940629070339,right,Mi1,505,6,-22,-17,-5,"6,-22"
505,720575940629090048,right,Mi1,506,1,-12,-7,-5,"1,-12"
506,720575940629098878,right,Mi1,507,-5,-12,-1,-11,"-5,-12"
507,720575940629104377,right,Mi1,508,-5,11,10,1,"-5,11"
508,720575940629129679,right,Mi1,509,-4,10,9,1,"-4,10"
509,720575940629170220,right,Mi1,510,-2,11,7,4,"-2,11"
510,720575940629246586,right,Mi1,511,5,-11,-11,0,"5,-11"
511,720575940629287034,right,Mi1,512,6,0,-6,6,"6,0"
512,720575940629349826,right,Mi1,513,-4,-13,-3,-10,"-4,-13"
513,720575940631668475,right,Mi1,514,-4,-10,-1,-9,"-4,-10"
514,720575940629377551,right,Mi1,515,-8,-7,4,-11,"-8,-7"
515,720575940629387051,right,Mi1,516,7,-18,-16,-2,"7,-18"
516,720575940638557406,right,Mi1,517,6,3,-5,8,"6,3"
517,720575940629418110,right,Mi1,518,-4,22,15,7,"-4,22"
518,720575940629426450,right,Mi1,519,-5,-5,2,-7,"-5,-5"
519,720575940629545803,right,Mi1,520,-2,-22,-9,-13,"-2,-22"
520,720575940629588891,right,Mi1,521,6,-9,-11,2,"6,-9"
521,720575940626812222,right,Mi1,522,-4,0,4,-4,"-4,0"
522,720575940629678124,right,Mi1,523,2,14,5,9,"2,14"
523,720575940629703724,right,Mi1,524,4,-20,-14,-6,"4,-20"
524,720575940629714999,right,Mi1,525,-1,-20,-9,-11,"-1,-20"
525,720575940629829275,right,Mi1,526,0,-10,-5,-5,"0,-10"
526,720575940629855964,right,Mi1,527,-4,-8,0,-8,"-4,-8"
527,720575940629866434,right,Mi1,528,2,7,1,6,"2,7"
528,720575940630000399,right,Mi1,529,2,-2,-3,1,"2,-2"
529,720575940630011961,right,Mi1,530,-3,-13,-4,-9,"-3,-13"
530,720575940630012923,right,Mi1,531,1,0,-1,1,"1,0"
531,720575940630034243,right,Mi1,532,-8,7,11,-4,"-8,7"
532,720575940630050920,right,Mi1,533,0,-16,-8,-8,"0,-16"
533,720575940630055272,right,Mi1,534,3,2,-2,4,"3,2"
534,720575940623458428,right,Mi1,535,8,-4,-10,6,"8,-4"
535,720575940627113162,right,Mi1,536,3,4,-1,5,"3,4"
536,720575940630142265,right,Mi1,537,0,-23,-12,-11,"0,-23"
537,720575940630146668,right,Mi1,538,-4,1,4,-3,"-4,1"
538,720575940630171207,right,Mi1,539,-6,15,13,2,"-6,15"
539,720575940630201206,right,Mi1,540,-2,-9,-3,-6,"-2,-9"
540,720575940630201851,right,Mi1,541,-4,14,11,3,"-4,14"
541,720575940617236923,right,Mi1,542,6,-13,-13,0,"6,-13"
542,720575940630294902,right,Mi1,543,-1,-4,-1,-3,"-1,-4"
543,720575940630299276,right,Mi1,544,3,-13,-10,-3,"3,-13"
544,720575940624161171,right,Mi1,545,5,11,0,11,"5,11"
545,720575940630369068,right,Mi1,546,3,6,0,6,"3,6"
546,720575940630379884,right,Mi1,547,-1,21,11,10,"-1,21"
547,720575940630386060,right,Mi1,548,1,-16,-9,-7,"1,-16"
548,720575940630407751,right,Mi1,549,0,-9,-5,-4,"0,-9"
549,720575940630440007,right,Mi1,550,-2,3,3,0,"-2,3"
550,720575940634907161,right,Mi1,551,-4,-9,-1,-8,"-4,-9"
551,720575940630505297,right,Mi1,552,4,-1,-5,4,"4,-1"
552,720575940630508495,right,Mi1,553,-3,16,11,5,"-3,16"
553,720575940630535564,right,Mi1,554,-9,-3,7,-10,"-9,-3"
554,720575940630542663,right,Mi1,555,-4,9,8,1,"-4,9"
555,720575940630567698,right,Mi1,556,0,10,5,5,"0,10"
556,720575940630588101,right,Mi1,557,6,-10,-11,1,"6,-10"
557,720575940630697124,right,Mi1,558,-4,-21,-7,-14,"-4,-21"
558,720575940630697576,right,Mi1,559,-6,22,17,5,"-6,22"
559,720575940630720204,right,Mi1,560,-7,14,14,0,"-7,14"
560,720575940630799226,right,Mi1,561,5,7,-2,9,"5,7"
561,720575940630745036,right,Mi1,562,-5,-2,4,-6,"-5,-2"
562,720575940630767631,right,Mi1,563,5,-13,-12,-1,"5,-13"
563,720575940630787599,right,Mi1,564,3,-23,-15,-8,"3,-23"
564,720575940631087831,right,Mi1,565,0,-26,-13,-13,"0,-26"
565,720575940630827339,right,Mi1,566,5,-8,-9,1,"5,-8"
566,720575940630845348,right,Mi1,567,-2,22,13,9,"-2,22"
567,720575940630919763,right,Mi1,568,-6,-8,2,-10,"-6,-8"
568,720575940630936315,right,Mi1,569,6,6,-3,9,"6,6"
569,720575940630944505,right,Mi1,570,2,25,10,15,"2,25"
570,720575940644950216,right,Mi1,571,0,-14,-7,-7,"0,-14"
571,720575940627077834,right,Mi1,572,-8,3,9,-6,"-8,3"
572,720575940630964551,right,Mi1,573,4,14,3,11,"4,14"
573,720575940631016275,right,Mi1,574,-6,5,8,-3,"-6,5"
574,720575940634569442,right,Mi1,575,6,9,-2,11,"6,9"
575,720575940631083215,right,Mi1,576,0,28,14,14,"0,28"
576,720575940631102509,right,Mi1,577,5,-14,-12,-2,"5,-14"
577,720575940631103007,right,Mi1,578,4,-11,-10,-1,"4,-11"
578,720575940631116586,right,Mi1,579,-3,-10,-2,-8,"-3,-10"
579,720575940631162410,right,Mi1,580,-2,-23,-10,-13,"-2,-23"
580,720575940631195333,right,Mi1,581,3,9,1,8,"3,9"
581,720575940631379512,right,Mi1,582,-1,23,12,11,"-1,23"
582,720575940631432901,right,Mi1,583,3,-25,-16,-9,"3,-25"
583,720575940631433487,right,Mi1,584,4,23,7,16,"4,23"
584,720575940631440697,right,Mi1,585,-1,-23,-11,-12,"-1,-23"
585,720575940631539397,right,Mi1,586,2,18,7,11,"2,18"
586,720575940631544082,right,Mi1,587,4,22,7,15,"4,22"
587,720575940631593297,right,Mi1,588,1,4,1,3,"1,4"
588,720575940631644719,right,Mi1,589,-1,-5,-2,-3,"-1,-5"
589,720575940631679530,right,Mi1,590,1,9,3,6,"1,9"
590,720575940631681095,right,Mi1,591,3,-3,-5,2,"3,-3"
591,720575940631681298,right,Mi1,592,3,-28,-17,-11,"3,-28"
592,720575940631682003,right,Mi1,593,3,-14,-10,-4,"3,-14"
593,720575940631717906,right,Mi1,594,7,-16,-15,-1,"7,-16"
594,720575940631718028,right,Mi1,595,7,-12,-13,1,"7,-12"
595,720575940631726440,right,Mi1,596,-4,-16,-4,-12,"-4,-16"
596,720575940631816332,right,Mi1,597,4,1,-4,5,"4,1"
597,720575940609667083,right,Mi1,598,2,-18,-11,-7,"2,-18"
598,720575940631865874,right,Mi1,599,-1,9,5,4,"-1,9"
599,720575940631894753,right,Mi1,600,3,-10,-8,-2,"3,-10"
600,720575940606513342,right,Mi1,601,1,16,7,9,"1,16"
601,720575940632034724,right,Mi1,602,4,-2,-5,3,"4,-2"
602,720575940632055912,right,Mi1,603,-3,-23,-9,-14,"-3,-23"
603,720575940632094824,right,Mi1,604,-6,-17,-3,-14,"-6,-17"
604,720575940632107033,right,Mi1,605,3,15,4,11,"3,15"
605,720575940632113439,right,Mi1,606,-1,-19,-9,-10,"-1,-19"
606,720575940632164044,right,Mi1,607,1,18,8,10,"1,18"
607,720575940632194221,right,Mi1,608,1,10,4,6,"1,10"
608,720575940632213933,right,Mi1,609,-2,0,2,-2,"-2,0"
609,720575940632232418,right,Mi1,610,2,-23,-14,-9,"2,-23"
610,720575940632238675,right,Mi1,611,-1,-18,-8,-10,"-1,-18"
611,720575940609312860,right,Mi1,612,-3,-26,-10,-16,"-3,-26"
612,720575940646215022,right,Mi1,613,-8,-4,6,-10,"-8,-4"
613,720575940632378695,right,Mi1,614,-2,-8,-2,-6,"-2,-8"
614,720575940632396444,right,Mi1,615,-7,-7,3,-10,"-7,-7"
615,720575940632433052,right,Mi1,616,-3,15,10,5,"-3,15"
616,720575940632443804,right,Mi1,617,-2,-17,-7,-10,"-2,-17"
617,720575940632460077,right,Mi1,618,-1,24,13,11,"-1,24"
618,720575940632606509,right,Mi1,619,-4,-19,-6,-13,"-4,-19"
619,720575940636136799,right,Mi1,620,7,1,-7,8,"7,1"
620,720575940632700256,right,Mi1,621,1,24,11,13,"1,24"
621,720575940632717359,right,Mi1,622,-5,20,15,5,"-5,20"
622,720575940611667154,right,Mi1,623,1,13,5,8,"1,13"
623,720575940629262922,right,Mi1,624,1,-17,-10,-7,"1,-17"
624,720575940632769678,right,Mi1,625,-2,24,14,10,"-2,24"
625,720575940632807359,right,Mi1,626,-5,-8,1,-9,"-5,-8"
626,720575940632845463,right,Mi1,627,0,-1,-1,0,"0,-1"
627,720575940632856289,right,Mi1,628,0,0,0,0,"0,0"
628,720575940628683516,right,Mi1,629,4,24,8,16,"4,24"
629,720575940621194405,right,Mi1,630,4,8,0,8,"4,8"
630,720575940633027539,right,Mi1,631,1,26,12,14,"1,26"
631,720575940633074783,right,Mi1,632,3,-20,-13,-7,"3,-20"
632,720575940633076691,right,Mi1,633,-1,-24,-11,-13,"-1,-24"
633,720575940633138330,right,Mi1,634,-3,-15,-5,-10,"-3,-15"
634,720575940621472750,right,Mi1,635,6,-6,-9,3,"6,-6"
635,720575940633345375,right,Mi1,636,0,6,3,3,"0,6"
636,720575940633468385,right,Mi1,637,3,-21,-14,-7,"3,-21"
637,720575940633476141,right,Mi1,638,-1,7,4,3,"-1,7"
638,720575940633611883,right,Mi1,639,-4,19,13,6,"-4,19"
639,720575940644945352,right,Mi1,640,-1,-16,-7,-9,"-1,-16"
640,720575940633711540,right,Mi1,641,-8,-5,5,-10,"-8,-5"
641,720575940633731832,right,Mi1,642,-5,-11,-1,-10,"-5,-11"
642,720575940633827996,right,Mi1,643,6,14,1,13,"6,14"
643,720575940633839796,right,Mi1,644,-6,18,15,3,"-6,18"
644,720575940633872865,right,Mi1,645,-4,27,17,10,"-4,27"
645,720575940631608315,right,Mi1,646,6,17,2,15,"6,17"
646,720575940634024303,right,Mi1,647,-4,-7,0,-7,"-4,-7"
647,720575940628857604,right,Mi1,648,1,7,2,5,"1,7"
648,720575940614607912,right,Mi1,649,-1,5,3,2,"-1,5"
649,720575940634215393,right,Mi1,650,-3,-25,-10,-15,"-3,-25"
650,720575940618338260,right,Mi1,651,-4,-5,1,-6,"-4,-5"
651,720575940634440858,right,Mi1,652,-6,-11,0,-11,"-6,-11"
652,720575940634682487,right,Mi1,653,-6,-12,0,-12,"-6,-12"
653,720575940634724453,right,Mi1,654,-3,8,7,1,"-3,8"
654,720575940634728043,right,Mi1,655,6,-1,-7,6,"6,-1"
655,720575940634766699,right,Mi1,656,0,-11,-6,-5,"0,-11"
656,720575940634769562,right,Mi1,657,-2,-25,-11,-14,"-2,-25"
657,720575940634823822,right,Mi1,658,1,20,9,11,"1,20"
658,720575940634978222,right,Mi1,659,-4,-6,1,-7,"-4,-6"
659,720575940635149466,right,Mi1,660,2,28,12,16,"2,28"
660,720575940635225495,right,Mi1,661,-3,14,10,4,"-3,14"
661,720575940617246395,right,Mi1,662,2,-1,-3,2,"2,-1"
662,720575940628290618,right,Mi1,663,0,8,4,4,"0,8"
663,720575940648422532,right,Mi1,664,1,-27,-15,-12,"1,-27"
664,720575940635542895,right,Mi1,665,7,-2,-8,6,"7,-2"
665,720575940635757168,right,Mi1,666,7,-13,-14,1,"7,-13"
666,720575940635825144,right,Mi1,667,1,-28,-15,-13,"1,-28"
667,720575940635889015,right,Mi1,668,1,19,8,11,"1,19"
668,720575940636028261,right,Mi1,669,4,-16,-12,-4,"4,-16"
669,720575940623093854,right,Mi1,670,5,5,-3,8,"5,5"
670,720575940636151032,right,Mi1,671,-4,-23,-8,-15,"-4,-23"
671,720575940636169705,right,Mi1,672,-8,11,13,-2,"-8,11"
672,720575940629180422,right,Mi1,673,2,5,0,5,"2,5"
673,720575940636304218,right,Mi1,674,-4,-14,-3,-11,"-4,-14"
674,720575940627009598,right,Mi1,675,-7,19,16,3,"-7,19"
675,720575940635689626,right,Mi1,676,-3,-21,-8,-13,"-3,-21"
676,720575940623887128,right,Mi1,677,0,11,5,6,"0,11"
677,720575940636425870,right,Mi1,678,3,-7,-7,0,"3,-7"
678,720575940636481513,right,Mi1,679,4,18,5,13,"4,18"
679,720575940626100238,right,Mi1,680,-1,25,13,12,"-1,25"
680,720575940618860445,right,Mi1,681,-2,-21,-9,-12,"-2,-21"
681,720575940636847167,right,Mi1,682,6,-8,-10,2,"6,-8"
682,720575940636890224,right,Mi1,683,2,6,1,5,"2,6"
683,720575940636894022,right,Mi1,684,-6,17,14,3,"-6,17"
684,720575940636962138,right,Mi1,685,-5,-9,0,-9,"-5,-9"
685,720575940636988813,right,Mi1,686,5,-22,-16,-6,"5,-22"
686,720575940637106573,right,Mi1,687,-6,-3,4,-7,"-6,-3"
687,720575940637161013,right,Mi1,688,-7,10,12,-2,"-7,10"
688,720575940637177054,right,Mi1,689,-2,18,11,7,"-2,18"
689,720575940637201461,right,Mi1,690,-7,-3,5,-8,"-7,-3"
690,720575940637228206,right,Mi1,691,-9,4,11,-7,"-9,4"
691,720575940637228341,right,Mi1,692,-4,24,16,8,"-4,24"
692,720575940637230766,right,Mi1,693,-3,25,15,10,"-3,25"
693,720575940624959927,right,Mi1,694,4,3,-3,6,"4,3"
694,720575940620960020,right,Mi1,695,-6,10,11,-1,"-6,10"
695,720575940637431110,right,Mi1,696,-2,16,10,6,"-2,16"
696,720575940637471054,right,Mi1,697,1,-22,-12,-10,"1,-22"
697,720575940637571812,right,Mi1,698,6,-7,-10,3,"6,-7"
698,720575940631758423,right,Mi1,699,-5,0,5,-5,"-5,0"
699,720575940637651034,right,Mi1,700,5,15,2,13,"5,15"
700,720575940637746493,right,Mi1,701,0,-4,-2,-2,"0,-4"
701,720575940606476478,right,Mi1,702,-5,23,16,7,"-5,23"
702,720575940637885043,right,Mi1,703,-3,1,3,-2,"-3,1"
703,720575940640562749,right,Mi1,704,-7,8,11,-3,"-7,8"
704,720575940637977149,right,Mi1,705,1,1,-1,2,"1,1"
705,720575940638169688,right,Mi1,706,-7,-12,1,-13,"-7,-12"
706,720575940638312006,right,Mi1,707,-2,25,14,11,"-2,25"
707,720575940638318399,right,Mi1,708,-4,-25,-9,-16,"-4,-25"
708,720575940620605776,right,Mi1,709,-2,-24,-10,-14,"-2,-24"
709,720575940638341353,right,Mi1,710,4,-25,-17,-8,"4,-25"
710,720575940638407494,right,Mi1,711,-1,19,10,9,"-1,19"
711,720575940638827984,right,Mi1,712,-7,12,13,-1,"-7,12"
712,720575940639065296,right,Mi1,713,-6,16,14,2,"-6,16"
713,720575940618311892,right,Mi1,714,5,12,1,11,"5,12"
714,720575940639223203,right,Mi1,715,4,10,1,9,"4,10"
715,720575940639250741,right,Mi1,716,4,-6,-7,1,"4,-6"
716,720575940639258200,right,Mi1,717,2,-22,-13,-9,"2,-22"
717,720575940639311488,right,Mi1,718,-5,24,17,7,"-5,24"
718,720575940636264952,right,Mi1,719,1,27,12,15,"1,27"
719,720575940639404605,right,Mi1,720,-5,21,15,6,"-5,21"
720,720575940635506528,right,Mi1,721,5,13,1,12,"5,13"
721,720575940639421016,right,Mi1,722,6,-15,-14,-1,"6,-15"
722,720575940639546933,right,Mi1,723,-2,-11,-4,-7,"-2,-11"
723,720575940614989107,right,Mi1,724,4,2,-3,5,"4,2"
724,720575940640212413,right,Mi1,725,-3,-24,-9,-15,"-3,-24"
725,720575940640143192,right,Mi1,726,2,-28,-16,-12,"2,-28"
726,720575940640180339,right,Mi1,727,7,6,-4,10,"7,6"
727,720575940625666488,right,Mi1,728,7,12,-1,13,"7,12"
728,720575940640250496,right,Mi1,729,-3,29,17,12,"-3,29"
729,720575940640318552,right,Mi1,730,7,0,-7,7,"7,0"
730,720575940640355213,right,Mi1,731,-6,9,10,-1,"-6,9"
731,720575940616893638,right,Mi1,732,-3,6,6,0,"-3,6"
732,720575940612523669,right,Mi1,733,-5,-17,-4,-13,"-5,-17"
733,720575940640466677,right,Mi1,734,2,0,-2,2,"2,0"
734,720575940640503640,right,Mi1,735,1,-23,-13,-10,"1,-23"
735,720575940640672501,right,Mi1,736,-8,1,8,-7,"-8,1"
736,720575940641105883,right,Mi1,737,0,19,9,10,"0,19"
737,720575940641108699,right,Mi1,738,-3,13,9,4,"-3,13"
738,720575940641151284,right,Mi1,739,-7,2,8,-6,"-7,2"
739,720575940641202640,right,Mi1,740,2,-8,-6,-2,"2,-8"
740,720575940643266583,right,Mi1,741,-2,-14,-5,-9,"-2,-14"
741,720575940643527112,right,Mi1,742,-4,11,9,2,"-4,11"
742,720575940643572334,right,Mi1,743,6,-19,-16,-3,"6,-19"
743,720575940643633352,right,Mi1,744,-4,25,16,9,"-4,25"
744,720575940643862324,right,Mi1,745,0,13,6,7,"0,13"
745,720575940643929800,right,Mi1,746,-3,3,4,-1,"-3,3"
746,720575940644093719,right,Mi1,747,0,2,1,1,"0,2"
747,720575940644391112,right,Mi1,748,-4,20,14,6,"-4,20"
748,720575940644510574,right,Mi1,749,-2,1,2,-1,"-2,1"
749,720575940605581024,right,Mi1,750,4,-24,-16,-8,"4,-24"
750,720575940645541252,right,Mi1,751,1,6,2,4,"1,6"
751,720575940645669940,right,Mi1,752,-2,7,5,2,"-2,7"
752,720575940646028142,right,Mi1,753,-3,24,15,9,"-3,24"
753,720575940646369588,right,Mi1,754,-1,-13,-6,-7,"-1,-13"
754,720575940646413108,right,Mi1,755,4,19,5,14,"4,19"
755,720575940646428980,right,Mi1,756,5,20,5,15,"5,20"
756,720575940646433076,right,Mi1,757,0,-6,-3,-3,"0,-6"
757,720575940647995769,right,Mi1,758,5,-1,-6,5,"5,-1"
758,720575940648026756,right,Mi1,759,7,14,0,14,"7,14"
759,720575940648557689,right,Mi1,760,0,17,8,9,"0,17"
760,720575940649324153,right,Mi1,761,-4,-18,-5,-13,"-4,-18"
761,720575940632406543,right,Mi1,762,0,14,7,7,"0,14"
762,720575940650403449,right,Mi1,763,-5,14,12,2,"-5,14"
763,720575940650482041,right,Mi1,764,-8,-6,5,-11,"-8,-6"
764,720575940650510838,right,Mi1,765,-3,9,7,2,"-3,9"
765,720575940651887094,right,Mi1,766,2,-4,-4,0,"2,-4"
766,720575940652626934,right,Mi1,767,1,28,13,15,"1,28"
767,720575940624086408,right,Mi1,768,3,5,-1,6,"3,5"
768,720575940655096481,right,Mi1,769,4,-27,-18,-9,"4,-27"
769,720575940612197986,right,Mi1,770,5,4,-3,7,"5,4"
770,720575940655608481,right,Mi1,771,3,-27,-17,-10,"3,-27"
771,720575940655611553,right,Mi1,772,1,12,5,7,"1,12"
772,720575940636037983,right,Mi1,773,5,-19,-15,-4,"5,-19"
773,720575940630271336,right,Mi1,774,-8,6,11,-5,"-8,6"
774,720575940645078984,right,Mi1,775,5,22,6,16,"5,22"
775,720575940645309988,right,Mi1,776,5,21,5,16,"5,21"
776,720575940628534827,right,Mi1,777,6,20,4,16,"6,20"
777,720575940620941703,right,Mi1,778,4,25,8,17,"4,25"
778,720575940604607678,right,Mi1,779,5,24,7,17,"5,24"
779,720575940607228629,right,Mi1,780,-6,25,18,7,"-6,25"
780,720575940605668128,right,Mi1,781,-5,26,18,8,"-5,26"
781,720575940622821590,right,Mi1,782,-5,27,18,9,"-5,27"
782,720575940632527524,right,Mi1,783,-4,28,18,10,"-4,28"
783,720575940618405917,right,Mi1,784,-4,29,18,11,"-4,29"
784,720575940641224181,right,Mi1,785,-3,30,18,12,"-3,30"
785,720575940646982964,right,Mi1,786,-2,30,17,13,"-2,30"
786,720575940635864176,right,Mi1,787,3,28,11,17,"3,28"
787,720575940624864263,right,Mi1,788,3,27,10,17,"3,27"
788,720575940626772666,right,Mi1,789,-3,-27,-11,-16,"-3,-27"
789,720575940616083212,right,Mi1,790,-2,-27,-12,-15,"-2,-27"
790,720575940614026280,right,Mi1,791,-1,-28,-13,-15,"-1,-28"
791,720575940616046348,right,Mi1,792,8,2,-7,9,"8,2"
792,720575940620133243,right,Mi1,793,8,-6,-11,5,"8,-6"
793,720575940622574038,right,Mi1,794,5,-26,-18,-8,"5,-26"
794,720575940623210933,right,Mi1,795,6,-21,-17,-4,"6,-21"
795,720575940619018779,right,Mi1,796,4,26,9,17,"4,26"
796,720575940633860397,right,C2,1,-6,13,12,1,"-6,13"
797,720575940620566772,right,C2,2,-8,2,9,-7,"-8,2"
798,720575940621492912,right,C2,3,6,-12,-12,0,"6,-12"
799,720575940613162675,right,C2,4,-5,-21,-6,-15,"-5,-21"
800,720575940620936289,right,C2,5,-1,16,9,7,"-1,16"
801,720575940624386186,right,C2,6,-2,-4,0,-4,"-2,-4"
802,720575940630762455,right,C2,7,-6,-6,3,-9,"-6,-6"
803,720575940619213888,right,C2,8,-4,26,17,9,"-4,26"
804,720575940623478749,right,C2,9,4,9,0,9,"4,9"
805,720575940638420302,right,C2,10,5,-15,-13,-2,"5,-15"
806,720575940628714005,right,C2,12,-7,9,11,-2,"-7,9"
807,720575940628696085,right,C2,13,-1,-26,-12,-14,"-1,-26"
808,720575940626805296,right,C2,14,0,-27,-14,-13,"0,-27"
809,720575940614521767,right,C2,15,2,-3,-4,1,"2,-3"
810,720575940623280937,right,C2,16,-2,-16,-6,-10,"-2,-16"
811,720575940621919152,right,C2,17,1,-5,-4,-1,"1,-5"
812,720575940635957855,right,C2,18,5,-16,-13,-3,"5,-16"
813,720575940636569701,right,C2,19,-7,17,15,2,"-7,17"
814,720575940634158050,right,C2,20,3,-11,-9,-2,"3,-11"
815,720575940626720152,right,C2,21,-2,19,11,8,"-2,19"
816,720575940639055450,right,C2,22,-1,3,2,1,"-1,3"
817,720575940640028494,right,C2,23,-3,-16,-5,-11,"-3,-16"
818,720575940630133760,right,C2,24,-1,-10,-4,-6,"-1,-10"
819,720575940615083231,right,C2,25,-9,3,10,-7,"-9,3"
820,720575940616302239,right,C2,26,1,-3,-3,0,"1,-3"
821,720575940630892288,right,C2,27,0,-25,-13,-12,"0,-25"
822,720575940631105068,right,C2,28,5,6,-2,8,"5,6"
823,720575940616568537,right,C2,29,-1,-3,-1,-2,"-1,-3"
824,720575940620936583,right,C2,30,6,16,2,14,"6,16"
825,720575940626462501,right,C2,31,0,16,8,8,"0,16"
826,720575940617562763,right,C2,32,0,12,6,6,"0,12"
827,720575940628760835,right,C2,34,6,18,3,15,"6,18"
828,720575940612202850,right,C2,35,1,-24,-13,-11,"1,-24"
829,720575940627219911,right,C2,37,1,5,1,4,"1,5"
830,720575940623447690,right,C2,38,0,-2,-1,-1,"0,-2"
831,720575940605886385,right,C2,40,-2,-6,-1,-5,"-2,-6"
832,720575940625441511,right,C2,41,-3,28,17,11,"-3,28"
833,720575940620463855,right,C2,42,-1,14,8,6,"-1,14"
834,720575940636864869,right,C2,43,-5,18,14,4,"-5,18"
835,720575940623979498,right,C2,44,5,-10,-10,0,"5,-10"
836,720575940609779524,right,C2,45,-5,-1,4,-5,"-5,-1"
837,720575940617042444,right,C2,46,-5,15,12,3,"-5,15"
838,720575940623605994,right,C2,47,-9,-1,8,-9,"-9,-1"
839,720575940645376292,right,C2,48,-4,-22,-7,-15,"-4,-22"
840,720575940621438448,right,C2,49,4,-4,-6,2,"4,-4"
841,720575940626653336,right,C2,50,-2,21,12,9,"-2,21"
842,720575940615117777,right,C2,51,0,-19,-10,-9,"0,-19"
843,720575940612481941,right,C2,52,-1,-22,-10,-12,"-1,-22"
844,720575940621150934,right,C2,53,5,14,2,12,"5,14"
845,720575940623488234,right,C2,54,-4,3,5,-2,"-4,3"
846,720575940633700179,right,C2,55,-4,-11,-2,-9,"-4,-11"
847,720575940616296607,right,C2,56,1,-13,-8,-5,"1,-13"
848,720575940633285843,right,C2,57,6,-11,-12,1,"6,-11"
849,720575940613724131,right,C2,58,3,12,3,9,"3,12"
850,720575940626719365,right,C2,59,-2,2,3,-1,"-2,2"
851,720575940640594384,right,C2,60,-8,8,12,-4,"-8,8"
852,720575940627270738,right,C2,61,-4,-4,2,-6,"-4,-4"
853,720575940612309966,right,C2,63,4,12,2,10,"4,12"
854,720575940615875003,right,C2,64,4,-23,-16,-7,"4,-23"
855,720575940623897101,right,C2,65,-1,28,15,13,"-1,28"
856,720575940638877237,right,C2,66,2,15,5,10,"2,15"
857,720575940613268963,right,C2,67,-2,-13,-5,-8,"-2,-13"
858,720575940608069554,right,C2,68,3,16,5,11,"3,16"
859,720575940640745587,right,C2,69,1,8,3,5,"1,8"
860,720575940624598054,right,C2,70,-4,21,14,7,"-4,21"
861,720575940635142751,right,C2,71,-2,-3,0,-3,"-2,-3"
862,720575940637861806,right,C2,72,0,-28,-14,-14,"0,-28"
863,720575940639326835,right,C2,73,2,2,-1,3,"2,2"
864,720575940619080193,right,C2,74,-1,-9,-4,-5,"-1,-9"
865,720575940627209994,right,C2,75,-6,14,13,1,"-6,14"
866,720575940632737325,right,C2,76,-3,-4,1,-5,"-3,-4"
867,720575940620847598,right,C2,77,2,-5,-5,0,"2,-5"
868,720575940642085595,right,C2,78,2,20,8,12,"2,20"
869,720575940623907591,right,C2,79,2,1,-2,3,"2,1"
870,720575940631273436,right,C2,80,4,13,2,11,"4,13"
871,720575940631683599,right,C2,81,6,-2,-7,5,"6,-2"
872,720575940623842485,right,C2,82,-7,7,10,-3,"-7,7"
873,720575940650588537,right,C2,83,2,-21,-13,-8,"2,-21"
874,720575940625649850,right,C2,84,-2,12,8,4,"-2,12"
875,720575940635750836,right,C2,85,4,-22,-15,-7,"4,-22"
876,720575940627912444,right,C2,86,-5,-7,1,-8,"-5,-7"
877,720575940614808273,right,C2,87,1,11,4,7,"1,11"
878,720575940627505539,right,C2,88,7,4,-5,9,"7,4"
879,720575940614879283,right,C2,89,1,-19,-11,-8,"1,-19"
880,720575940622379190,right,C2,90,-4,5,6,-1,"-4,5"
881,720575940617088605,right,C2,91,-1,6,4,2,"-1,6"
882,720575940616662614,right,C2,92,0,9,4,5,"0,9"
883,720575940623920391,right,C2,95,4,-21,-15,-6,"4,-21"
884,720575940634794391,right,C2,96,1,-10,-6,-4,"1,-10"
885,720575940629979447,right,C2,97,-5,2,6,-4,"-5,2"
886,720575940629991323,right,C2,98,-1,-12,-5,-7,"-1,-12"
887,720575940622737288,right,C2,99,4,15,3,12,"4,15"
888,720575940629874732,right,C2,100,2,-10,-7,-3,"2,-10"
889,720575940629308234,right,C2,101,-7,6,10,-4,"-7,6"
890,720575940629354110,right,C2,102,3,13,3,10,"3,13"
891,720575940635442071,right,C2,104,-1,-27,-13,-14,"-1,-27"
892,720575940628653308,right,C2,105,3,22,8,14,"3,22"
893,720575940614627112,right,C2,106,-7,11,12,-1,"-7,11"
894,720575940612531921,right,C2,107,8,-2,-9,7,"8,-2"
895,720575940623964853,right,C2,108,-3,-12,-3,-9,"-3,-12"
896,720575940621660144,right,C2,109,4,-5,-7,2,"4,-5"
897,720575940617646036,right,C2,110,-7,0,7,-7,"-7,0"
898,720575940610978094,right,C2,111,2,-24,-14,-10,"2,-24"
899,720575940620508075,right,C2,112,-6,1,6,-5,"-6,1"
900,720575940628530023,right,C2,113,-2,4,4,0,"-2,4"
901,720575940619132632,right,C2,114,2,-13,-9,-4,"2,-13"
902,720575940631853113,right,C2,115,-4,2,5,-3,"-4,2"
903,720575940639176681,right,C2,116,-1,-8,-3,-5,"-1,-8"
904,720575940619477077,right,C2,117,-8,-2,7,-9,"-8,-2"
905,720575940618591266,right,C2,118,3,1,-3,4,"3,1"
906,720575940625861159,right,C2,119,-2,6,5,1,"-2,6"
907,720575940623508733,right,C2,120,-1,-1,0,-1,"-1,-1"
908,720575940631556675,right,C2,122,-5,9,9,0,"-5,9"
909,720575940627694479,right,C2,123,-8,10,13,-3,"-8,10"
910,720575940648376452,right,C2,124,1,-7,-5,-2,"1,-7"
911,720575940650713465,right,C2,125,5,9,-1,10,"5,9"
912,720575940621604998,right,C2,126,3,11,2,9,"3,11"
913,720575940644337312,right,C2,127,0,15,7,8,"0,15"
914,720575940616768268,right,C2,128,3,-22,-14,-8,"3,-22"
915,720575940612565657,right,C2,129,0,-13,-7,-6,"0,-13"
916,720575940638093534,right,C2,130,2,12,4,8,"2,12"
917,720575940626274050,right,C2,131,-6,20,16,4,"-6,20"
918,720575940618119739,right,C2,132,2,4,0,4,"2,4"
919,720575940622066014,right,C2,133,-3,20,13,7,"-3,20"
920,720575940613650841,right,C2,134,-5,-18,-4,-14,"-5,-18"
921,720575940628266578,right,C2,135,-3,-22,-8,-14,"-3,-22"
922,720575940632750879,right,C2,136,0,3,1,2,"0,3"
923,720575940625721802,right,C2,137,5,-7,-9,2,"5,-7"
924,720575940609820629,right,C2,138,0,27,13,14,"0,27"
925,720575940613652451,right,C2,139,1,-14,-8,-6,"1,-14"
926,720575940625600868,right,C2,140,3,8,1,7,"3,8"
927,720575940624984503,right,C2,141,5,-23,-17,-6,"5,-23"
928,720575940620772846,right,C2,142,-2,-18,-7,-11,"-2,-18"
929,720575940628288133,right,C2,143,-4,16,12,4,"-4,16"
930,720575940626458652,right,C2,144,7,-11,-13,2,"7,-11"
931,720575940625074446,right,C2,145,0,4,2,2,"0,4"
932,720575940617143133,right,C2,146,1,-6,-4,-2,"1,-6"
933,720575940627156869,right,C2,147,1,21,9,12,"1,21"
934,720575940624385160,right,C2,148,-7,-11,1,-12,"-7,-11"
935,720575940620135047,right,C2,149,6,-14,-13,-1,"6,-14"
936,720575940617547494,right,C2,150,-8,5,10,-5,"-8,5"
937,720575940610049493,right,C2,151,-3,-14,-4,-10,"-3,-14"
938,720575940608057730,right,C2,152,3,-15,-11,-4,"3,-15"
939,720575940616601612,right,C2,153,8,0,-8,8,"8,0"
940,720575940632927661,right,C2,154,-8,0,8,-8,"-8,0"
941,720575940615978646,right,C2,155,-8,13,14,-1,"-8,13"
942,720575940621279216,right,C2,156,-9,1,9,-8,"-9,1"
943,720575940625026824,right,C2,157,-1,-7,-3,-4,"-1,-7"
944,720575940631484409,right,C2,158,3,-5,-6,1,"3,-5"
945,720575940623686365,right,C2,159,7,7,-4,11,"7,7"
946,720575940625827917,right,C2,161,4,-14,-11,-3,"4,-14"
947,720575940630403269,right,C2,162,-4,-2,3,-5,"-4,-2"
948,720575940629887276,right,C2,163,-9,7,12,-5,"-9,7"
949,720575940639316550,right,C2,164,-1,-2,0,-2,"-1,-2"
950,720575940641225435,right,C2,165,4,16,4,12,"4,16"
951,720575940618933302,right,C2,166,0,18,9,9,"0,18"
952,720575940616395276,right,C2,167,0,-17,-9,-8,"0,-17"
953,720575940621483504,right,C2,168,-1,17,9,8,"-1,17"
954,720575940619836269,right,C2,169,0,-18,-9,-9,"0,-18"
955,720575940624486804,right,C2,170,-5,1,5,-4,"-5,1"
956,720575940608262980,right,C2,171,6,-20,-16,-4,"6,-20"
957,720575940635587832,right,C2,172,1,22,10,12,"1,22"
958,720575940650734713,right,C2,173,2,-25,-15,-10,"2,-25"
959,720575940612971690,right,C2,174,4,-15,-12,-3,"4,-15"
960,720575940622331305,right,C2,175,-6,-7,2,-9,"-6,-7"
961,720575940622362650,right,C2,176,-2,13,8,5,"-2,13"
962,720575940608603331,right,C2,177,-2,-1,1,-2,"-2,-1"
963,720575940617927892,right,C2,178,2,11,3,8,"2,11"
964,720575940619766430,right,C2,179,-5,-16,-3,-13,"-5,-16"
965,720575940660268929,right,C2,181,1,-4,-3,-1,"1,-4"
966,720575940621733870,right,C2,182,7,-10,-12,2,"7,-10"
967,720575940618026241,right,C2,183,-5,-15,-3,-12,"-5,-15"
968,720575940634921626,right,C2,184,-6,-5,3,-8,"-6,-5"
969,720575940653406966,right,C2,185,2,-11,-8,-3,"2,-11"
970,720575940622865917,right,C2,186,-1,26,14,12,"-1,26"
971,720575940646078830,right,C2,187,3,21,7,14,"3,21"
972,720575940622513652,right,C2,188,-5,17,13,4,"-5,17"
973,720575940628354307,right,C2,189,6,13,0,13,"6,13"
974,720575940608029826,right,C2,190,-3,-5,0,-5,"-3,-5"
975,720575940620139143,right,C2,191,-1,-11,-5,-6,"-1,-11"
976,720575940610585442,right,C2,192,7,10,-2,12,"7,10"
977,720575940622880094,right,C2,193,-5,4,7,-3,"-5,4"
978,720575940623603178,right,C2,194,0,-5,-3,-2,"0,-5"
979,720575940624537095,right,C2,195,-3,-1,2,-3,"-3,-1"
980,720575940631641551,right,C2,196,-1,8,5,3,"-1,8"
981,720575940634843031,right,C2,197,0,-20,-10,-10,"0,-20"
982,720575940632224908,right,C2,198,6,2,-5,7,"6,2"
983,720575940629179035,right,C2,199,0,-12,-6,-6,"0,-12"
984,720575940627404821,right,C2,200,-5,12,11,1,"-5,12"
985,720575940637664654,right,C2,202,-1,27,14,13,"-1,27"
986,720575940624191882,right,C2,203,3,-1,-4,3,"3,-1"
987,720575940634966463,right,C2,204,5,-2,-6,4,"5,-2"
988,720575940621262100,right,C2,205,5,-6,-8,2,"5,-6"
989,720575940623243658,right,C2,206,-3,5,5,0,"-3,5"
990,720575940621294000,right,C2,208,5,-21,-16,-5,"5,-21"
991,720575940638048368,right,C2,209,-3,-8,-1,-7,"-3,-8"
992,720575940631981964,right,C2,210,-6,8,10,-2,"-6,8"
993,720575940620396635,right,C2,211,-7,-1,6,-7,"-7,-1"
994,720575940637609390,right,C2,212,2,-16,-10,-6,"2,-16"
995,720575940623152264,right,C2,213,3,-4,-5,1,"3,-4"
996,720575940617832276,right,C2,214,-5,3,6,-3,"-5,3"
997,720575940622981912,right,C2,215,6,7,-3,10,"6,7"
998,720575940643470116,right,C2,216,2,19,7,12,"2,19"
999,720575940624272425,right,C2,217,6,15,1,14,"6,15"
1000,720575940632314060,right,C2,218,2,10,3,7,"2,10"
1001,720575940652505078,right,C2,219,6,-4,-8,4,"6,-4"
1002,720575940635624343,right,C2,220,2,-6,-5,-1,"2,-6"
1003,720575940615526210,right,C2,221,-7,3,8,-5,"-7,3"
1004,720575940631276631,right,C2,222,-3,26,16,10,"-3,26"
1005,720575940632671848,right,C2,223,-2,26,15,11,"-2,26"
1006,720575940621361601,right,C2,224,0,5,2,3,"0,5"
1007,720575940632016911,right,C2,225,2,-26,-15,-11,"2,-26"
1008,720575940630203333,right,C2,226,5,19,4,15,"5,19"
1009,720575940623355530,right,C2,227,-7,5,9,-4,"-7,5"
1010,720575940616058418,right,C2,228,-7,1,7,-6,"-7,1"
1011,720575940621680321,right,C2,229,5,2,-4,6,"5,2"
1012,720575940635588788,right,C2,230,2,9,2,7,"2,9"
1013,720575940626262928,right,C2,231,4,-12,-10,-2,"4,-12"
1014,720575940630700795,right,C2,232,-4,13,10,3,"-4,13"
1015,720575940616252347,right,C2,233,4,-13,-11,-2,"4,-13"
1016,720575940628284615,right,C2,234,1,3,0,3,"1,3"
1017,720575940630644239,right,C2,235,4,11,1,10,"4,11"
1018,720575940628334023,right,C2,236,-1,4,3,1,"-1,4"
1019,720575940647349795,right,C2,237,-2,27,15,12,"-2,27"
1020,720575940621727103,right,C2,238,-8,-3,6,-9,"-8,-3"
1021,720575940609562635,right,C2,239,-6,6,9,-3,"-6,6"
1022,720575940623912455,right,C2,240,-4,-3,2,-5,"-4,-3"
1023,720575940620246036,right,C2,241,2,-17,-11,-6,"2,-17"
1024,720575940625969098,right,C2,242,-4,6,7,-1,"-4,6"
1025,720575940632003279,right,C2,243,-1,-21,-10,-11,"-1,-21"
1026,720575940622931992,right,C2,244,-4,-12,-2,-10,"-4,-12"
1027,720575940631325515,right,C2,245,-5,-3,3,-6,"-5,-3"
1028,720575940610915938,right,C2,246,-4,15,11,4,"-4,15"
1029,720575940619221824,right,C2,247,-4,-15,-4,-11,"-4,-15"
1030,720575940616716683,right,C2,248,-6,0,6,-6,"-6,0"
1031,720575940621570486,right,C2,249,2,-12,-8,-4,"2,-12"
1032,720575940626995880,right,C2,250,-1,1,1,0,"-1,1"
1033,720575940627340165,right,C2,251,-1,-14,-6,-8,"-1,-14"
1034,720575940623824422,right,C2,252,3,23,8,15,"3,23"
1035,720575940606626481,right,C2,253,5,16,3,13,"5,16"
1036,720575940623177084,right,C2,254,3,-24,-15,-9,"3,-24"
1037,720575940627574035,right,C2,255,-6,-13,-1,-12,"-6,-13"
1038,720575940628425640,right,C2,256,5,-20,-15,-5,"5,-20"
1039,720575940625970364,right,C2,257,2,21,8,13,"2,21"
1040,720575940633597860,right,C2,258,-4,-17,-5,-12,"-4,-17"
1041,720575940630220604,right,C2,259,-7,-5,4,-9,"-7,-5"
1042,720575940630591098,right,C2,260,-3,19,12,7,"-3,19"
1043,720575940630466934,right,C2,261,-1,13,7,6,"-1,13"
1044,720575940626016408,right,C2,263,-3,4,5,-1,"-3,4"
1045,720575940638559302,right,C2,264,-1,-6,-2,-4,"-1,-6"
1046,720575940636050318,right,C2,265,-6,-1,5,-6,"-6,-1"
1047,720575940623115177,right,C2,266,-1,-25,-12,-13,"-1,-25"
1048,720575940627428610,right,C2,267,-6,2,7,-5,"-6,2"
1049,720575940632651859,right,C2,268,7,-6,-10,4,"7,-6"
1050,720575940631276375,right,C2,269,2,-19,-12,-7,"2,-19"
1051,720575940621295536,right,C2,270,1,-8,-5,-3,"1,-8"
1052,720575940627383933,right,C2,271,4,6,-1,7,"4,6"
1053,720575940640039229,right,C2,272,3,-2,-4,2,"3,-2"
1054,720575940614373630,right,C2,273,-6,23,17,6,"-6,23"
1055,720575940649633145,right,C2,275,-8,-1,7,-8,"-8,-1"
1056,720575940617675521,right,C2,276,2,3,-1,4,"2,3"
1057,720575940615021310,right,C2,277,7,-3,-9,6,"7,-3"
1058,720575940615219103,right,C2,278,-5,10,10,0,"-5,10"
1059,720575940622839390,right,C2,279,-4,8,8,0,"-4,8"
1060,720575940634054425,right,C2,280,-6,-14,-1,-13,"-6,-14"
1061,720575940618064155,right,C2,281,-9,2,10,-8,"-9,2"
1062,720575940624226598,right,C2,282,0,26,13,13,"0,26"
1063,720575940630038327,right,C2,283,-4,4,6,-2,"-4,4"
1064,720575940622137665,right,C2,284,0,25,12,13,"0,25"
1065,720575940615732310,right,C2,285,6,-18,-15,-3,"6,-18"
1066,720575940636674415,right,C2,286,0,-24,-12,-12,"0,-24"
1067,720575940612496497,right,C2,287,-5,13,11,2,"-5,13"
1068,720575940625119271,right,C2,289,-1,11,6,5,"-1,11"
1069,720575940642653659,right,C2,290,5,-24,-17,-7,"5,-24"
1070,720575940625965756,right,C2,291,7,2,-6,8,"7,2"
1071,720575940621126081,right,C2,292,-4,18,13,5,"-4,18"
1072,720575940608069298,right,C2,293,4,-17,-13,-4,"4,-17"
1073,720575940622045022,right,C2,294,1,-20,-11,-9,"1,-20"
1074,720575940620268167,right,C2,296,1,-18,-10,-8,"1,-18"
1075,720575940638188254,right,C2,297,7,-9,-12,3,"7,-9"
1076,720575940616407106,right,C2,298,-5,5,7,-2,"-5,5"
1077,720575940628324170,right,C2,299,-4,12,10,2,"-4,12"
1078,720575940624250859,right,C2,300,4,-18,-13,-5,"4,-18"
1079,720575940624643047,right,C2,301,-5,16,13,3,"-5,16"
1080,720575940610602360,right,C2,302,2,17,6,11,"2,17"
1081,720575940624496874,right,C2,303,-5,22,16,6,"-5,22"
1082,720575940623271423,right,C2,305,-7,4,9,-5,"-7,4"
1083,720575940612974961,right,C2,306,3,7,0,7,"3,7"
1084,720575940623987199,right,C2,307,5,-25,-18,-7,"5,-25"
1085,720575940619523742,right,C2,308,-5,8,9,-1,"-5,8"
1086,720575940638559972,right,C2,309,-6,12,12,0,"-6,12"
1087,720575940608625419,right,C2,310,2,22,9,13,"2,22"
1088,720575940614889110,right,C2,311,-7,15,14,1,"-7,15"
1089,720575940625991868,right,C2,312,4,-7,-8,1,"4,-7"
1090,720575940626934202,right,C2,313,7,3,-6,9,"7,3"
1091,720575940621686254,right,C2,314,-9,5,11,-6,"-9,5"
1092,720575940626358605,right,C2,315,-3,-6,0,-6,"-3,-6"
1093,720575940629834240,right,C2,316,5,-4,-7,3,"5,-4"
1094,720575940635584504,right,C2,317,-5,-4,3,-7,"-5,-4"
1095,720575940619581204,right,C2,318,4,-19,-14,-5,"4,-19"
1096,720575940628740395,right,C2,319,-2,5,4,1,"-2,5"
1097,720575940619436081,right,C2,320,-2,-5,-1,-4,"-2,-5"
1098,720575940638136944,right,C2,321,8,4,-6,10,"8,4"
1099,720575940611526776,right,C2,322,2,26,11,15,"2,26"
1100,720575940629229840,right,C2,323,-7,-13,0,-13,"-7,-13"
1101,720575940623134889,right,C2,324,3,24,9,15,"3,24"
1102,720575940616392415,right,C2,325,5,1,-5,6,"5,1"
1103,720575940623933901,right,C2,326,2,16,6,10,"2,16"
1104,720575940629985128,right,C2,328,5,-9,-10,1,"5,-9"
1105,720575940632792111,right,C2,329,0,24,12,12,"0,24"
1106,720575940620042107,right,C2,330,3,3,-2,5,"3,3"
1107,720575940638819817,right,C2,331,1,-15,-9,-6,"1,-15"
1108,720575940622319792,right,C2,332,4,-26,-17,-9,"4,-26"
1109,720575940631036476,right,C2,335,2,8,2,6,"2,8"
1110,720575940625337319,right,C2,336,0,23,11,12,"0,23"
1111,720575940624168521,right,C2,337,-5,-6,2,-8,"-5,-6"
1112,720575940621127815,right,C2,338,-1,0,1,-1,"-1,0"
1113,720575940622721037,right,C2,339,6,11,-1,12,"6,11"
1114,720575940611675854,right,C2,340,-4,17,12,5,"-4,17"
1115,720575940623911267,right,C2,341,6,-17,-15,-2,"6,-17"
1116,720575940605074144,right,C2,342,2,-15,-10,-5,"2,-15"
1117,720575940638895194,right,C2,343,-3,27,16,11,"-3,27"
1118,720575940622410153,right,C2,344,-2,-15,-6,-9,"-2,-15"
1119,720575940618713157,right,C2,345,3,-12,-9,-3,"3,-12"
1120,720575940624671724,right,C2,346,-7,-9,2,-11,"-7,-9"
1121,720575940632113747,right,C2,347,-5,-13,-2,-11,"-5,-13"
1122,720575940612990435,right,C2,348,3,14,4,10,"3,14"
1123,720575940632488223,right,C2,349,-5,-14,-2,-12,"-5,-14"
1124,720575940625829520,right,C2,350,1,15,6,9,"1,15"
1125,720575940604650464,right,C2,351,-1,-17,-8,-9,"-1,-17"
1126,720575940612691093,right,C2,352,-2,28,16,12,"-2,28"
1127,720575940613428978,right,C2,353,2,24,10,14,"2,24"
1128,720575940631597819,right,C2,354,-2,-26,-11,-15,"-2,-26"
1129,720575940625073131,right,C2,355,-7,-6,4,-10,"-7,-6"
1130,720575940626838821,right,C2,356,0,22,11,11,"0,22"
1131,720575940625926926,right,C2,357,4,17,4,13,"4,17"
1132,720575940643722519,right,C2,359,2,23,9,14,"2,23"
1133,720575940613194354,right,C2,360,-5,19,14,5,"-5,19"
1134,720575940619740363,right,C2,361,0,-7,-4,-3,"0,-7"
1135,720575940619055444,right,C2,362,2,-20,-12,-8,"2,-20"
1136,720575940624245245,right,C2,363,7,-4,-9,5,"7,-4"
1137,720575940621577899,right,C2,364,4,4,-2,6,"4,4"
1138,720575940609209948,right,C2,365,4,7,-1,8,"4,7"
1139,720575940638036157,right,C2,366,-5,-20,-5,-15,"-5,-20"
1140,720575940616231825,right,C2,367,-6,-15,-2,-13,"-6,-15"
1141,720575940609320713,right,C2,368,-4,-20,-6,-14,"-4,-20"
1142,720575940634985567,right,C2,369,5,-5,-8,3,"5,-5"
1143,720575940631412811,right,C2,371,6,-5,-9,4,"6,-5"
1144,720575940615356054,right,C2,372,1,-2,-2,0,"1,-2"
1145,720575940624403850,right,C2,373,1,-21,-12,-9,"1,-21"
1146,720575940624571430,right,C2,374,2,13,4,9,"2,13"
1147,720575940626372610,right,C2,375,-6,7,9,-2,"-6,7"
1148,720575940624765939,right,C2,376,-7,-10,2,-12,"-7,-10"
1149,720575940637099639,right,C2,377,0,7,3,4,"0,7"
1150,720575940613267222,right,C2,378,-3,18,12,6,"-3,18"
1151,720575940623561165,right,C2,379,3,-17,-12,-5,"3,-17"
1152,720575940625714215,right,C2,380,-1,29,15,14,"-1,29"
1153,720575940627655699,right,C2,381,-8,-9,3,-12,"-8,-9"
1154,720575940640519587,right,C2,382,3,-6,-6,0,"3,-6"
1155,720575940616799883,right,C2,383,-6,11,11,0,"-6,11"
1156,720575940620282304,right,C2,384,-6,-2,5,-7,"-6,-2"
1157,720575940635021081,right,C2,385,-3,-18,-6,-12,"-3,-18"
1158,720575940644072608,right,C2,386,-6,19,15,4,"-6,19"
1159,720575940621111728,right,C2,387,-1,-15,-7,-8,"-1,-15"
1160,720575940647390340,right,C2,388,3,19,6,13,"3,19"
1161,720575940638781766,right,C2,389,-6,-16,-2,-14,"-6,-16"
1162,720575940620339334,right,C2,390,-6,-9,1,-10,"-6,-9"
1163,720575940613865000,right,C2,391,4,-3,-6,3,"4,-3"
1164,720575940628376070,right,C2,392,-4,7,7,0,"-4,7"
1165,720575940620830656,right,C2,393,-1,22,12,10,"-1,22"
1166,720575940631816504,right,C2,394,-7,-8,3,-11,"-7,-8"
1167,720575940611859922,right,C2,395,0,-22,-11,-11,"0,-22"
1168,720575940627204636,right,C2,396,-1,10,6,4,"-1,10"
1169,720575940628270321,right,C2,397,-3,-19,-7,-12,"-3,-19"
1170,720575940642331789,right,C2,398,-3,22,14,8,"-3,22"
1171,720575940619614843,right,C2,399,-4,-24,-8,-16,"-4,-24"
1172,720575940613011861,right,C2,400,1,-29,-16,-13,"1,-29"
1173,720575940638598726,right,C2,401,-2,-19,-8,-11,"-2,-19"
1174,720575940620263663,right,C2,402,3,26,10,16,"3,26"
1175,720575940621799551,right,C2,403,-2,-12,-4,-8,"-2,-12"
1176,720575940636643214,right,C2,404,-1,20,11,9,"-1,20"
1177,720575940627759705,right,C2,405,3,10,2,8,"3,10"
1178,720575940615292071,right,C2,406,1,-25,-14,-11,"1,-25"
1179,720575940619184965,right,C2,407,-5,-10,0,-10,"-5,-10"
1180,720575940615065238,right,C2,408,-6,-4,4,-8,"-6,-4"
1181,720575940644530848,right,C2,409,0,-3,-2,-1,"0,-3"
1182,720575940627991292,right,C2,410,-2,-2,1,-3,"-2,-2"
1183,720575940619955403,right,C2,411,-5,-19,-5,-14,"-5,-19"
1184,720575940660834945,right,C2,412,-6,21,16,5,"-6,21"
1185,720575940629645391,right,C2,413,-2,-7,-2,-5,"-2,-7"
1186,720575940618651938,right,C2,414,4,21,6,15,"4,21"
1187,720575940618450065,right,C2,415,6,12,0,12,"6,12"
1188,720575940617582054,right,C2,416,3,-8,-7,-1,"3,-8"
1189,720575940634685847,right,C2,417,-6,-10,1,-11,"-6,-10"
1190,720575940623424982,right,C2,418,-2,15,9,6,"-2,15"
1191,720575940651885046,right,C2,419,-3,-11,-3,-8,"-3,-11"
1192,720575940636724848,right,C2,420,6,-3,-8,5,"6,-3"
1193,720575940632665145,right,C2,421,-1,12,7,5,"-1,12"
1194,720575940630272615,right,C2,422,-7,-4,5,-9,"-7,-4"
1195,720575940626940702,right,C2,423,3,-18,-12,-6,"3,-18"
1196,720575940620035264,right,C2,424,-3,-2,2,-4,"-3,-2"
1197,720575940622710366,right,C2,425,3,20,7,13,"3,20"
1198,720575940629860908,right,C2,426,-3,0,3,-3,"-3,0"
1199,720575940618056409,right,C2,427,5,-18,-14,-4,"5,-18"
1200,720575940622609276,right,C2,428,-2,23,13,10,"-2,23"
1201,720575940652190198,right,C2,429,-2,14,9,5,"-2,14"
1202,720575940647028515,right,C2,430,-3,-7,-1,-6,"-3,-7"
1203,720575940633579745,right,C2,431,-2,-10,-3,-7,"-2,-10"
1204,720575940640245813,right,C2,432,-5,7,8,-1,"-5,7"
1205,720575940631162386,right,C2,433,0,-8,-4,-4,"0,-8"
1206,720575940623497715,right,C2,434,-3,7,6,1,"-3,7"
1207,720575940630804480,right,C2,435,5,-17,-14,-3,"5,-17"
1208,720575940634667199,right,C2,436,0,-15,-8,-7,"0,-15"
1209,720575940635065369,right,C2,437,-3,12,9,3,"-3,12"
1210,720575940660816769,right,C2,438,2,27,11,16,"2,27"
1211,720575940626883453,right,C2,439,-3,-9,-2,-7,"-3,-9"
1212,720575940615388021,right,C2,440,1,23,10,13,"1,23"
1213,720575940609075157,right,C2,441,3,-16,-11,-5,"3,-16"
1214,720575940626964542,right,C2,442,-5,25,17,8,"-5,25"
1215,720575940623210281,right,C2,443,-6,4,8,-4,"-6,4"
1216,720575940609597193,right,C2,444,4,-10,-9,-1,"4,-10"
1217,720575940628524872,right,C2,445,-2,8,6,2,"-2,8"
1218,720575940622562943,right,C2,446,2,-14,-9,-5,"2,-14"
1219,720575940630437826,right,C2,447,-1,2,2,0,"-1,2"
1220,720575940626467453,right,C2,448,0,30,15,15,"0,30"
1221,720575940632602449,right,C2,449,6,-16,-14,-2,"6,-16"
1222,720575940621383540,right,C2,450,2,-9,-7,-2,"2,-9"
1223,720575940630481399,right,C2,451,4,20,6,14,"4,20"
1224,720575940638810084,right,C2,452,1,-9,-6,-3,"1,-9"
1225,720575940618868052,right,C2,453,3,25,9,16,"3,25"
1226,720575940616782534,right,C2,454,5,-12,-11,-1,"5,-12"
1227,720575940627515633,right,C2,455,7,-7,-11,4,"7,-7"
1228,720575940647690548,right,C2,456,0,21,10,11,"0,21"
1229,720575940621313304,right,C2,457,-2,17,10,7,"-2,17"
1230,720575940606673510,right,C2,458,5,0,-5,5,"5,0"
1231,720575940622800903,right,C2,459,5,-3,-7,4,"5,-3"
1232,720575940630271799,right,C2,460,-3,-20,-7,-13,"-3,-20"
1233,720575940606089900,right,C2,461,7,-5,-10,5,"7,-5"
1234,720575940627993852,right,C2,462,-1,18,10,8,"-1,18"
1235,720575940615269799,right,C2,463,5,17,3,14,"5,17"
1236,720575940612214165,right,C2,464,4,0,-4,4,"4,0"
1237,720575940621007495,right,C2,465,3,0,-3,3,"3,0"
1238,720575940622112609,right,C2,466,1,14,6,8,"1,14"
1239,720575940621962160,right,C2,467,-2,-20,-8,-12,"-2,-20"
1240,720575940620250049,right,C2,468,-3,11,8,3,"-3,11"
1241,720575940620453615,right,C2,469,-7,13,13,0,"-7,13"
1242,720575940621873908,right,C2,470,4,-9,-9,0,"4,-9"
1243,720575940619557243,right,C2,472,1,25,11,14,"1,25"
1244,720575940638594526,right,C2,473,-4,23,15,8,"-4,23"
1245,720575940621275329,right,C2,474,-3,-17,-6,-11,"-3,-17"
1246,720575940614341551,right,C2,475,-4,-1,3,-4,"-4,-1"
1247,720575940615680658,right,C2,476,-1,15,8,7,"-1,15"
1248,720575940614348967,right,C2,477,-3,2,4,-2,"-3,2"
1249,720575940611106094,right,C2,479,-2,10,7,3,"-2,10"
1250,720575940610972914,right,C2,480,3,-19,-13,-6,"3,-19"
1251,720575940637521118,right,C2,481,4,-8,-8,0,"4,-8"
1252,720575940653413622,right,C2,482,1,17,7,10,"1,17"
1253,720575940655073953,right,C2,483,2,-7,-6,-1,"2,-7"
1254,720575940622084940,right,C2,484,3,-9,-8,-1,"3,-9"
1255,720575940632134737,right,C2,485,-3,-3,1,-4,"-3,-3"
1256,720575940645619492,right,C2,486,0,1,0,1,"0,1"
1257,720575940622881868,right,C2,487,1,-1,-2,1,"1,-1"
1258,720575940617353558,right,C2,488,7,5,-5,10,"7,5"
1259,720575940613563670,right,C2,489,-3,10,8,2,"-3,10"
1260,720575940623905031,right,C2,490,-5,6,8,-2,"-5,6"
1261,720575940625968371,right,C2,491,7,-1,-8,7,"7,-1"
1262,720575940632928337,right,C2,492,-7,-2,6,-8,"-7,-2"
1263,720575940617625717,right,C2,493,-3,23,14,9,"-3,23"
1264,720575940619070493,right,C2,494,0,29,14,15,"0,29"
1265,720575940621312421,right,C2,495,4,5,-2,7,"4,5"
1266,720575940612115313,right,C2,496,7,8,-3,11,"7,8"
1267,720575940618748445,right,C2,497,6,1,-6,7,"6,1"
1268,720575940631086848,right,C2,498,6,10,-1,11,"6,10"
1269,720575940624786412,right,C2,499,5,10,0,10,"5,10"
1270,720575940631304492,right,C2,500,7,-8,-11,3,"7,-8"
1271,720575940627843224,right,C2,501,1,2,0,2,"1,2"
1272,720575940627737348,right,C2,503,3,17,5,12,"3,17"
1273,720575940621312176,right,C2,504,-2,9,6,3,"-2,9"
1274,720575940622194102,right,C2,505,6,-22,-17,-5,"6,-22"
1275,720575940618856246,right,C2,506,1,-12,-7,-5,"1,-12"
1276,720575940608157058,right,C2,507,-5,-12,-1,-11,"-5,-12"
1277,720575940614568338,right,C2,508,-5,11,10,1,"-5,11"
1278,720575940624081643,right,C2,509,-4,10,9,1,"-4,10"
1279,720575940624531348,right,C2,510,-2,11,7,4,"-2,11"
1280,720575940616887435,right,C2,511,5,-11,-11,0,"5,-11"
1281,720575940631444522,right,C2,512,6,0,-6,6,"6,0"
1282,720575940622486441,right,C2,513,-4,-13,-3,-10,"-4,-13"
1283,720575940618130260,right,C2,514,-4,-10,-1,-9,"-4,-10"
1284,720575940632579411,right,C2,515,-8,-7,4,-11,"-8,-7"
1285,720575940635262900,right,C2,516,7,-18,-16,-2,"7,-18"
1286,720575940623532471,right,C2,518,-4,22,15,7,"-4,22"
1287,720575940621571199,right,C2,519,-5,-5,2,-7,"-5,-5"
1288,720575940614476269,right,C2,520,-2,-22,-9,-13,"-2,-22"
1289,720575940615463934,right,C2,521,6,-9,-11,2,"6,-9"
1290,720575940621555137,right,C2,522,-4,0,4,-4,"-4,0"
1291,720575940623684021,right,C2,523,2,14,5,9,"2,14"
1292,720575940632225583,right,C2,524,4,-20,-14,-6,"4,-20"
1293,720575940621718182,right,C2,525,-1,-20,-9,-11,"-1,-20"
1294,720575940627680584,right,C2,526,0,-10,-5,-5,"0,-10"
1295,720575940610945122,right,C2,527,-4,-8,0,-8,"-4,-8"
1296,720575940610564164,right,C2,528,2,7,1,6,"2,7"
1297,720575940624992295,right,C2,529,2,-2,-3,1,"2,-2"
1298,720575940621692353,right,C2,530,-3,-13,-4,-9,"-3,-13"
1299,720575940632747880,right,C2,531,1,0,-1,1,"1,0"
1300,720575940606944130,right,C2,532,-8,7,11,-4,"-8,7"
1301,720575940620705995,right,C2,533,0,-16,-8,-8,"0,-16"
1302,720575940622554248,right,C2,534,3,2,-2,4,"3,2"
1303,720575940619654193,right,C2,536,3,4,-1,5,"3,4"
1304,720575940628221583,right,C2,537,0,-23,-12,-11,"0,-23"
1305,720575940628577402,right,C2,538,-4,1,4,-3,"-4,1"
1306,720575940612279961,right,C2,539,-6,15,13,2,"-6,15"
1307,720575940641936603,right,C2,540,-2,-9,-3,-6,"-2,-9"
1308,720575940611872376,right,C2,541,-4,14,11,3,"-4,14"
1309,720575940615188586,right,C2,542,6,-13,-13,0,"6,-13"
1310,720575940620695022,right,C2,543,-1,-4,-1,-3,"-1,-4"
1311,720575940625573351,right,C2,544,3,-13,-10,-3,"3,-13"
1312,720575940643891104,right,C2,545,5,11,0,11,"5,11"
1313,720575940644317476,right,C2,546,3,6,0,6,"3,6"
1314,720575940635227034,right,C2,547,-1,21,11,10,"-1,21"
1315,720575940633096785,right,C2,548,1,-16,-9,-7,"1,-16"
1316,720575940621825407,right,C2,549,0,-9,-5,-4,"0,-9"
1317,720575940614929770,right,C2,550,-2,3,3,0,"-2,3"
1318,720575940616967611,right,C2,551,-4,-9,-1,-8,"-4,-9"
1319,720575940622662877,right,C2,552,4,-1,-5,4,"4,-1"
1320,720575940617836189,right,C2,553,-3,16,11,5,"-3,16"
1321,720575940618829083,right,C2,554,-9,-3,7,-10,"-9,-3"
1322,720575940627783164,right,C2,555,-4,9,8,1,"-4,9"
1323,720575940652415734,right,C2,556,0,10,5,5,"0,10"
1324,720575940630054393,right,C2,557,6,-10,-11,1,"6,-10"
1325,720575940623792108,right,C2,558,-4,-21,-7,-14,"-4,-21"
1326,720575940613481113,right,C2,559,-6,22,17,5,"-6,22"
1327,720575940612280217,right,C2,560,-7,14,14,0,"-7,14"
1328,720575940623081827,right,C2,561,5,7,-2,9,"5,7"
1329,720575940622043998,right,C2,562,-5,-2,4,-6,"-5,-2"
1330,720575940628069393,right,C2,563,5,-13,-12,-1,"5,-13"
1331,720575940622028726,right,C2,564,3,-23,-15,-8,"3,-23"
1332,720575940616322783,right,C2,565,0,-26,-13,-13,"0,-26"
1333,720575940614790818,right,C2,566,5,-8,-9,1,"5,-8"
1334,720575940655418529,right,C2,567,-2,22,13,9,"-2,22"
1335,720575940626364197,right,C2,568,-6,-8,2,-10,"-6,-8"
1336,720575940627700888,right,C2,570,2,25,10,15,"2,25"
1337,720575940615427239,right,C2,571,0,-14,-7,-7,"0,-14"
1338,720575940614374910,right,C2,572,-8,3,9,-6,"-8,3"
1339,720575940628690453,right,C2,573,4,14,3,11,"4,14"
1340,720575940643633824,right,C2,574,-6,5,8,-3,"-6,5"
1341,720575940628368915,right,C2,576,0,28,14,14,"0,28"
1342,720575940617813814,right,C2,577,5,-14,-12,-2,"5,-14"
1343,720575940622195700,right,C2,578,4,-11,-10,-1,"4,-11"
1344,720575940605974630,right,C2,579,-3,-10,-2,-8,"-3,-10"
1345,720575940618763291,right,C2,580,-2,-23,-10,-13,"-2,-23"
1346,720575940615774358,right,C2,581,3,9,1,8,"3,9"
1347,720575940624584231,right,C2,582,-1,23,12,11,"-1,23"
1348,720575940634707937,right,C2,583,3,-25,-16,-9,"3,-25"
1349,720575940636433076,right,C2,584,4,23,7,16,"4,23"
1350,720575940613497366,right,C2,585,-1,-23,-11,-12,"-1,-23"
1351,720575940634687388,right,C2,586,2,18,7,11,"2,18"
1352,720575940614560808,right,C2,587,4,22,7,15,"4,22"
1353,720575940621933556,right,C2,588,1,4,1,3,"1,4"
1354,720575940615779046,right,C2,589,-1,-5,-2,-3,"-1,-5"
1355,720575940634181075,right,C2,590,1,9,3,6,"1,9"
1356,720575940647362083,right,C2,591,3,-3,-5,2,"3,-3"
1357,720575940631637243,right,C2,593,3,-14,-10,-4,"3,-14"
1358,720575940612839889,right,C2,594,7,-16,-15,-1,"7,-16"
1359,720575940635267735,right,C2,595,7,-12,-13,1,"7,-12"
1360,720575940623066003,right,C2,596,-4,-16,-4,-12,"-4,-16"
1361,720575940636883374,right,C2,597,4,1,-4,5,"4,1"
1362,720575940631402870,right,C2,598,2,-18,-11,-7,"2,-18"
1363,720575940628138664,right,C2,599,-1,9,5,4,"-1,9"
1364,720575940617666443,right,C2,600,3,-10,-8,-2,"3,-10"
1365,720575940623959178,right,C2,601,1,16,7,9,"1,16"
1366,720575940633089676,right,C2,602,4,-2,-5,3,"4,-2"
1367,720575940623976461,right,C2,603,-3,-23,-9,-14,"-3,-23"
1368,720575940627902351,right,C2,604,-6,-17,-3,-14,"-6,-17"
1369,720575940612863858,right,C2,605,3,15,4,11,"3,15"
1370,720575940614277859,right,C2,606,-1,-19,-9,-10,"-1,-19"
1371,720575940621020737,right,C2,607,1,18,8,10,"1,18"
1372,720575940609090571,right,C2,608,1,10,4,6,"1,10"
1373,720575940620689134,right,C2,609,-2,0,2,-2,"-2,0"
1374,720575940631099679,right,C2,610,2,-23,-14,-9,"2,-23"
1375,720575940620633560,right,C2,611,-1,-18,-8,-10,"-1,-18"
1376,720575940621941274,right,C2,613,-8,-4,6,-10,"-8,-4"
1377,720575940640655824,right,C2,614,-2,-8,-2,-6,"-2,-8"
1378,720575940644715936,right,C2,616,-3,15,10,5,"-3,15"
1379,720575940633057188,right,C2,617,-2,-17,-7,-10,"-2,-17"
1380,720575940623606313,right,C2,618,-1,24,13,11,"-1,24"
1381,720575940618393885,right,C2,619,-4,-19,-6,-13,"-4,-19"
1382,720575940611627730,right,C2,620,7,1,-7,8,"7,1"
1383,720575940613843251,right,C2,621,1,24,11,13,"1,24"
1384,720575940620109076,right,C2,622,-5,20,15,5,"-5,20"
1385,720575940645761303,right,C2,623,1,13,5,8,"1,13"
1386,720575940631866922,right,C2,624,1,-17,-10,-7,"1,-17"
1387,720575940624957448,right,C2,625,-2,24,14,10,"-2,24"
1388,720575940634984032,right,C2,626,-5,-8,1,-9,"-5,-8"
1389,720575940621500864,right,C2,627,0,-1,-1,0,"0,-1"
1390,720575940625537511,right,C2,628,0,0,0,0,"0,0"
1391,720575940646226467,right,C2,629,4,24,8,16,"4,24"
1392,720575940610260419,right,C2,630,4,8,0,8,"4,8"
1393,720575940629061063,right,C2,631,1,26,12,14,"1,26"
1394,720575940644868296,right,C2,632,3,-20,-13,-7,"3,-20"
1395,720575940632473667,right,C2,633,-1,-24,-11,-13,"-1,-24"
1396,720575940638781417,right,C2,634,-3,-15,-5,-10,"-3,-15"
1397,720575940630988544,right,C2,635,6,-6,-9,3,"6,-6"
1398,720575940617356545,right,C2,636,0,6,3,3,"0,6"
1399,720575940617449913,right,C2,637,3,-21,-14,-7,"3,-21"
1400,720575940632663716,right,C2,638,-1,7,4,3,"-1,7"
1401,720575940621805172,right,C2,639,-4,19,13,6,"-4,19"
1402,720575940629038332,right,C2,640,-1,-16,-7,-9,"-1,-16"
1403,720575940626550403,right,C2,641,-8,-5,5,-10,"-8,-5"
1404,720575940613653219,right,C2,642,-5,-11,-1,-10,"-5,-11"
1405,720575940625341171,right,C2,643,6,14,1,13,"6,14"
1406,720575940609263115,right,C2,644,-6,18,15,3,"-6,18"
1407,720575940623786495,right,C2,645,-4,27,17,10,"-4,27"
1408,720575940614529261,right,C2,646,6,17,2,15,"6,17"
1409,720575940614282792,right,C2,647,-4,-7,0,-7,"-4,-7"
1410,720575940647056163,right,C2,648,1,7,2,5,"1,7"
1411,720575940650770297,right,C2,649,-1,5,3,2,"-1,5"
1412,720575940629098492,right,C2,650,-3,-25,-10,-15,"-3,-25"
1413,720575940622489814,right,C2,651,-4,-5,1,-6,"-4,-5"
1414,720575940610288964,right,C2,653,-6,-12,0,-12,"-6,-12"
1415,720575940605504446,right,C2,654,-3,8,7,1,"-3,8"
1416,720575940615259030,right,C2,655,6,-1,-7,6,"6,-1"
1417,720575940640531032,right,C2,656,0,-11,-6,-5,"0,-11"
1418,720575940625178376,right,C2,657,-2,-25,-11,-14,"-2,-25"
1419,720575940621305515,right,C2,658,1,20,9,11,"1,20"
1420,720575940628768528,right,C2,659,-4,-6,1,-7,"-4,-6"
1421,720575940614151651,right,C2,661,-3,14,10,4,"-3,14"
1422,720575940628326922,right,C2,662,2,-1,-3,2,"2,-1"
1423,720575940632218984,right,C2,663,0,8,4,4,"0,8"
1424,720575940624431398,right,C2,664,1,-27,-15,-12,"1,-27"
1425,720575940631605132,right,C2,665,7,-2,-8,6,"7,-2"
1426,720575940635408279,right,C2,666,7,-13,-14,1,"7,-13"
1427,720575940640025141,right,C2,667,1,-28,-15,-13,"1,-28"
1428,720575940639445923,right,C2,668,1,19,8,11,"1,19"
1429,720575940633403167,right,C2,669,4,-16,-12,-4,"4,-16"
1430,720575940614503731,right,C2,671,-4,-23,-8,-15,"-4,-23"
1431,720575940624080619,right,C2,672,-8,11,13,-2,"-8,11"
1432,720575940635590767,right,C2,673,2,5,0,5,"2,5"
1433,720575940631868008,right,C2,674,-4,-14,-3,-11,"-4,-14"
1434,720575940629555578,right,C2,675,-7,19,16,3,"-7,19"
1435,720575940622219340,right,C2,676,-3,-21,-8,-13,"-3,-21"
1436,720575940630428672,right,C2,677,0,11,5,6,"0,11"
1437,720575940621143617,right,C2,678,3,-7,-7,0,"3,-7"
1438,720575940635264924,right,C2,679,4,18,5,13,"4,18"
1439,720575940607199580,right,C2,680,-1,25,13,12,"-1,25"
1440,720575940623104862,right,C2,681,-2,-21,-9,-12,"-2,-21"
1441,720575940614793378,right,C2,682,6,-8,-10,2,"6,-8"
1442,720575940620685806,right,C2,683,2,6,1,5,"2,6"
1443,720575940628039250,right,C2,684,-6,17,14,3,"-6,17"
1444,720575940626839652,right,C2,685,-5,-9,0,-9,"-5,-9"
1445,720575940623367050,right,C2,686,5,-22,-16,-6,"5,-22"
1446,720575940617042235,right,C2,687,-6,-3,4,-7,"-6,-3"
1447,720575940625532564,right,C2,688,-7,10,12,-2,"-7,10"
1448,720575940621579691,right,C2,690,-7,-3,5,-8,"-7,-3"
1449,720575940638488553,right,C2,692,-4,24,16,8,"-4,24"
1450,720575940627092617,right,C2,693,-3,25,15,10,"-3,25"
1451,720575940654444961,right,C2,695,-6,10,11,-1,"-6,10"
1452,720575940630975831,right,C2,696,-2,16,10,6,"-2,16"
1453,720575940627759961,right,C2,697,1,-22,-12,-10,"1,-22"
1454,720575940638405722,right,C2,698,6,-7,-10,3,"6,-7"
1455,720575940609178051,right,C2,699,-5,0,5,-5,"-5,0"
1456,720575940610960646,right,C2,700,5,15,2,13,"5,15"
1457,720575940641583835,right,C2,701,0,-4,-2,-2,"0,-4"
1458,720575940636134495,right,C2,702,-5,23,16,7,"-5,23"
1459,720575940613352106,right,C2,703,-3,1,3,-2,"-3,1"
1460,720575940622346846,right,C2,704,-7,8,11,-3,"-7,8"
1461,720575940626890186,right,C2,705,1,1,-1,2,"1,1"
1462,720575940628899304,right,C2,706,-7,-12,1,-13,"-7,-12"
1463,720575940614614509,right,C2,707,-2,25,14,11,"-2,25"
1464,720575940622711517,right,C2,709,-2,-24,-10,-14,"-2,-24"
1465,720575940627080122,right,C2,710,4,-25,-17,-8,"4,-25"
1466,720575940623720885,right,C2,711,-1,19,10,9,"-1,19"
1467,720575940630907729,right,C2,712,-7,12,13,-1,"-7,12"
1468,720575940626437732,right,C2,713,-6,16,14,2,"-6,16"
1469,720575940605622193,right,C2,714,5,12,1,11,"5,12"
1470,720575940612549910,right,C2,715,4,10,1,9,"4,10"
1471,720575940621791727,right,C2,716,4,-6,-7,1,"4,-6"
1472,720575940656148897,right,C2,717,2,-22,-13,-9,"2,-22"
1473,720575940648608132,right,C2,718,-5,24,17,7,"-5,24"
1474,720575940644585160,right,C2,719,1,27,12,15,"1,27"
1475,720575940628571753,right,C2,720,-5,21,15,6,"-5,21"
1476,720575940624963255,right,C2,721,5,13,1,12,"5,13"
1477,720575940634210003,right,C2,722,6,-15,-14,-1,"6,-15"
1478,720575940623344086,right,C2,723,-2,-11,-4,-7,"-2,-11"
1479,720575940636023159,right,C2,724,4,2,-3,5,"4,2"
1480,720575940620570453,right,C2,725,-3,-24,-9,-15,"-3,-24"
1481,720575940630852396,right,C2,726,2,-28,-16,-12,"2,-28"
1482,720575940626065948,right,C2,728,7,12,-1,13,"7,12"
1483,720575940611658389,right,C2,731,-6,9,10,-1,"-6,9"
1484,720575940635471540,right,C2,732,-3,6,6,0,"-3,6"
1485,720575940630790188,right,C2,733,-5,-17,-4,-13,"-5,-17"
1486,720575940609237973,right,C2,734,2,0,-2,2,"2,0"
1487,720575940645081288,right,C2,735,1,-23,-13,-10,"1,-23"
1488,720575940639645859,right,C2,736,-8,1,8,-7,"-8,1"
1489,720575940621029803,right,C2,737,0,19,9,10,"0,19"
1490,720575940626972797,right,C2,738,-3,13,9,4,"-3,13"
1491,720575940621913114,right,C2,739,-7,2,8,-6,"-7,2"
1492,720575940628434490,right,C2,740,2,-8,-6,-2,"2,-8"
1493,720575940649255801,right,C2,741,-2,-14,-5,-9,"-2,-14"
1494,720575940618342329,right,C2,742,-4,11,9,2,"-4,11"
1495,720575940639802557,right,C2,744,-4,25,16,9,"-4,25"
1496,720575940614702047,right,C2,745,0,13,6,7,"0,13"
1497,720575940624842791,right,C2,746,-3,3,4,-1,"-3,3"
1498,720575940621653718,right,C2,747,0,2,1,1,"0,2"
1499,720575940640403790,right,C2,748,-4,20,14,6,"-4,20"
1500,720575940630316375,right,C2,749,-2,1,2,-1,"-2,1"
1501,720575940622961441,right,C2,750,4,-24,-16,-8,"4,-24"
1502,720575940608310914,right,C2,751,1,6,2,4,"1,6"
1503,720575940624283143,right,C2,752,-2,7,5,2,"-2,7"
1504,720575940625845991,right,C2,753,-3,24,15,9,"-3,24"
1505,720575940603435232,right,C2,754,-1,-13,-6,-7,"-1,-13"
1506,720575940621757308,right,C2,755,4,19,5,14,"4,19"
1507,720575940638452190,right,C2,756,5,20,5,15,"5,20"
1508,720575940646427171,right,C2,757,0,-6,-3,-3,"0,-6"
1509,720575940645151432,right,C2,758,5,-1,-6,5,"5,-1"
1510,720575940625970178,right,C2,760,0,17,8,9,"0,17"
1511,720575940638398185,right,C2,761,-4,-18,-5,-13,"-4,-18"
1512,720575940629889530,right,C2,762,0,14,7,7,"0,14"
1513,720575940635142495,right,C2,763,-5,14,12,2,"-5,14"
1514,720575940626121828,right,C2,764,-8,-6,5,-11,"-8,-6"
1515,720575940627550376,right,C2,765,-3,9,7,2,"-3,9"
1516,720575940629508602,right,C2,766,2,-4,-4,0,"2,-4"
1517,720575940627298691,right,C2,767,1,28,13,15,"1,28"
1518,720575940623500295,right,C2,768,3,5,-1,6,"3,5"
1519,720575940629591040,right,C2,769,4,-27,-18,-9,"4,-27"
1520,720575940618400230,right,C2,770,5,4,-3,7,"5,4"
1521,720575940636481391,right,C2,772,1,12,5,7,"1,12"
1522,720575940647877252,right,C2,773,5,-19,-15,-4,"5,-19"
1523,720575940617859643,right,C2,774,-8,6,11,-5,"-8,6"
1524,720575940616311750,right,C2,775,5,22,6,16,"5,22"
1525,720575940621599216,right,C2,776,5,21,5,16,"5,21"
1526,720575940612693544,right,C2,777,6,20,4,16,"6,20"
1527,720575940618589953,right,C2,779,5,24,7,17,"5,24"
1528,720575940620981584,right,C2,780,-6,25,18,7,"-6,25"
1529,720575940620731989,right,C2,781,-5,26,18,8,"-5,26"
1530,720575940623109658,right,C2,783,-4,28,18,10,"-4,28"
1531,720575940634993177,right,C2,787,3,28,11,17,"3,28"
1532,720575940639138281,right,C2,789,-3,-27,-11,-16,"-3,-27"
1533,720575940612238798,right,C2,790,-2,-27,-12,-15,"-2,-27"
1534,720575940606613536,right,C2,791,-1,-28,-13,-15,"-1,-28"
1535,720575940620182182,right,C2,792,8,2,-7,9,"8,2"
1536,720575940630240316,right,C2,793,8,-6,-11,5,"8,-6"
1537,720575940639181887,right,C2,794,5,-26,-18,-8,"5,-26"
1538,720575940641987829,right,C2,795,6,-21,-17,-4,"6,-21"
1539,720575940624400713,right,C3,1,-6,13,12,1,"-6,13"
1540,720575940629948983,right,C3,2,-8,2,9,-7,"-8,2"
1541,720575940609734357,right,C3,3,6,-12,-12,0,"6,-12"
1542,720575940633092492,right,C3,4,-5,-21,-6,-15,"-5,-21"
1543,720575940622127740,right,C3,5,-1,16,9,7,"-1,16"
1544,720575940626359117,right,C3,6,-2,-4,0,-4,"-2,-4"
1545,720575940646026116,right,C3,7,-6,-6,3,-9,"-6,-6"
1546,720575940623110426,right,C3,8,-4,26,17,9,"-4,26"
1547,720575940613326322,right,C3,9,4,9,0,9,"4,9"
1548,720575940623150728,right,C3,10,5,-15,-13,-2,"5,-15"
1549,720575940614791730,right,C3,11,7,-14,-14,0,"7,-14"
1550,720575940620613717,right,C3,12,-7,9,11,-2,"-7,9"
1551,720575940626049575,right,C3,13,-1,-26,-12,-14,"-1,-26"
1552,720575940620889547,right,C3,14,0,-27,-14,-13,"0,-27"
1553,720575940637690970,right,C3,15,2,-3,-4,1,"2,-3"
1554,720575940612544921,right,C3,16,-2,-16,-6,-10,"-2,-16"
1555,720575940631884359,right,C3,17,1,-5,-4,-1,"1,-5"
1556,720575940620613766,right,C3,18,5,-16,-13,-3,"5,-16"
1557,720575940635093099,right,C3,19,-7,17,15,2,"-7,17"
1558,720575940623810608,right,C3,20,3,-11,-9,-2,"3,-11"
1559,720575940634888855,right,C3,21,-2,19,11,8,"-2,19"
1560,720575940630183931,right,C3,22,-1,3,2,1,"-1,3"
1561,720575940617833762,right,C3,23,-3,-16,-5,-11,"-3,-16"
1562,720575940612683816,right,C3,24,-1,-10,-4,-6,"-1,-10"
1563,720575940614726854,right,C3,25,-9,3,10,-7,"-9,3"
1564,720575940619767893,right,C3,26,1,-3,-3,0,"1,-3"
1565,720575940627979141,right,C3,27,0,-25,-13,-12,"0,-25"
1566,720575940628434248,right,C3,28,5,6,-2,8,"5,6"
1567,720575940624134985,right,C3,29,-1,-3,-1,-2,"-1,-3"
1568,720575940639757683,right,C3,30,6,16,2,14,"6,16"
1569,720575940639075647,right,C3,31,0,16,8,8,"0,16"
1570,720575940613184995,right,C3,32,0,12,6,6,"0,12"
1571,720575940622113633,right,C3,33,3,18,6,12,"3,18"
1572,720575940608176818,right,C3,34,6,18,3,15,"6,18"
1573,720575940635265436,right,C3,35,1,-24,-13,-11,"1,-24"
1574,720575940643706784,right,C3,36,6,8,-2,10,"6,8"
1575,720575940639224179,right,C3,37,1,5,1,4,"1,5"
1576,720575940661264001,right,C3,38,0,-2,-1,-1,"0,-2"
1577,720575940605834161,right,C3,39,0,20,10,10,"0,20"
1578,720575940623117862,right,C3,40,-2,-6,-1,-5,"-2,-6"
1579,720575940622448368,right,C3,41,-3,28,17,11,"-3,28"
1580,720575940605610784,right,C3,42,-1,14,8,6,"-1,14"
1581,720575940619563723,right,C3,43,-5,18,14,4,"-5,18"
1582,720575940622704922,right,C3,44,5,-10,-10,0,"5,-10"
1583,720575940639071551,right,C3,45,-5,-1,4,-5,"-5,-1"
1584,720575940639466045,right,C3,46,-5,15,12,3,"-5,15"
1585,720575940626207234,right,C3,47,-9,-1,8,-9,"-9,-1"
1586,720575940624784648,right,C3,48,-4,-22,-7,-15,"-4,-22"
1587,720575940606709449,right,C3,49,4,-4,-6,2,"4,-4"
1588,720575940621180097,right,C3,50,-2,21,12,9,"-2,21"
1589,720575940625548728,right,C3,51,0,-19,-10,-9,"0,-19"
1590,720575940623590378,right,C3,52,-1,-22,-10,-12,"-1,-22"
1591,720575940627737725,right,C3,53,5,14,2,12,"5,14"
1592,720575940609088348,right,C3,54,-4,3,5,-2,"-4,3"
1593,720575940647264132,right,C3,55,-4,-11,-2,-9,"-4,-11"
1594,720575940623977059,right,C3,56,1,-13,-8,-5,"1,-13"
1595,720575940638023024,right,C3,57,6,-11,-12,1,"6,-11"
1596,720575940610974254,right,C3,58,3,12,3,9,"3,12"
1597,720575940622402943,right,C3,59,-2,2,3,-1,"-2,2"
1598,720575940636971497,right,C3,60,-8,8,12,-4,"-8,8"
1599,720575940610235086,right,C3,61,-4,-4,2,-6,"-4,-4"
1600,720575940606872241,right,C3,62,0,-29,-15,-14,"0,-29"
1601,720575940611179054,right,C3,63,4,12,2,10,"4,12"
1602,720575940626040508,right,C3,64,4,-23,-16,-7,"4,-23"
1603,720575940625609452,right,C3,66,2,15,5,10,"2,15"
1604,720575940615359647,right,C3,67,-2,-13,-5,-8,"-2,-13"
1605,720575940635473503,right,C3,68,3,16,5,11,"3,16"
1606,720575940620852833,right,C3,69,1,8,3,5,"1,8"
1607,720575940610497582,right,C3,70,-4,21,14,7,"-4,21"
1608,720575940628767248,right,C3,71,-2,-3,0,-3,"-2,-3"
1609,720575940621347749,right,C3,72,0,-28,-14,-14,"0,-28"
1610,720575940630612987,right,C3,73,2,2,-1,3,"2,2"
1611,720575940632637215,right,C3,74,-1,-9,-4,-5,"-1,-9"
1612,720575940626029200,right,C3,75,-6,14,13,1,"-6,14"
1613,720575940617835547,right,C3,76,-3,-4,1,-5,"-3,-4"
1614,720575940629408497,right,C3,77,2,-5,-5,0,"2,-5"
1615,720575940630283068,right,C3,78,2,20,8,12,"2,20"
1616,720575940632415116,right,C3,79,2,1,-2,3,"2,1"
1617,720575940624543271,right,C3,81,6,-2,-7,5,"6,-2"
1618,720575940626648836,right,C3,82,-7,7,10,-3,"-7,7"
1619,720575940614528040,right,C3,83,2,-21,-13,-8,"2,-21"
1620,720575940644774167,right,C3,84,-2,12,8,4,"-2,12"
1621,720575940622740208,right,C3,85,4,-22,-15,-7,"4,-22"
1622,720575940632524627,right,C3,86,-5,-7,1,-8,"-5,-7"
1623,720575940607184329,right,C3,87,1,11,4,7,"1,11"
1624,720575940627505283,right,C3,88,7,4,-5,9,"7,4"
1625,720575940630767097,right,C3,89,1,-19,-11,-8,"1,-19"
1626,720575940611973489,right,C3,90,-4,5,6,-1,"-4,5"
1627,720575940616839730,right,C3,91,-1,6,4,2,"-1,6"
1628,720575940639466054,right,C3,92,0,9,4,5,"0,9"
1629,720575940607235593,right,C3,93,-6,3,7,-4,"-6,3"
1630,720575940612552946,right,C3,94,5,18,4,14,"5,18"
1631,720575940611846769,right,C3,95,4,-21,-15,-6,"4,-21"
1632,720575940633247569,right,C3,96,1,-10,-6,-4,"1,-10"
1633,720575940622480408,right,C3,97,-5,2,6,-4,"-5,2"
1634,720575940629497094,right,C3,98,-1,-12,-5,-7,"-1,-12"
1635,720575940616274827,right,C3,99,4,15,3,12,"4,15"
1636,720575940626572837,right,C3,100,2,-10,-7,-3,"2,-10"
1637,720575940621595937,right,C3,101,-7,6,10,-4,"-7,6"
1638,720575940613472741,right,C3,102,3,13,3,10,"3,13"
1639,720575940628550916,right,C3,103,7,9,-3,12,"7,9"
1640,720575940614708236,right,C3,105,3,22,8,14,"3,22"
1641,720575940620223281,right,C3,106,-7,11,12,-1,"-7,11"
1642,720575940624859623,right,C3,107,8,-2,-9,7,"8,-2"
1643,720575940616209932,right,C3,108,-3,-12,-3,-9,"-3,-12"
1644,720575940614792098,right,C3,109,4,-5,-7,2,"4,-5"
1645,720575940625817232,right,C3,110,-7,0,7,-7,"-7,0"
1646,720575940619074587,right,C3,111,2,-24,-14,-10,"2,-24"
1647,720575940612739989,right,C3,112,-6,1,6,-5,"-6,1"
1648,720575940639216499,right,C3,113,-2,4,4,0,"-2,4"
1649,720575940631246863,right,C3,114,2,-13,-9,-4,"2,-13"
1650,720575940640405582,right,C3,115,-4,2,5,-3,"-4,2"
1651,720575940614697127,right,C3,116,-1,-8,-3,-5,"-1,-8"
1652,720575940652456438,right,C3,117,-8,-2,7,-9,"-8,-2"
1653,720575940632763935,right,C3,118,3,1,-3,4,"3,1"
1654,720575940608061826,right,C3,119,-2,6,5,1,"-2,6"
1655,720575940618882171,right,C3,120,-1,-1,0,-1,"-1,-1"
1656,720575940616599618,right,C3,121,-8,4,10,-6,"-8,4"
1657,720575940629123177,right,C3,122,-5,9,9,0,"-5,9"
1658,720575940629976323,right,C3,123,-8,10,13,-3,"-8,10"
1659,720575940616568114,right,C3,124,1,-7,-5,-2,"1,-7"
1660,720575940626290946,right,C3,125,5,9,-1,10,"5,9"
1661,720575940610426051,right,C3,126,3,11,2,9,"3,11"
1662,720575940604476774,right,C3,127,0,15,7,8,"0,15"
1663,720575940620688110,right,C3,128,3,-22,-14,-8,"3,-22"
1664,720575940622053381,right,C3,129,0,-13,-7,-6,"0,-13"
1665,720575940613485608,right,C3,130,2,12,4,8,"2,12"
1666,720575940652374518,right,C3,131,-6,20,16,4,"-6,20"
1667,720575940631294531,right,C3,132,2,4,0,4,"2,4"
1668,720575940637328198,right,C3,133,-3,20,13,7,"-3,20"
1669,720575940625716628,right,C3,134,-5,-18,-4,-14,"-5,-18"
1670,720575940614839739,right,C3,135,-3,-22,-8,-14,"-3,-22"
1671,720575940623006758,right,C3,136,0,3,1,2,"0,3"
1672,720575940612455282,right,C3,137,5,-7,-9,2,"5,-7"
1673,720575940621870445,right,C3,138,0,27,13,14,"0,27"
1674,720575940630161463,right,C3,139,1,-14,-8,-6,"1,-14"
1675,720575940636712055,right,C3,140,3,8,1,7,"3,8"
1676,720575940628077138,right,C3,141,5,-23,-17,-6,"5,-23"
1677,720575940614222801,right,C3,142,-2,-18,-7,-11,"-2,-18"
1678,720575940623012702,right,C3,143,-4,16,12,4,"-4,16"
1679,720575940622847749,right,C3,144,7,-11,-13,2,"7,-11"
1680,720575940642370011,right,C3,145,0,4,2,2,"0,4"
1681,720575940636108407,right,C3,146,1,-6,-4,-2,"1,-6"
1682,720575940620571409,right,C3,147,1,21,9,12,"1,21"
1683,720575940604521440,right,C3,148,-7,-11,1,-12,"-7,-11"
1684,720575940622829309,right,C3,149,6,-14,-13,-1,"6,-14"
1685,720575940630546171,right,C3,150,-8,5,10,-5,"-8,5"
1686,720575940631420268,right,C3,151,-3,-14,-4,-10,"-3,-14"
1687,720575940613819670,right,C3,152,3,-15,-11,-4,"3,-15"
1688,720575940608278364,right,C3,153,8,0,-8,8,"8,0"
1689,720575940636717230,right,C3,154,-8,0,8,-8,"-8,0"
1690,720575940629646583,right,C3,155,-8,13,14,-1,"-8,13"
1691,720575940631115794,right,C3,156,-9,1,9,-8,"-9,1"
1692,720575940624492176,right,C3,157,-1,-7,-3,-4,"-1,-7"
1693,720575940625776115,right,C3,158,3,-5,-6,1,"3,-5"
1694,720575940623626995,right,C3,160,-2,20,12,8,"-2,20"
1695,720575940631408758,right,C3,161,4,-14,-11,-3,"4,-14"
1696,720575940632330344,right,C3,162,-4,-2,3,-5,"-4,-2"
1697,720575940620968277,right,C3,163,-9,7,12,-5,"-9,7"
1698,720575940619964039,right,C3,164,-1,-2,0,-2,"-1,-2"
1699,720575940624567334,right,C3,165,4,16,4,12,"4,16"
1700,720575940632264040,right,C3,166,0,18,9,9,"0,18"
1701,720575940636601742,right,C3,167,0,-17,-9,-8,"0,-17"
1702,720575940615916594,right,C3,168,-1,17,9,8,"-1,17"
1703,720575940629573626,right,C3,169,0,-18,-9,-9,"0,-18"
1704,720575940640455808,right,C3,170,-5,1,5,-4,"-5,1"
1705,720575940625879754,right,C3,171,6,-20,-16,-4,"6,-20"
1706,720575940630715518,right,C3,172,1,22,10,12,"1,22"
1707,720575940612421874,right,C3,173,2,-25,-15,-10,"2,-25"
1708,720575940615406994,right,C3,174,4,-15,-12,-3,"4,-15"
1709,720575940632059532,right,C3,175,-6,-7,2,-9,"-6,-7"
1710,720575940615466655,right,C3,176,-2,13,8,5,"-2,13"
1711,720575940632085063,right,C3,177,-2,-1,1,-2,"-2,-1"
1712,720575940613692950,right,C3,178,2,11,3,8,"2,11"
1713,720575940614071505,right,C3,179,-5,-16,-3,-13,"-5,-16"
1714,720575940633542995,right,C3,180,2,-27,-16,-11,"2,-27"
1715,720575940638211300,right,C3,181,1,-4,-3,-1,"1,-4"
1716,720575940618000541,right,C3,182,7,-10,-12,2,"7,-10"
1717,720575940661245825,right,C3,183,-5,-15,-3,-12,"-5,-15"
1718,720575940627994108,right,C3,184,-6,-5,3,-8,"-6,-5"
1719,720575940639217085,right,C3,185,2,-11,-8,-3,"2,-11"
1720,720575940630870615,right,C3,186,-1,26,14,12,"-1,26"
1721,720575940620054101,right,C3,187,3,21,7,14,"3,21"
1722,720575940632264003,right,C3,188,-5,17,13,4,"-5,17"
1723,720575940626837117,right,C3,189,6,13,0,13,"6,13"
1724,720575940620262848,right,C3,190,-3,-5,0,-5,"-3,-5"
1725,720575940609036757,right,C3,191,-1,-11,-5,-6,"-1,-11"
1726,720575940625937338,right,C3,192,7,10,-2,12,"7,10"
1727,720575940622895885,right,C3,193,-5,4,7,-3,"-5,4"
1728,720575940610001109,right,C3,194,0,-5,-3,-2,"0,-5"
1729,720575940622921421,right,C3,195,-3,-1,2,-3,"-3,-1"
1730,720575940613671594,right,C3,196,-1,8,5,3,"-1,8"
1731,720575940630315770,right,C3,197,0,-20,-10,-10,"0,-20"
1732,720575940605174304,right,C3,198,6,2,-5,7,"6,2"
1733,720575940604692704,right,C3,199,0,-12,-6,-6,"0,-12"
1734,720575940630445911,right,C3,200,-5,12,11,1,"-5,12"
1735,720575940630243943,right,C3,201,-8,9,12,-3,"-8,9"
1736,720575940615601575,right,C3,202,-1,27,14,13,"-1,27"
1737,720575940647633460,right,C3,203,3,-1,-4,3,"3,-1"
1738,720575940631143724,right,C3,204,5,-2,-6,4,"5,-2"
1739,720575940632621988,right,C3,205,5,-6,-8,2,"5,-6"
1740,720575940639489955,right,C3,206,-3,5,5,0,"-3,5"
1741,720575940623448188,right,C3,207,1,29,13,16,"1,29"
1742,720575940632313931,right,C3,208,5,-21,-16,-5,"5,-21"
1743,720575940617200601,right,C3,209,-3,-8,-1,-7,"-3,-8"
1744,720575940623818421,right,C3,210,-6,8,10,-2,"-6,8"
1745,720575940631827256,right,C3,211,-7,-1,6,-7,"-7,-1"
1746,720575940620826733,right,C3,212,2,-16,-10,-6,"2,-16"
1747,720575940604307936,right,C3,213,3,-4,-5,1,"3,-4"
1748,720575940634840767,right,C3,214,-5,3,6,-3,"-5,3"
1749,720575940630765946,right,C3,215,6,7,-3,10,"6,7"
1750,720575940639939280,right,C3,216,2,19,7,12,"2,19"
1751,720575940621462918,right,C3,217,6,15,1,14,"6,15"
1752,720575940618749238,right,C3,218,2,10,3,7,"2,10"
1753,720575940611274725,right,C3,219,6,-4,-8,4,"6,-4"
1754,720575940610902738,right,C3,220,2,-6,-5,-1,"2,-6"
1755,720575940615497383,right,C3,221,-7,3,8,-5,"-7,3"
1756,720575940635558904,right,C3,222,-3,26,16,10,"-3,26"
1757,720575940620639329,right,C3,223,-2,26,15,11,"-2,26"
1758,720575940622186793,right,C3,224,0,5,2,3,"0,5"
1759,720575940628350538,right,C3,225,2,-26,-15,-11,"2,-26"
1760,720575940641064333,right,C3,226,5,19,4,15,"5,19"
1761,720575940631855185,right,C3,227,-7,5,9,-4,"-7,5"
1762,720575940620659053,right,C3,228,-7,1,7,-6,"-7,1"
1763,720575940623910349,right,C3,229,5,2,-4,6,"5,2"
1764,720575940638786118,right,C3,230,2,9,2,7,"2,9"
1765,720575940618736448,right,C3,231,4,-12,-10,-2,"4,-12"
1766,720575940629991243,right,C3,232,-4,13,10,3,"-4,13"
1767,720575940632154439,right,C3,233,4,-13,-11,-2,"4,-13"
1768,720575940625022707,right,C3,234,1,3,0,3,"1,3"
1769,720575940640413347,right,C3,235,4,11,1,10,"4,11"
1770,720575940618813248,right,C3,236,-1,4,3,1,"-1,4"
1771,720575940625846814,right,C3,237,-2,27,15,12,"-2,27"
1772,720575940617602843,right,C3,238,-8,-3,6,-9,"-8,-3"
1773,720575940621954081,right,C3,239,-6,6,9,-3,"-6,6"
1774,720575940611266510,right,C3,240,-4,-3,2,-5,"-4,-3"
1775,720575940623151496,right,C3,241,2,-17,-11,-6,"2,-17"
1776,720575940607332873,right,C3,242,-4,6,7,-1,"-4,6"
1777,720575940634003885,right,C3,243,-1,-21,-10,-11,"-1,-21"
1778,720575940620786342,right,C3,244,-4,-12,-2,-10,"-4,-12"
1779,720575940612997093,right,C3,245,-5,-3,3,-6,"-5,-3"
1780,720575940647051043,right,C3,246,-4,15,11,4,"-4,15"
1781,720575940617753758,right,C3,247,-4,-15,-4,-11,"-4,-15"
1782,720575940627242737,right,C3,248,-6,0,6,-6,"-6,0"
1783,720575940623921159,right,C3,249,2,-12,-8,-4,"2,-12"
1784,720575940644675694,right,C3,250,-1,1,1,0,"-1,1"
1785,720575940627394314,right,C3,251,-1,-14,-6,-8,"-1,-14"
1786,720575940637474928,right,C3,252,3,23,8,15,"3,23"
1787,720575940623724899,right,C3,253,5,16,3,13,"5,16"
1788,720575940627416457,right,C3,254,3,-24,-15,-9,"3,-24"
1789,720575940620707098,right,C3,255,-6,-13,-1,-12,"-6,-13"
1790,720575940625969594,right,C3,256,5,-20,-15,-5,"5,-20"
1791,720575940612037594,right,C3,257,2,21,8,13,"2,21"
1792,720575940621966249,right,C3,258,-4,-17,-5,-12,"-4,-17"
1793,720575940618084445,right,C3,259,-7,-5,4,-9,"-7,-5"
1794,720575940633792737,right,C3,260,-3,19,12,7,"-3,19"
1795,720575940612551321,right,C3,261,-1,13,7,6,"-1,13"
1796,720575940620830635,right,C3,262,1,-11,-7,-4,"1,-11"
1797,720575940621269884,right,C3,263,-3,4,5,-1,"-3,4"
1798,720575940628256655,right,C3,264,-1,-6,-2,-4,"-1,-6"
1799,720575940631257508,right,C3,265,-6,-1,5,-6,"-6,-1"
1800,720575940629124551,right,C3,266,-1,-25,-12,-13,"-1,-25"
1801,720575940605553598,right,C3,267,-6,2,7,-5,"-6,2"
1802,720575940620735878,right,C3,268,7,-6,-10,4,"7,-6"
1803,720575940635308444,right,C3,269,2,-19,-12,-7,"2,-19"
1804,720575940609862667,right,C3,270,1,-8,-5,-3,"1,-8"
1805,720575940632534476,right,C3,271,4,6,-1,7,"4,6"
1806,720575940611104462,right,C3,272,3,-2,-4,2,"3,-2"
1807,720575940626636176,right,C3,273,-6,23,17,6,"-6,23"
1808,720575940628637937,right,C3,275,-8,-1,7,-8,"-8,-1"
1809,720575940627728657,right,C3,276,2,3,-1,4,"2,3"
1810,720575940622021452,right,C3,277,7,-3,-9,6,"7,-3"
1811,720575940632504801,right,C3,278,-5,10,10,0,"-5,10"
1812,720575940632185130,right,C3,279,-4,8,8,0,"-4,8"
1813,720575940644937751,right,C3,280,-6,-14,-1,-13,"-6,-14"
1814,720575940611780761,right,C3,281,-9,2,10,-8,"-9,2"
1815,720575940612728342,right,C3,282,0,26,13,13,"0,26"
1816,720575940639286899,right,C3,283,-4,4,6,-2,"-4,4"
1817,720575940610720120,right,C3,284,0,25,12,13,"0,25"
1818,720575940623108301,right,C3,285,6,-18,-15,-3,"6,-18"
1819,720575940647626804,right,C3,286,0,-24,-12,-12,"0,-24"
1820,720575940624041924,right,C3,287,-5,13,11,2,"-5,13"
1821,720575940624169001,right,C3,289,-1,11,6,5,"-1,11"
1822,720575940617892219,right,C3,290,5,-24,-17,-7,"5,-24"
1823,720575940640144829,right,C3,291,7,2,-6,8,"7,2"
1824,720575940633855513,right,C3,292,-4,18,13,5,"-4,18"
1825,720575940625745808,right,C3,293,4,-17,-13,-4,"4,-17"
1826,720575940634288339,right,C3,294,1,-20,-11,-9,"1,-20"
1827,720575940627160266,right,C3,296,1,-18,-10,-8,"1,-18"
1828,720575940631754703,right,C3,297,7,-9,-12,3,"7,-9"
1829,720575940631729103,right,C3,298,-5,5,7,-2,"-5,5"
1830,720575940620015892,right,C3,299,-4,12,10,2,"-4,12"
1831,720575940632756781,right,C3,300,4,-18,-13,-5,"4,-18"
1832,720575940625522667,right,C3,301,-5,16,13,3,"-5,16"
1833,720575940606423840,right,C3,302,2,17,6,11,"2,17"
1834,720575940630804933,right,C3,303,-5,22,16,6,"-5,22"
1835,720575940614342823,right,C3,305,-7,4,9,-5,"-7,4"
1836,720575940624289205,right,C3,306,3,7,0,7,"3,7"
1837,720575940628893160,right,C3,307,5,-25,-18,-7,"5,-25"
1838,720575940626963593,right,C3,308,-5,8,9,-1,"-5,8"
1839,720575940644751639,right,C3,309,-6,12,12,0,"-6,12"
1840,720575940624994557,right,C3,310,2,22,9,13,"2,22"
1841,720575940631057679,right,C3,311,-7,15,14,1,"-7,15"
1842,720575940636889456,right,C3,312,4,-7,-8,1,"4,-7"
1843,720575940629453553,right,C3,313,7,3,-6,9,"7,3"
1844,720575940612153622,right,C3,314,-9,5,11,-6,"-9,5"
1845,720575940605469286,right,C3,315,-3,-6,0,-6,"-3,-6"
1846,720575940622083845,right,C3,316,5,-4,-7,3,"5,-4"
1847,720575940632748648,right,C3,317,-5,-4,3,-7,"-5,-4"
1848,720575940614525351,right,C3,318,4,-19,-14,-5,"4,-19"
1849,720575940613796630,right,C3,319,-2,5,4,1,"-2,5"
1850,720575940611865713,right,C3,320,-2,-5,-1,-4,"-2,-5"
1851,720575940630242295,right,C3,322,2,26,11,15,"2,26"
1852,720575940616515814,right,C3,323,-7,-13,0,-13,"-7,-13"
1853,720575940641694197,right,C3,324,3,24,9,15,"3,24"
1854,720575940630872428,right,C3,325,5,1,-5,6,"5,1"
1855,720575940628125948,right,C3,326,2,16,6,10,"2,16"
1856,720575940647599492,right,C3,328,5,-9,-10,1,"5,-9"
1857,720575940619903625,right,C3,329,0,24,12,12,"0,24"
1858,720575940620976048,right,C3,330,3,3,-2,5,"3,3"
1859,720575940633830445,right,C3,331,1,-15,-9,-6,"1,-15"
1860,720575940627484297,right,C3,332,4,-26,-17,-9,"4,-26"
1861,720575940627839881,right,C3,333,0,-21,-11,-10,"0,-21"
1862,720575940632780077,right,C3,334,1,-26,-14,-12,"1,-26"
1863,720575940624018249,right,C3,335,2,8,2,6,"2,8"
1864,720575940622213289,right,C3,336,0,23,11,12,"0,23"
1865,720575940633892435,right,C3,337,-5,-6,2,-8,"-5,-6"
1866,720575940626342745,right,C3,338,-1,0,1,-1,"-1,0"
1867,720575940613686993,right,C3,339,6,11,-1,12,"6,11"
1868,720575940617805405,right,C3,340,-4,17,12,5,"-4,17"
1869,720575940628981975,right,C3,341,6,-17,-15,-2,"6,-17"
1870,720575940621581317,right,C3,342,2,-15,-10,-5,"2,-15"
1871,720575940622132406,right,C3,343,-3,27,16,11,"-3,27"
1872,720575940621383796,right,C3,344,-2,-15,-6,-9,"-2,-15"
1873,720575940624389159,right,C3,345,3,-12,-9,-3,"3,-12"
1874,720575940639795571,right,C3,346,-7,-9,2,-11,"-7,-9"
1875,720575940636140407,right,C3,347,-5,-13,-2,-11,"-5,-13"
1876,720575940625114957,right,C3,349,-5,-14,-2,-12,"-5,-14"
1877,720575940620108715,right,C3,350,1,15,6,9,"1,15"
1878,720575940616530210,right,C3,351,-1,-17,-8,-9,"-1,-17"
1879,720575940631920079,right,C3,352,-2,28,16,12,"-2,28"
1880,720575940631020495,right,C3,353,2,24,10,14,"2,24"
1881,720575940631332828,right,C3,354,-2,-26,-11,-15,"-2,-26"
1882,720575940626101450,right,C3,355,-7,-6,4,-10,"-7,-6"
1883,720575940623135210,right,C3,356,0,22,11,11,"0,22"
1884,720575940617834681,right,C3,357,4,17,4,13,"4,17"
1885,720575940628358662,right,C3,358,-3,17,11,6,"-3,17"
1886,720575940619210667,right,C3,359,2,23,9,14,"2,23"
1887,720575940620062110,right,C3,360,-5,19,14,5,"-5,19"
1888,720575940623819619,right,C3,361,0,-7,-4,-3,"0,-7"
1889,720575940621362241,right,C3,362,2,-20,-12,-8,"2,-20"
1890,720575940608752651,right,C3,363,7,-4,-9,5,"7,-4"
1891,720575940612171470,right,C3,364,4,4,-2,6,"4,4"
1892,720575940624159123,right,C3,365,4,7,-1,8,"4,7"
1893,720575940611797458,right,C3,366,-5,-20,-5,-15,"-5,-20"
1894,720575940635484852,right,C3,367,-6,-15,-2,-13,"-6,-15"
1895,720575940635590324,right,C3,368,-4,-20,-6,-14,"-4,-20"
1896,720575940627379987,right,C3,369,5,-5,-8,3,"5,-5"
1897,720575940625907044,right,C3,370,-3,21,13,8,"-3,21"
1898,720575940610958290,right,C3,371,6,-5,-9,4,"6,-5"
1899,720575940632171083,right,C3,372,1,-2,-2,0,"1,-2"
1900,720575940624819785,right,C3,373,1,-21,-12,-9,"1,-21"
1901,720575940632456490,right,C3,374,2,13,4,9,"2,13"
1902,720575940610373752,right,C3,375,-6,7,9,-2,"-6,7"
1903,720575940619723885,right,C3,376,-7,-10,2,-12,"-7,-10"
1904,720575940617717282,right,C3,377,0,7,3,4,"0,7"
1905,720575940615184031,right,C3,378,-3,18,12,6,"-3,18"
1906,720575940640419491,right,C3,379,3,-17,-12,-5,"3,-17"
1907,720575940622934601,right,C3,381,-8,-9,3,-12,"-8,-9"
1908,720575940626801726,right,C3,382,3,-6,-6,0,"3,-6"
1909,720575940609790987,right,C3,383,-6,11,11,0,"-6,11"
1910,720575940616417878,right,C3,384,-6,-2,5,-7,"-6,-2"
1911,720575940608043954,right,C3,385,-3,-18,-6,-12,"-3,-18"
1912,720575940639650109,right,C3,386,-6,19,15,4,"-6,19"
1913,720575940623363978,right,C3,387,-1,-15,-7,-8,"-1,-15"
1914,720575940629161713,right,C3,388,3,19,6,13,"3,19"
1915,720575940628359430,right,C3,389,-6,-16,-2,-14,"-6,-16"
1916,720575940635635892,right,C3,390,-6,-9,1,-10,"-6,-9"
1917,720575940620061387,right,C3,391,4,-3,-6,3,"4,-3"
1918,720575940661057665,right,C3,392,-4,7,7,0,"-4,7"
1919,720575940629972418,right,C3,393,-1,22,12,10,"-1,22"
1920,720575940611015010,right,C3,394,-7,-8,3,-11,"-7,-8"
1921,720575940607221426,right,C3,395,0,-22,-11,-11,"0,-22"
1922,720575940629859371,right,C3,396,-1,10,6,4,"-1,10"
1923,720575940624803303,right,C3,397,-3,-19,-7,-12,"-3,-19"
1924,720575940618232861,right,C3,398,-3,22,14,8,"-3,22"
1925,720575940614320611,right,C3,399,-4,-24,-8,-16,"-4,-24"
1926,720575940625889317,right,C3,401,-2,-19,-8,-11,"-2,-19"
1927,720575940623554311,right,C3,402,3,26,10,16,"3,26"
1928,720575940614624935,right,C3,403,-2,-12,-4,-8,"-2,-12"
1929,720575940618886747,right,C3,404,-1,20,11,9,"-1,20"
1930,720575940625563429,right,C3,405,3,10,2,8,"3,10"
1931,720575940619016315,right,C3,406,1,-25,-14,-11,"1,-25"
1932,720575940622275248,right,C3,407,-5,-10,0,-10,"-5,-10"
1933,720575940611235534,right,C3,408,-6,-4,4,-8,"-6,-4"
1934,720575940633436324,right,C3,409,0,-3,-2,-1,"0,-3"
1935,720575940619509894,right,C3,410,-2,-2,1,-3,"-2,-2"
1936,720575940623740935,right,C3,411,-5,-19,-5,-14,"-5,-19"
1937,720575940617540582,right,C3,412,-6,21,16,5,"-6,21"
1938,720575940629497338,right,C3,413,-2,-7,-2,-5,"-2,-7"
1939,720575940636414126,right,C3,414,4,21,6,15,"4,21"
1940,720575940624029704,right,C3,415,6,12,0,12,"6,12"
1941,720575940628750185,right,C3,416,3,-8,-7,-1,"3,-8"
1942,720575940618783808,right,C3,417,-6,-10,1,-11,"-6,-10"
1943,720575940618873115,right,C3,418,-2,15,9,6,"-2,15"
1944,720575940627850312,right,C3,420,6,-3,-8,5,"6,-3"
1945,720575940619243313,right,C3,421,-1,12,7,5,"-1,12"
1946,720575940630467948,right,C3,422,-7,-4,5,-9,"-7,-4"
1947,720575940627081502,right,C3,423,3,-18,-12,-6,"3,-18"
1948,720575940630172571,right,C3,424,-3,-2,2,-4,"-3,-2"
1949,720575940632753837,right,C3,425,3,20,7,13,"3,20"
1950,720575940628541801,right,C3,426,-3,0,3,-3,"-3,0"
1951,720575940620490587,right,C3,427,5,-18,-14,-4,"5,-18"
1952,720575940619983262,right,C3,428,-2,23,13,10,"-2,23"
1953,720575940617525177,right,C3,429,-2,14,9,5,"-2,14"
1954,720575940626595074,right,C3,430,-3,-7,-1,-6,"-3,-7"
1955,720575940623291177,right,C3,431,-2,-10,-3,-7,"-2,-10"
1956,720575940638447523,right,C3,432,-5,7,8,-1,"-5,7"
1957,720575940625441684,right,C3,433,0,-8,-4,-4,"0,-8"
1958,720575940614761647,right,C3,434,-3,7,6,1,"-3,7"
1959,720575940629741694,right,C3,435,5,-17,-14,-3,"5,-17"
1960,720575940626532354,right,C3,436,0,-15,-8,-7,"0,-15"
1961,720575940621294768,right,C3,437,-3,12,9,3,"-3,12"
1962,720575940608302002,right,C3,438,2,27,11,16,"2,27"
1963,720575940614444328,right,C3,439,-3,-9,-2,-7,"-3,-9"
1964,720575940621343670,right,C3,440,1,23,10,13,"1,23"
1965,720575940623148424,right,C3,441,3,-16,-11,-5,"3,-16"
1966,720575940633506079,right,C3,442,-5,25,17,8,"-5,25"
1967,720575940632695204,right,C3,443,-6,4,8,-4,"-6,4"
1968,720575940629292806,right,C3,444,4,-10,-9,-1,"4,-10"
1969,720575940639647651,right,C3,445,-2,8,6,2,"-2,8"
1970,720575940625075726,right,C3,446,2,-14,-9,-5,"2,-14"
1971,720575940625351780,right,C3,447,-1,2,2,0,"-1,2"
1972,720575940640412635,right,C3,449,6,-16,-14,-2,"6,-16"
1973,720575940620678022,right,C3,450,2,-9,-7,-2,"2,-9"
1974,720575940631544659,right,C3,451,4,20,6,14,"4,20"
1975,720575940633171108,right,C3,452,1,-9,-6,-3,"1,-9"
1976,720575940622515461,right,C3,453,3,25,9,16,"3,25"
1977,720575940629062138,right,C3,454,5,-12,-11,-1,"5,-12"
1978,720575940626387458,right,C3,455,7,-7,-11,4,"7,-7"
1979,720575940644497188,right,C3,456,0,21,10,11,"0,21"
1980,720575940620543323,right,C3,457,-2,17,10,7,"-2,17"
1981,720575940624929789,right,C3,458,5,0,-5,5,"5,0"
1982,720575940627838333,right,C3,459,5,-3,-7,4,"5,-3"
1983,720575940631379707,right,C3,460,-3,-20,-7,-13,"-3,-20"
1984,720575940606090412,right,C3,461,7,-5,-10,5,"7,-5"
1985,720575940620384080,right,C3,462,-1,18,10,8,"-1,18"
1986,720575940634440343,right,C3,463,5,17,3,14,"5,17"
1987,720575940628981035,right,C3,464,4,0,-4,4,"4,0"
1988,720575940630613356,right,C3,465,3,0,-3,3,"3,0"
1989,720575940610346030,right,C3,466,1,14,6,8,"1,14"
1990,720575940621774360,right,C3,467,-2,-20,-8,-12,"-2,-20"
1991,720575940624886712,right,C3,468,-3,11,8,3,"-3,11"
1992,720575940636912986,right,C3,469,-7,13,13,0,"-7,13"
1993,720575940631694136,right,C3,470,4,-9,-9,0,"4,-9"
1994,720575940630898284,right,C3,471,3,-26,-16,-10,"3,-26"
1995,720575940624229970,right,C3,472,1,25,11,14,"1,25"
1996,720575940633087535,right,C3,473,-4,23,15,8,"-4,23"
1997,720575940620390127,right,C3,474,-3,-17,-6,-11,"-3,-17"
1998,720575940620417473,right,C3,475,-4,-1,3,-4,"-4,-1"
1999,720575940625018109,right,C3,476,-1,15,8,7,"-1,15"
2000,720575940619137307,right,C3,477,-3,2,4,-2,"-3,2"
2001,720575940622315754,right,C3,478,-7,16,15,1,"-7,16"
2002,720575940637625456,right,C3,479,-2,10,7,3,"-2,10"
2003,720575940609040341,right,C3,480,3,-19,-13,-6,"3,-19"
2004,720575940621270637,right,C3,481,4,-8,-8,0,"4,-8"
2005,720575940616476555,right,C3,482,1,17,7,10,"1,17"
2006,720575940619014685,right,C3,483,2,-7,-6,-1,"2,-7"
2007,720575940623608870,right,C3,484,3,-9,-8,-1,"3,-9"
2008,720575940630215127,right,C3,485,-3,-3,1,-4,"-3,-3"
2009,720575940633340959,right,C3,486,0,1,0,1,"0,1"
2010,720575940621591536,right,C3,487,1,-1,-2,1,"1,-1"
2011,720575940621564864,right,C3,488,7,5,-5,10,"7,5"
2012,720575940631411983,right,C3,489,-3,10,8,2,"-3,10"
2013,720575940624542183,right,C3,490,-5,6,8,-2,"-5,6"
2014,720575940612470757,right,C3,491,7,-1,-8,7,"7,-1"
2015,720575940621423296,right,C3,492,-7,-2,6,-8,"-7,-2"
2016,720575940623125793,right,C3,493,-3,23,14,9,"-3,23"
2017,720575940632058063,right,C3,494,0,29,14,15,"0,29"
2018,720575940616047116,right,C3,496,7,8,-3,11,"7,8"
2019,720575940621303024,right,C3,497,6,1,-6,7,"6,1"
2020,720575940630716534,right,C3,498,6,10,-1,11,"6,10"
2021,720575940614623634,right,C3,499,5,10,0,10,"5,10"
2022,720575940619582118,right,C3,500,7,-8,-11,3,"7,-8"
2023,720575940627078417,right,C3,501,1,2,0,2,"1,2"
2024,720575940647379764,right,C3,502,5,8,-1,9,"5,8"
2025,720575940627432469,right,C3,503,3,17,5,12,"3,17"
2026,720575940617274836,right,C3,504,-2,9,6,3,"-2,9"
2027,720575940623432141,right,C3,505,6,-22,-17,-5,"6,-22"
2028,720575940612520933,right,C3,506,1,-12,-7,-5,"1,-12"
2029,720575940624916286,right,C3,507,-5,-12,-1,-11,"-5,-12"
2030,720575940638198342,right,C3,508,-5,11,10,1,"-5,11"
2031,720575940622900237,right,C3,509,-4,10,9,1,"-4,10"
2032,720575940621810437,right,C3,510,-2,11,7,4,"-2,11"
2033,720575940648558980,right,C3,511,5,-11,-11,0,"5,-11"
2034,720575940624279549,right,C3,512,6,0,-6,6,"6,0"
2035,720575940631225119,right,C3,513,-4,-13,-3,-10,"-4,-13"
2036,720575940620658285,right,C3,514,-4,-10,-1,-9,"-4,-10"
2037,720575940627284101,right,C3,515,-8,-7,4,-11,"-8,-7"
2038,720575940626882762,right,C3,518,-4,22,15,7,"-4,22"
2039,720575940612298389,right,C3,519,-5,-5,2,-7,"-5,-5"
2040,720575940617935138,right,C3,520,-2,-22,-9,-13,"-2,-22"
2041,720575940645243427,right,C3,521,6,-9,-11,2,"6,-9"
2042,720575940615600690,right,C3,522,-4,0,4,-4,"-4,0"
2043,720575940630307835,right,C3,523,2,14,5,9,"2,14"
2044,720575940611438968,right,C3,524,4,-20,-14,-6,"4,-20"
2045,720575940621864986,right,C3,525,-1,-20,-9,-11,"-1,-20"
2046,720575940634250336,right,C3,526,0,-10,-5,-5,"0,-10"
2047,720575940639159886,right,C3,527,-4,-8,0,-8,"-4,-8"
2048,720575940623315836,right,C3,528,2,7,1,6,"2,7"
2049,720575940627694824,right,C3,529,2,-2,-3,1,"2,-2"
2050,720575940620893761,right,C3,530,-3,-13,-4,-9,"-3,-13"
2051,720575940611730642,right,C3,531,1,0,-1,1,"1,0"
2052,720575940615343825,right,C3,532,-8,7,11,-4,"-8,7"
2053,720575940630625918,right,C3,533,0,-16,-8,-8,"0,-16"
2054,720575940633458124,right,C3,534,3,2,-2,4,"3,2"
2055,720575940605682720,right,C3,535,8,-4,-10,6,"8,-4"
2056,720575940609497867,right,C3,536,3,4,-1,5,"3,4"
2057,720575940627019876,right,C3,537,0,-23,-12,-11,"0,-23"
2058,720575940634536858,right,C3,538,-4,1,4,-3,"-4,1"
2059,720575940605861310,right,C3,539,-6,15,13,2,"-6,15"
2060,720575940620339078,right,C3,540,-2,-9,-3,-6,"-2,-9"
2061,720575940615838358,right,C3,541,-4,14,11,3,"-4,14"
2062,720575940633319628,right,C3,542,6,-13,-13,0,"6,-13"
2063,720575940608761924,right,C3,543,-1,-4,-1,-3,"-1,-4"
2064,720575940623281416,right,C3,544,3,-13,-10,-3,"3,-13"
2065,720575940622983081,right,C3,545,5,11,0,11,"5,11"
2066,720575940624532459,right,C3,546,3,6,0,6,"3,6"
2067,720575940637442270,right,C3,547,-1,21,11,10,"-1,21"
2068,720575940605894833,right,C3,549,0,-9,-5,-4,"0,-9"
2069,720575940639648163,right,C3,550,-2,3,3,0,"-2,3"
2070,720575940629734522,right,C3,551,-4,-9,-1,-8,"-4,-9"
2071,720575940626993683,right,C3,552,4,-1,-5,4,"4,-1"
2072,720575940639688320,right,C3,553,-3,16,11,5,"-3,16"
2073,720575940621123393,right,C3,554,-9,-3,7,-10,"-9,-3"
2074,720575940640228979,right,C3,555,-4,9,8,1,"-4,9"
2075,720575940633662628,right,C3,556,0,10,5,5,"0,10"
2076,720575940619521950,right,C3,557,6,-10,-11,1,"6,-10"
2077,720575940612480151,right,C3,558,-4,-21,-7,-14,"-4,-21"
2078,720575940639761059,right,C3,559,-6,22,17,5,"-6,22"
2079,720575940627074566,right,C3,560,-7,14,14,0,"-7,14"
2080,720575940613320434,right,C3,561,5,7,-2,9,"5,7"
2081,720575940629830782,right,C3,562,-5,-2,4,-6,"-5,-2"
2082,720575940618254917,right,C3,563,5,-13,-12,-1,"5,-13"
2083,720575940626575653,right,C3,564,3,-23,-15,-8,"3,-23"
2084,720575940627469840,right,C3,565,0,-26,-13,-13,"0,-26"
2085,720575940613373667,right,C3,566,5,-8,-9,1,"5,-8"
2086,720575940632670056,right,C3,567,-2,22,13,9,"-2,22"
2087,720575940626968862,right,C3,568,-6,-8,2,-10,"-6,-8"
2088,720575940622146625,right,C3,569,6,6,-3,9,"6,6"
2089,720575940615184434,right,C3,570,2,25,10,15,"2,25"
2090,720575940623498790,right,C3,571,0,-14,-7,-7,"0,-14"
2091,720575940629901074,right,C3,572,-8,3,9,-6,"-8,3"
2092,720575940630542329,right,C3,573,4,14,3,11,"4,14"
2093,720575940623901901,right,C3,574,-6,5,8,-3,"-6,5"
2094,720575940622477823,right,C3,575,6,9,-2,11,"6,9"
2095,720575940639858485,right,C3,576,0,28,14,14,"0,28"
2096,720575940620519685,right,C3,577,5,-14,-12,-2,"5,-14"
2097,720575940621694657,right,C3,578,4,-11,-10,-1,"4,-11"
2098,720575940618459200,right,C3,579,-3,-10,-2,-8,"-3,-10"
2099,720575940612990003,right,C3,580,-2,-23,-10,-13,"-2,-23"
2100,720575940631136274,right,C3,581,3,9,1,8,"3,9"
2101,720575940624796052,right,C3,582,-1,23,12,11,"-1,23"
2102,720575940632320274,right,C3,583,3,-25,-16,-9,"3,-25"
2103,720575940637835182,right,C3,584,4,23,7,16,"4,23"
2104,720575940632256583,right,C3,585,-1,-23,-11,-12,"-1,-23"
2105,720575940632176012,right,C3,586,2,18,7,11,"2,18"
2106,720575940636500069,right,C3,587,4,22,7,15,"4,22"
2107,720575940622594292,right,C3,588,1,4,1,3,"1,4"
2108,720575940632959535,right,C3,589,-1,-5,-2,-3,"-1,-5"
2109,720575940622971928,right,C3,590,1,9,3,6,"1,9"
2110,720575940629167878,right,C3,591,3,-3,-5,2,"3,-3"
2111,720575940632704339,right,C3,593,3,-14,-10,-4,"3,-14"
2112,720575940638450404,right,C3,594,7,-16,-15,-1,"7,-16"
2113,720575940614750358,right,C3,595,7,-12,-13,1,"7,-12"
2114,720575940626279196,right,C3,596,-4,-16,-4,-12,"-4,-16"
2115,720575940612740374,right,C3,597,4,1,-4,5,"4,1"
2116,720575940610111556,right,C3,598,2,-18,-11,-7,"2,-18"
2117,720575940632559928,right,C3,599,-1,9,5,4,"-1,9"
2118,720575940620315969,right,C3,600,3,-10,-8,-2,"3,-10"
2119,720575940617214395,right,C3,601,1,16,7,9,"1,16"
2120,720575940607471538,right,C3,602,4,-2,-5,3,"4,-2"
2121,720575940629316763,right,C3,603,-3,-23,-9,-14,"-3,-23"
2122,720575940627612945,right,C3,604,-6,-17,-3,-14,"-6,-17"
2123,720575940622957311,right,C3,605,3,15,4,11,"3,15"
2124,720575940629391354,right,C3,606,-1,-19,-9,-10,"-1,-19"
2125,720575940622997628,right,C3,607,1,18,8,10,"1,18"
2126,720575940639832125,right,C3,608,1,10,4,6,"1,10"
2127,720575940634689175,right,C3,609,-2,0,2,-2,"-2,0"
2128,720575940619924816,right,C3,610,2,-23,-14,-9,"2,-23"
2129,720575940631968843,right,C3,611,-1,-18,-8,-10,"-1,-18"
2130,720575940627726937,right,C3,612,-3,-26,-10,-16,"-3,-26"
2131,720575940621923678,right,C3,613,-8,-4,6,-10,"-8,-4"
2132,720575940620701889,right,C3,614,-2,-8,-2,-6,"-2,-8"
2133,720575940607936898,right,C3,615,-7,-7,3,-10,"-7,-7"
2134,720575940630434876,right,C3,616,-3,15,10,5,"-3,15"
2135,720575940620256960,right,C3,617,-2,-17,-7,-10,"-2,-17"
2136,720575940631127158,right,C3,618,-1,24,13,11,"-1,24"
2137,720575940635770815,right,C3,619,-4,-19,-6,-13,"-4,-19"
2138,720575940621064277,right,C3,620,7,1,-7,8,"7,1"
2139,720575940619225537,right,C3,621,1,24,11,13,"1,24"
2140,720575940636907376,right,C3,622,-5,20,15,5,"-5,20"
2141,720575940614625698,right,C3,623,1,13,5,8,"1,13"
2142,720575940637608878,right,C3,624,1,-17,-10,-7,"1,-17"
2143,720575940623138559,right,C3,625,-2,24,14,10,"-2,24"
2144,720575940623024166,right,C3,626,-5,-8,1,-9,"-5,-8"
2145,720575940636487054,right,C3,627,0,-1,-1,0,"0,-1"
2146,720575940639040445,right,C3,628,0,0,0,0,"0,0"
2147,720575940628971850,right,C3,629,4,24,8,16,"4,24"
2148,720575940624347430,right,C3,630,4,8,0,8,"4,8"
2149,720575940613182122,right,C3,631,1,26,12,14,"1,26"
2150,720575940610484782,right,C3,632,3,-20,-13,-7,"3,-20"
2151,720575940627410690,right,C3,633,-1,-24,-11,-13,"-1,-24"
2152,720575940633909677,right,C3,634,-3,-15,-5,-10,"-3,-15"
2153,720575940644408100,right,C3,635,6,-6,-9,3,"6,-6"
2154,720575940627174417,right,C3,636,0,6,3,3,"0,6"
2155,720575940633546700,right,C3,637,3,-21,-14,-7,"3,-21"
2156,720575940636070392,right,C3,638,-1,7,4,3,"-1,7"
2157,720575940616367291,right,C3,639,-4,19,13,6,"-4,19"
2158,720575940605706430,right,C3,640,-1,-16,-7,-9,"-1,-16"
2159,720575940618833310,right,C3,641,-8,-5,5,-10,"-8,-5"
2160,720575940629953079,right,C3,642,-5,-11,-1,-10,"-5,-11"
2161,720575940632961567,right,C3,643,6,14,1,13,"6,14"
2162,720575940629564794,right,C3,644,-6,18,15,3,"-6,18"
2163,720575940624119944,right,C3,645,-4,27,17,10,"-4,27"
2164,720575940612569457,right,C3,647,-4,-7,0,-7,"-4,-7"
2165,720575940616210738,right,C3,648,1,7,2,5,"1,7"
2166,720575940636481204,right,C3,649,-1,5,3,2,"-1,5"
2167,720575940617013516,right,C3,650,-3,-25,-10,-15,"-3,-25"
2168,720575940625063411,right,C3,651,-4,-5,1,-6,"-4,-5"
2169,720575940616120669,right,C3,652,-6,-11,0,-11,"-6,-11"
2170,720575940623654669,right,C3,653,-6,-12,0,-12,"-6,-12"
2171,720575940634449890,right,C3,654,-3,8,7,1,"-3,8"
2172,720575940632572185,right,C3,655,6,-1,-7,6,"6,-1"
2173,720575940630520643,right,C3,656,0,-11,-6,-5,"0,-11"
2174,720575940605190624,right,C3,657,-2,-25,-11,-14,"-2,-25"
2175,720575940631544618,right,C3,658,1,20,9,11,"1,20"
2176,720575940628006855,right,C3,659,-4,-6,1,-7,"-4,-6"
2177,720575940633439827,right,C3,660,2,28,12,16,"2,28"
2178,720575940624612327,right,C3,661,-3,14,10,4,"-3,14"
2179,720575940620519616,right,C3,662,2,-1,-3,2,"2,-1"
2180,720575940625837242,right,C3,663,0,8,4,4,"0,8"
2181,720575940617507894,right,C3,664,1,-27,-15,-12,"1,-27"
2182,720575940633387212,right,C3,665,7,-2,-8,6,"7,-2"
2183,720575940628345160,right,C3,666,7,-13,-14,1,"7,-13"
2184,720575940640134589,right,C3,667,1,-28,-15,-13,"1,-28"
2185,720575940632804920,right,C3,668,1,19,8,11,"1,19"
2186,720575940640727896,right,C3,669,4,-16,-12,-4,"4,-16"
2187,720575940625977788,right,C3,670,5,5,-3,8,"5,5"
2188,720575940625325861,right,C3,671,-4,-23,-8,-15,"-4,-23"
2189,720575940628639473,right,C3,672,-8,11,13,-2,"-8,11"
2190,720575940659946625,right,C3,673,2,5,0,5,"2,5"
2191,720575940615314498,right,C3,674,-4,-14,-3,-11,"-4,-14"
2192,720575940625893159,right,C3,675,-7,19,16,3,"-7,19"
2193,720575940607202057,right,C3,676,-3,-21,-8,-13,"-3,-21"
2194,720575940620905638,right,C3,677,0,11,5,6,"0,11"
2195,720575940630266471,right,C3,678,3,-7,-7,0,"3,-7"
2196,720575940640812240,right,C3,679,4,18,5,13,"4,18"
2197,720575940628355689,right,C3,680,-1,25,13,12,"-1,25"
2198,720575940615042479,right,C3,681,-2,-21,-9,-12,"-2,-21"
2199,720575940615756866,right,C3,682,6,-8,-10,2,"6,-8"
2200,720575940624324169,right,C3,683,2,6,1,5,"2,6"
2201,720575940633829145,right,C3,684,-6,17,14,3,"-6,17"
2202,720575940626506371,right,C3,685,-5,-9,0,-9,"-5,-9"
2203,720575940628520710,right,C3,686,5,-22,-16,-6,"5,-22"
2204,720575940607105714,right,C3,687,-6,-3,4,-7,"-6,-3"
2205,720575940617284820,right,C3,688,-7,10,12,-2,"-7,10"
2206,720575940620609006,right,C3,689,-2,18,11,7,"-2,18"
2207,720575940656083617,right,C3,690,-7,-3,5,-8,"-7,-3"
2208,720575940609170371,right,C3,691,-9,4,11,-7,"-9,4"
2209,720575940609722889,right,C3,692,-4,24,16,8,"-4,24"
2210,720575940637836009,right,C3,693,-3,25,15,10,"-3,25"
2211,720575940612179173,right,C3,695,-6,10,11,-1,"-6,10"
2212,720575940639460467,right,C3,696,-2,16,10,6,"-2,16"
2213,720575940629793552,right,C3,697,1,-22,-12,-10,"1,-22"
2214,720575940628292168,right,C3,698,6,-7,-10,3,"6,-7"
2215,720575940618631253,right,C3,699,-5,0,5,-5,"-5,0"
2216,720575940633974172,right,C3,700,5,15,2,13,"5,15"
2217,720575940632181585,right,C3,701,0,-4,-2,-2,"0,-4"
2218,720575940655640993,right,C3,702,-5,23,16,7,"-5,23"
2219,720575940605544736,right,C3,703,-3,1,3,-2,"-3,1"
2220,720575940622216624,right,C3,704,-7,8,11,-3,"-7,8"
2221,720575940637840218,right,C3,705,1,1,-1,2,"1,1"
2222,720575940623387869,right,C3,707,-2,25,14,11,"-2,25"
2223,720575940635699095,right,C3,709,-2,-24,-10,-14,"-2,-24"
2224,720575940634519392,right,C3,710,4,-25,-17,-8,"4,-25"
2225,720575940620609262,right,C3,711,-1,19,10,9,"-1,19"
2226,720575940610184654,right,C3,712,-7,12,13,-1,"-7,12"
2227,720575940625656300,right,C3,713,-6,16,14,2,"-6,16"
2228,720575940630904261,right,C3,714,5,12,1,11,"5,12"
2229,720575940621814789,right,C3,715,4,10,1,9,"4,10"
2230,720575940620411307,right,C3,716,4,-6,-7,1,"4,-6"
2231,720575940605796542,right,C3,717,2,-22,-13,-9,"2,-22"
2232,720575940654774689,right,C3,718,-5,24,17,7,"-5,24"
2233,720575940632737347,right,C3,719,1,27,12,15,"1,27"
2234,720575940611944402,right,C3,720,-5,21,15,6,"-5,21"
2235,720575940620102772,right,C3,721,5,13,1,12,"5,13"
2236,720575940638219497,right,C3,722,6,-15,-14,-1,"6,-15"
2237,720575940629769669,right,C3,723,-2,-11,-4,-7,"-2,-11"
2238,720575940638138846,right,C3,724,4,2,-3,5,"4,2"
2239,720575940635249052,right,C3,725,-3,-24,-9,-15,"-3,-24"
2240,720575940615666399,right,C3,726,2,-28,-16,-12,"2,-28"
2241,720575940633423897,right,C3,727,7,6,-4,10,"7,6"
2242,720575940616540043,right,C3,728,7,12,-1,13,"7,12"
2243,720575940621887112,right,C3,729,-3,29,17,12,"-3,29"
2244,720575940641302736,right,C3,730,7,0,-7,7,"7,0"
2245,720575940635164852,right,C3,731,-6,9,10,-1,"-6,9"
2246,720575940622202077,right,C3,732,-3,6,6,0,"-3,6"
2247,720575940633160495,right,C3,733,-5,-17,-4,-13,"-5,-17"
2248,720575940632901191,right,C3,734,2,0,-2,2,"2,0"
2249,720575940629286218,right,C3,735,1,-23,-13,-10,"1,-23"
2250,720575940606650754,right,C3,736,-8,1,8,-7,"-8,1"
2251,720575940605998257,right,C3,737,0,19,9,10,"0,19"
2252,720575940629803458,right,C3,738,-3,13,9,4,"-3,13"
2253,720575940635867248,right,C3,739,-7,2,8,-6,"-7,2"
2254,720575940628813060,right,C3,740,2,-8,-6,-2,"2,-8"
2255,720575940615482434,right,C3,741,-2,-14,-5,-9,"-2,-14"
2256,720575940614930794,right,C3,742,-4,11,9,2,"-4,11"
2257,720575940621244848,right,C3,743,6,-19,-16,-3,"6,-19"
2258,720575940655983777,right,C3,744,-4,25,16,9,"-4,25"
2259,720575940637751017,right,C3,745,0,13,6,7,"0,13"
2260,720575940614844566,right,C3,746,-3,3,4,-1,"-3,3"
2261,720575940628215963,right,C3,747,0,2,1,1,"0,2"
2262,720575940614321123,right,C3,748,-4,20,14,6,"-4,20"
2263,720575940608410307,right,C3,749,-2,1,2,-1,"-2,1"
2264,720575940621656230,right,C3,750,4,-24,-16,-8,"4,-24"
2265,720575940629320704,right,C3,751,1,6,2,4,"1,6"
2266,720575940616162626,right,C3,752,-2,7,5,2,"-2,7"
2267,720575940608412508,right,C3,753,-3,24,15,9,"-3,24"
2268,720575940632046509,right,C3,754,-1,-13,-6,-7,"-1,-13"
2269,720575940621106961,right,C3,755,4,19,5,14,"4,19"
2270,720575940618203348,right,C3,756,5,20,5,15,"5,20"
2271,720575940640615485,right,C3,757,0,-6,-3,-3,"0,-6"
2272,720575940638989658,right,C3,758,5,-1,-6,5,"5,-1"
2273,720575940625914686,right,C3,759,7,14,0,14,"7,14"
2274,720575940627074332,right,C3,760,0,17,8,9,"0,17"
2275,720575940633845037,right,C3,761,-4,-18,-5,-13,"-4,-18"
2276,720575940610718328,right,C3,762,0,14,7,7,"0,14"
2277,720575940641459419,right,C3,763,-5,14,12,2,"-5,14"
2278,720575940612461977,right,C3,764,-8,-6,5,-11,"-8,-6"
2279,720575940623073833,right,C3,765,-3,9,7,2,"-3,9"
2280,720575940616478806,right,C3,766,2,-4,-4,0,"2,-4"
2281,720575940638430185,right,C3,767,1,28,13,15,"1,28"
2282,720575940620482753,right,C3,768,3,5,-1,6,"3,5"
2283,720575940629528592,right,C3,769,4,-27,-18,-9,"4,-27"
2284,720575940646381678,right,C3,770,5,4,-3,7,"5,4"
2285,720575940622773929,right,C3,771,3,-27,-17,-10,"3,-27"
2286,720575940616054175,right,C3,772,1,12,5,7,"1,12"
2287,720575940624326071,right,C3,773,5,-19,-15,-4,"5,-19"
2288,720575940626280573,right,C3,774,-8,6,11,-5,"-8,6"
2289,720575940628629191,right,C3,775,5,22,6,16,"5,22"
2290,720575940631342167,right,C3,776,5,21,5,16,"5,21"
2291,720575940605592608,right,C3,777,6,20,4,16,"6,20"
2292,720575940624639159,right,C3,778,4,25,8,17,"4,25"
2293,720575940645631511,right,C3,779,5,24,7,17,"5,24"
2294,720575940626542142,right,C3,780,-6,25,18,7,"-6,25"
2295,720575940622794623,right,C3,781,-5,26,18,8,"-5,26"
2296,720575940608739523,right,C3,783,-4,28,18,10,"-4,28"
2297,720575940635330661,right,C3,784,-4,29,18,11,"-4,29"
2298,720575940628642216,right,C3,785,-3,30,18,12,"-3,30"
2299,720575940623108521,right,C3,787,3,28,11,17,"3,28"
2300,720575940626641098,right,C3,788,3,27,10,17,"3,27"
2301,720575940630708094,right,C3,790,-2,-27,-12,-15,"-2,-27"
2302,720575940627339346,right,C3,792,8,2,-7,9,"8,2"
2303,720575940623612125,right,C3,794,5,-26,-18,-8,"5,-26"
2304,720575940639191229,right,C3,795,6,-21,-17,-4,"6,-21"
2305,720575940620921424,right,C3,796,4,26,9,17,"4,26"
2306,720575940636561838,right,L1,1,-6,13,12,1,"-6,13"
2307,720575940629723006,right,L1,2,-8,2,9,-7,"-8,2"
2308,720575940621153702,right,L1,3,6,-12,-12,0,"6,-12"
2309,720575940607560370,right,L1,4,-5,-21,-6,-15,"-5,-21"
2310,720575940628893937,right,L1,5,-1,16,9,7,"-1,16"
2311,720575940618854228,right,L1,6,-2,-4,0,-4,"-2,-4"
2312,720575940632654440,right,L1,7,-6,-6,3,-9,"-6,-6"
2313,720575940620875741,right,L1,8,-4,26,17,9,"-4,26"
2314,720575940622451197,right,L1,9,4,9,0,9,"4,9"
2315,720575940623092044,right,L1,10,5,-15,-13,-2,"5,-15"
2316,720575940619416113,right,L1,11,7,-14,-14,0,"7,-14"
2317,720575940627241747,right,L1,12,-7,9,11,-2,"-7,9"
2318,720575940628018565,right,L1,13,-1,-26,-12,-14,"-1,-26"
2319,720575940640408435,right,L1,14,0,-27,-14,-13,"0,-27"
2320,720575940631787577,right,L1,15,2,-3,-4,1,"2,-3"
2321,720575940620354008,right,L1,16,-2,-16,-6,-10,"-2,-16"
2322,720575940641512656,right,L1,17,1,-5,-4,-1,"1,-5"
2323,720575940622808745,right,L1,18,5,-16,-13,-3,"5,-16"
2324,720575940622892056,right,L1,19,-7,17,15,2,"-7,17"
2325,720575940614504342,right,L1,20,3,-11,-9,-2,"3,-11"
2326,720575940631839140,right,L1,21,-2,19,11,8,"-2,19"
2327,720575940617734976,right,L1,22,-1,3,2,1,"-1,3"
2328,720575940618608029,right,L1,23,-3,-16,-5,-11,"-3,-16"
2329,720575940613506582,right,L1,24,-1,-10,-4,-6,"-1,-10"
2330,720575940628400149,right,L1,25,-9,3,10,-7,"-9,3"
2331,720575940609591817,right,L1,26,1,-3,-3,0,"1,-3"
2332,720575940618867796,right,L1,27,0,-25,-13,-12,"0,-25"
2333,720575940636112747,right,L1,28,5,6,-2,8,"5,6"
2334,720575940636892590,right,L1,29,-1,-3,-1,-2,"-1,-3"
2335,720575940618322617,right,L1,30,6,16,2,14,"6,16"
2336,720575940618427015,right,L1,31,0,16,8,8,"0,16"
2337,720575940641517008,right,L1,32,0,12,6,6,"0,12"
2338,720575940626709029,right,L1,33,3,18,6,12,"3,18"
2339,720575940608177330,right,L1,34,6,18,3,15,"6,18"
2340,720575940612019150,right,L1,35,1,-24,-13,-11,"1,-24"
2341,720575940613632114,right,L1,36,6,8,-2,10,"6,8"
2342,720575940631433167,right,L1,37,1,5,1,4,"1,5"
2343,720575940630784055,right,L1,38,0,-2,-1,-1,"0,-2"
2344,720575940626150448,right,L1,39,0,20,10,10,"0,20"
2345,720575940634193815,right,L1,40,-2,-6,-1,-5,"-2,-6"
2346,720575940633518381,right,L1,41,-3,28,17,11,"-3,28"
2347,720575940630498942,right,L1,42,-1,14,8,6,"-1,14"
2348,720575940622269445,right,L1,43,-5,18,14,4,"-5,18"
2349,720575940627686942,right,L1,44,5,-10,-10,0,"5,-10"
2350,720575940621905729,right,L1,45,-5,-1,4,-5,"-5,-1"
2351,720575940606631014,right,L1,46,-5,15,12,3,"-5,15"
2352,720575940623394440,right,L1,47,-9,-1,8,-9,"-9,-1"
2353,720575940628630248,right,L1,48,-4,-22,-7,-15,"-4,-22"
2354,720575940624102397,right,L1,49,4,-4,-6,2,"4,-4"
2355,720575940623993783,right,L1,50,-2,21,12,9,"-2,21"
2356,720575940625623795,right,L1,51,0,-19,-10,-9,"0,-19"
2357,720575940613513330,right,L1,52,-1,-22,-10,-12,"-1,-22"
2358,720575940606524802,right,L1,53,5,14,2,12,"5,14"
2359,720575940642512603,right,L1,54,-4,3,5,-2,"-4,3"
2360,720575940631022807,right,L1,55,-4,-11,-2,-9,"-4,-11"
2361,720575940624183690,right,L1,56,1,-13,-8,-5,"1,-13"
2362,720575940638525150,right,L1,57,6,-11,-12,1,"6,-11"
2363,720575940613377945,right,L1,58,3,12,3,9,"3,12"
2364,720575940639115608,right,L1,59,-2,2,3,-1,"-2,2"
2365,720575940607194546,right,L1,60,-8,8,12,-4,"-8,8"
2366,720575940616616053,right,L1,61,-4,-4,2,-6,"-4,-4"
2367,720575940612647025,right,L1,62,0,-29,-15,-14,"0,-29"
2368,720575940624617450,right,L1,63,4,12,2,10,"4,12"
2369,720575940605541822,right,L1,64,4,-23,-16,-7,"4,-23"
2370,720575940621610587,right,L1,65,-1,28,15,13,"-1,28"
2371,720575940624372263,right,L1,66,2,15,5,10,"2,15"
2372,720575940624616486,right,L1,67,-2,-13,-5,-8,"-2,-13"
2373,720575940617855537,right,L1,68,3,16,5,11,"3,16"
2374,720575940631735121,right,L1,69,1,8,3,5,"1,8"
2375,720575940626661168,right,L1,70,-4,21,14,7,"-4,21"
2376,720575940623537043,right,L1,71,-2,-3,0,-3,"-2,-3"
2377,720575940628279183,right,L1,72,0,-28,-14,-14,"0,-28"
2378,720575940632680100,right,L1,73,2,2,-1,3,"2,2"
2379,720575940621563072,right,L1,74,-1,-9,-4,-5,"-1,-9"
2380,720575940640153216,right,L1,75,-6,14,13,1,"-6,14"
2381,720575940617225118,right,L1,76,-3,-4,1,-5,"-3,-4"
2382,720575940616241339,right,L1,77,2,-5,-5,0,"2,-5"
2383,720575940635607220,right,L1,78,2,20,8,12,"2,20"
2384,720575940636482734,right,L1,79,2,1,-2,3,"2,1"
2385,720575940616665915,right,L1,80,4,13,2,11,"4,13"
2386,720575940636027290,right,L1,81,6,-2,-7,5,"6,-2"
2387,720575940628037257,right,L1,82,-7,7,10,-3,"-7,7"
2388,720575940622609669,right,L1,83,2,-21,-13,-8,"2,-21"
2389,720575940627819338,right,L1,84,-2,12,8,4,"-2,12"
2390,720575940628453448,right,L1,85,4,-22,-15,-7,"4,-22"
2391,720575940620399740,right,L1,86,-5,-7,1,-8,"-5,-7"
2392,720575940624825271,right,L1,87,1,11,4,7,"1,11"
2393,720575940638737085,right,L1,88,7,4,-5,9,"7,4"
2394,720575940633136209,right,L1,89,1,-19,-11,-8,"1,-19"
2395,720575940647118883,right,L1,90,-4,5,6,-1,"-4,5"
2396,720575940629649411,right,L1,91,-1,6,4,2,"-1,6"
2397,720575940612777434,right,L1,92,0,9,4,5,"0,9"
2398,720575940639339709,right,L1,93,-6,3,7,-4,"-6,3"
2399,720575940631757624,right,L1,94,5,18,4,14,"5,18"
2400,720575940613504882,right,L1,95,4,-21,-15,-6,"4,-21"
2401,720575940633441996,right,L1,96,1,-10,-6,-4,"1,-10"
2402,720575940632281359,right,L1,97,-5,2,6,-4,"-5,2"
2403,720575940626691984,right,L1,98,-1,-12,-5,-7,"-1,-12"
2404,720575940629507279,right,L1,99,4,15,3,12,"4,15"
2405,720575940636006751,right,L1,100,2,-10,-7,-3,"2,-10"
2406,720575940633568924,right,L1,101,-7,6,10,-4,"-7,6"
2407,720575940616323999,right,L1,102,3,13,3,10,"3,13"
2408,720575940623075610,right,L1,103,7,9,-3,12,"7,9"
2409,720575940628316945,right,L1,104,-1,-27,-13,-14,"-1,-27"
2410,720575940660156545,right,L1,105,3,22,8,14,"3,22"
2411,720575940630610302,right,L1,106,-7,11,12,-1,"-7,11"
2412,720575940615432866,right,L1,107,8,-2,-9,7,"8,-2"
2413,720575940624391914,right,L1,108,-3,-12,-3,-9,"-3,-12"
2414,720575940627143098,right,L1,109,4,-5,-7,2,"4,-5"
2415,720575940629500521,right,L1,110,-7,0,7,-7,"-7,0"
2416,720575940631298809,right,L1,111,2,-24,-14,-10,"2,-24"
2417,720575940628769768,right,L1,112,-6,1,6,-5,"-6,1"
2418,720575940626919882,right,L1,113,-2,4,4,0,"-2,4"
2419,720575940624792051,right,L1,114,2,-13,-9,-4,"2,-13"
2420,720575940605621862,right,L1,115,-4,2,5,-3,"-4,2"
2421,720575940608226261,right,L1,116,-1,-8,-3,-5,"-1,-8"
2422,720575940629972076,right,L1,117,-8,-2,7,-9,"-8,-2"
2423,720575940614971944,right,L1,118,3,1,-3,4,"3,1"
2424,720575940627505241,right,L1,119,-2,6,5,1,"-2,6"
2425,720575940632304146,right,L1,120,-1,-1,0,-1,"-1,-1"
2426,720575940605774014,right,L1,121,-8,4,10,-6,"-8,4"
2427,720575940631894815,right,L1,122,-5,9,9,0,"-5,9"
2428,720575940643577198,right,L1,123,-8,10,13,-3,"-8,10"
2429,720575940638456798,right,L1,124,1,-7,-5,-2,"1,-7"
2430,720575940640687861,right,L1,125,5,9,-1,10,"5,9"
2431,720575940637938409,right,L1,126,3,11,2,9,"3,11"
2432,720575940614123491,right,L1,127,0,15,7,8,"0,15"
2433,720575940628311098,right,L1,128,3,-22,-14,-8,"3,-22"
2434,720575940636107615,right,L1,129,0,-13,-7,-6,"0,-13"
2435,720575940620457813,right,L1,130,2,12,4,8,"2,12"
2436,720575940619890512,right,L1,131,-6,20,16,4,"-6,20"
2437,720575940608181515,right,L1,132,2,4,0,4,"2,4"
2438,720575940632260623,right,L1,133,-3,20,13,7,"-3,20"
2439,720575940627998739,right,L1,134,-5,-18,-4,-14,"-5,-18"
2440,720575940604747953,right,L1,135,-3,-22,-8,-14,"-3,-22"
2441,720575940621343252,right,L1,136,0,3,1,2,"0,3"
2442,720575940621766566,right,L1,137,5,-7,-9,2,"5,-7"
2443,720575940627743400,right,L1,138,0,27,13,14,"0,27"
2444,720575940646305827,right,L1,139,1,-14,-8,-6,"1,-14"
2445,720575940608144050,right,L1,140,3,8,1,7,"3,8"
2446,720575940632455272,right,L1,141,5,-23,-17,-6,"5,-23"
2447,720575940618379554,right,L1,142,-2,-18,-7,-11,"-2,-18"
2448,720575940635803802,right,L1,143,-4,16,12,4,"-4,16"
2449,720575940629755774,right,L1,144,7,-11,-13,2,"7,-11"
2450,720575940606253489,right,L1,145,0,4,2,2,"0,4"
2451,720575940625652272,right,L1,146,1,-6,-4,-2,"1,-6"
2452,720575940609729035,right,L1,147,1,21,9,12,"1,21"
2453,720575940630540023,right,L1,148,-7,-11,1,-12,"-7,-11"
2454,720575940634827671,right,L1,149,6,-14,-13,-1,"6,-14"
2455,720575940622266025,right,L1,150,-8,5,10,-5,"-8,5"
2456,720575940622564869,right,L1,151,-3,-14,-4,-10,"-3,-14"
2457,720575940629531639,right,L1,152,3,-15,-11,-4,"3,-15"
2458,720575940653597174,right,L1,153,8,0,-8,8,"8,0"
2459,720575940619592102,right,L1,154,-8,0,8,-8,"-8,0"
2460,720575940637450974,right,L1,155,-8,13,14,-1,"-8,13"
2461,720575940620647407,right,L1,156,-9,1,9,-8,"-9,1"
2462,720575940634252700,right,L1,157,-1,-7,-3,-4,"-1,-7"
2463,720575940626993338,right,L1,158,3,-5,-6,1,"3,-5"
2464,720575940612733667,right,L1,159,7,7,-4,11,"7,7"
2465,720575940642334965,right,L1,160,-2,20,12,8,"-2,20"
2466,720575940631796175,right,L1,161,4,-14,-11,-3,"4,-14"
2467,720575940635696120,right,L1,162,-4,-2,3,-5,"-4,-2"
2468,720575940613580269,right,L1,163,-9,7,12,-5,"-9,7"
2469,720575940612646642,right,L1,164,-1,-2,0,-2,"-1,-2"
2470,720575940628519665,right,L1,165,4,16,4,12,"4,16"
2471,720575940632696889,right,L1,166,0,18,9,9,"0,18"
2472,720575940624931768,right,L1,167,0,-17,-9,-8,"0,-17"
2473,720575940612349363,right,L1,168,-1,17,9,8,"-1,17"
2474,720575940621052069,right,L1,169,0,-18,-9,-9,"0,-18"
2475,720575940632659364,right,L1,170,-5,1,5,-4,"-5,1"
2476,720575940631211382,right,L1,171,6,-20,-16,-4,"6,-20"
2477,720575940626353916,right,L1,172,1,22,10,12,"1,22"
2478,720575940632452456,right,L1,173,2,-25,-15,-10,"2,-25"
2479,720575940637260389,right,L1,174,4,-15,-12,-3,"4,-15"
2480,720575940624334532,right,L1,176,-2,13,8,5,"-2,13"
2481,720575940606406530,right,L1,177,-2,-1,1,-2,"-2,-1"
2482,720575940621010196,right,L1,178,2,11,3,8,"2,11"
2483,720575940624002601,right,L1,179,-5,-16,-3,-13,"-5,-16"
2484,720575940640299325,right,L1,180,2,-27,-16,-11,"2,-27"
2485,720575940630042679,right,L1,181,1,-4,-3,-1,"1,-4"
2486,720575940624869117,right,L1,182,7,-10,-12,2,"7,-10"
2487,720575940635639743,right,L1,183,-5,-15,-3,-12,"-5,-15"
2488,720575940630422466,right,L1,184,-6,-5,3,-8,"-6,-5"
2489,720575940625043856,right,L1,185,2,-11,-8,-3,"2,-11"
2490,720575940629703015,right,L1,186,-1,26,14,12,"-1,26"
2491,720575940629998071,right,L1,187,3,21,7,14,"3,21"
2492,720575940602857696,right,L1,188,-5,17,13,4,"-5,17"
2493,720575940614549394,right,L1,189,6,13,0,13,"6,13"
2494,720575940621690236,right,L1,190,-3,-5,0,-5,"-3,-5"
2495,720575940636656997,right,L1,191,-1,-11,-5,-6,"-1,-11"
2496,720575940631156781,right,L1,192,7,10,-2,12,"7,10"
2497,720575940612654771,right,L1,193,-5,4,7,-3,"-5,4"
2498,720575940611508686,right,L1,194,0,-5,-3,-2,"0,-5"
2499,720575940614775954,right,L1,195,-3,-1,2,-3,"-3,-1"
2500,720575940622638106,right,L1,196,-1,8,5,3,"-1,8"
2501,720575940628594664,right,L1,197,0,-20,-10,-10,"0,-20"
2502,720575940611758741,right,L1,198,6,2,-5,7,"6,2"
2503,720575940638398278,right,L1,199,0,-12,-6,-6,"0,-12"
2504,720575940624885687,right,L1,200,-5,12,11,1,"-5,12"
2505,720575940620316632,right,L1,201,-8,9,12,-3,"-8,9"
2506,720575940642630619,right,L1,202,-1,27,14,13,"-1,27"
2507,720575940627026705,right,L1,203,3,-1,-4,3,"3,-1"
2508,720575940616324767,right,L1,204,5,-2,-6,4,"5,-2"
2509,720575940625161230,right,L1,205,5,-6,-8,2,"5,-6"
2510,720575940609746187,right,L1,206,-3,5,5,0,"-3,5"
2511,720575940632408847,right,L1,207,1,29,13,16,"1,29"
2512,720575940613506162,right,L1,208,5,-21,-16,-5,"5,-21"
2513,720575940654966945,right,L1,209,-3,-8,-1,-7,"-3,-8"
2514,720575940629888043,right,L1,210,-6,8,10,-2,"-6,8"
2515,720575940620346840,right,L1,211,-7,-1,6,-7,"-7,-1"
2516,720575940631840824,right,L1,212,2,-16,-10,-6,"2,-16"
2517,720575940638004457,right,L1,213,3,-4,-5,1,"3,-4"
2518,720575940618408166,right,L1,214,-5,3,6,-3,"-5,3"
2519,720575940624416403,right,L1,215,6,7,-3,10,"6,7"
2520,720575940618704182,right,L1,216,2,19,7,12,"2,19"
2521,720575940615650271,right,L1,217,6,15,1,14,"6,15"
2522,720575940628171407,right,L1,218,2,10,3,7,"2,10"
2523,720575940640405667,right,L1,219,6,-4,-8,4,"6,-4"
2524,720575940618463813,right,L1,220,2,-6,-5,-1,"2,-6"
2525,720575940629995308,right,L1,221,-7,3,8,-5,"-7,3"
2526,720575940613894883,right,L1,222,-3,26,16,10,"-3,26"
2527,720575940633026980,right,L1,223,-2,26,15,11,"-2,26"
2528,720575940621193456,right,L1,224,0,5,2,3,"0,5"
2529,720575940611660498,right,L1,225,2,-26,-15,-11,"2,-26"
2530,720575940612595349,right,L1,226,5,19,4,15,"5,19"
2531,720575940640609187,right,L1,227,-7,5,9,-4,"-7,5"
2532,720575940615853206,right,L1,228,-7,1,7,-6,"-7,1"
2533,720575940628279610,right,L1,229,5,2,-4,6,"5,2"
2534,720575940626470146,right,L1,230,2,9,2,7,"2,9"
2535,720575940605032364,right,L1,231,4,-12,-10,-2,"4,-12"
2536,720575940638818623,right,L1,232,-4,13,10,3,"-4,13"
2537,720575940626820964,right,L1,233,4,-13,-11,-2,"4,-13"
2538,720575940644925038,right,L1,234,1,3,0,3,"1,3"
2539,720575940622489727,right,L1,235,4,11,1,10,"4,11"
2540,720575940619341447,right,L1,236,-1,4,3,1,"-1,4"
2541,720575940615370407,right,L1,237,-2,27,15,12,"-2,27"
2542,720575940639113405,right,L1,238,-8,-3,6,-9,"-8,-3"
2543,720575940627633384,right,L1,239,-6,6,9,-3,"-6,6"
2544,720575940619149982,right,L1,240,-4,-3,2,-5,"-4,-3"
2545,720575940613906147,right,L1,241,2,-17,-11,-6,"2,-17"
2546,720575940610106692,right,L1,242,-4,6,7,-1,"-4,6"
2547,720575940613515798,right,L1,243,-1,-21,-10,-11,"-1,-21"
2548,720575940611749233,right,L1,244,-4,-12,-2,-10,"-4,-12"
2549,720575940645458542,right,L1,245,-5,-3,3,-6,"-5,-3"
2550,720575940627311491,right,L1,246,-4,15,11,4,"-4,15"
2551,720575940631279119,right,L1,247,-4,-15,-4,-11,"-4,-15"
2552,720575940614875176,right,L1,248,-6,0,6,-6,"-6,0"
2553,720575940616853772,right,L1,249,2,-12,-8,-4,"2,-12"
2554,720575940623532426,right,L1,250,-1,1,1,0,"-1,1"
2555,720575940607807177,right,L1,251,-1,-14,-6,-8,"-1,-14"
2556,720575940623435533,right,L1,252,3,23,8,15,"3,23"
2557,720575940624217323,right,L1,253,5,16,3,13,"5,16"
2558,720575940628410792,right,L1,254,3,-24,-15,-9,"3,-24"
2559,720575940610731076,right,L1,255,-6,-13,-1,-12,"-6,-13"
2560,720575940628593384,right,L1,256,5,-20,-15,-5,"5,-20"
2561,720575940622106534,right,L1,257,2,21,8,13,"2,21"
2562,720575940627731837,right,L1,258,-4,-17,-5,-12,"-4,-17"
2563,720575940620402853,right,L1,259,-7,-5,4,-9,"-7,-5"
2564,720575940620827156,right,L1,260,-3,19,12,7,"-3,19"
2565,720575940640038333,right,L1,261,-1,13,7,6,"-1,13"
2566,720575940632187407,right,L1,262,1,-11,-7,-4,"1,-11"
2567,720575940626974297,right,L1,263,-3,4,5,-1,"-3,4"
2568,720575940615385403,right,L1,264,-1,-6,-2,-4,"-1,-6"
2569,720575940628148873,right,L1,265,-6,-1,5,-6,"-6,-1"
2570,720575940621546688,right,L1,266,-1,-25,-12,-13,"-1,-25"
2571,720575940620103509,right,L1,267,-6,2,7,-5,"-6,2"
2572,720575940623664664,right,L1,268,7,-6,-10,4,"7,-6"
2573,720575940628594408,right,L1,269,2,-19,-12,-7,"2,-19"
2574,720575940626733699,right,L1,270,1,-8,-5,-3,"1,-8"
2575,720575940623449368,right,L1,271,4,6,-1,7,"4,6"
2576,720575940620811758,right,L1,272,3,-2,-4,2,"3,-2"
2577,720575940629871319,right,L1,273,-6,23,17,6,"-6,23"
2578,720575940625258219,right,L1,275,-8,-1,7,-8,"-8,-1"
2579,720575940624160196,right,L1,276,2,3,-1,4,"2,3"
2580,720575940620598181,right,L1,277,7,-3,-9,6,"7,-3"
2581,720575940610684586,right,L1,278,-5,10,10,0,"-5,10"
2582,720575940618753088,right,L1,279,-4,8,8,0,"-4,8"
2583,720575940630539511,right,L1,280,-6,-14,-1,-13,"-6,-14"
2584,720575940628703720,right,L1,281,-9,2,10,-8,"-9,2"
2585,720575940635493999,right,L1,282,0,26,13,13,"0,26"
2586,720575940638053744,right,L1,283,-4,4,6,-2,"-4,4"
2587,720575940624677012,right,L1,284,0,25,12,13,"0,25"
2588,720575940623910919,right,L1,285,6,-18,-15,-3,"6,-18"
2589,720575940640400243,right,L1,286,0,-24,-12,-12,"0,-24"
2590,720575940627601753,right,L1,287,-5,13,11,2,"-5,13"
2591,720575940622870004,right,L1,288,-1,30,16,14,"-1,30"
2592,720575940631730402,right,L1,289,-1,11,6,5,"-1,11"
2593,720575940614937494,right,L1,290,5,-24,-17,-7,"5,-24"
2594,720575940621145716,right,L1,291,7,2,-6,8,"7,2"
2595,720575940608063106,right,L1,292,-4,18,13,5,"-4,18"
2596,720575940638054000,right,L1,293,4,-17,-13,-4,"4,-17"
2597,720575940628936747,right,L1,294,1,-20,-11,-9,"1,-20"
2598,720575940642385397,right,L1,295,-2,29,16,13,"-2,29"
2599,720575940613905891,right,L1,296,1,-18,-10,-8,"1,-18"
2600,720575940618338961,right,L1,297,7,-9,-12,3,"7,-9"
2601,720575940617537117,right,L1,298,-5,5,7,-2,"-5,5"
2602,720575940642565851,right,L1,299,-4,12,10,2,"-4,12"
2603,720575940633252812,right,L1,300,4,-18,-13,-5,"4,-18"
2604,720575940608164994,right,L1,301,-5,16,13,3,"-5,16"
2605,720575940629278726,right,L1,302,2,17,6,11,"2,17"
2606,720575940621765876,right,L1,303,-5,22,16,6,"-5,22"
2607,720575940632414226,right,L1,304,6,5,-4,9,"6,5"
2608,720575940636805733,right,L1,305,-7,4,9,-5,"-7,4"
2609,720575940631268140,right,L1,306,3,7,0,7,"3,7"
2610,720575940647577140,right,L1,307,5,-25,-18,-7,"5,-25"
2611,720575940617012678,right,L1,308,-5,8,9,-1,"-5,8"
2612,720575940634104019,right,L1,309,-6,12,12,0,"-6,12"
2613,720575940628855595,right,L1,310,2,22,9,13,"2,22"
2614,720575940612306382,right,L1,311,-7,15,14,1,"-7,15"
2615,720575940630702585,right,L1,312,4,-7,-8,1,"4,-7"
2616,720575940622404212,right,L1,313,7,3,-6,9,"7,3"
2617,720575940643788960,right,L1,314,-9,5,11,-6,"-9,5"
2618,720575940622513481,right,L1,315,-3,-6,0,-6,"-3,-6"
2619,720575940621340080,right,L1,316,5,-4,-7,3,"5,-4"
2620,720575940612277454,right,L1,317,-5,-4,3,-7,"-5,-4"
2621,720575940632457320,right,L1,318,4,-19,-14,-5,"4,-19"
2622,720575940607674754,right,L1,319,-2,5,4,1,"-2,5"
2623,720575940639337781,right,L1,320,-2,-5,-1,-4,"-2,-5"
2624,720575940618442726,right,L1,321,8,4,-6,10,"8,4"
2625,720575940632521064,right,L1,322,2,26,11,15,"2,26"
2626,720575940621234859,right,L1,323,-7,-13,0,-13,"-7,-13"
2627,720575940625550996,right,L1,324,3,24,9,15,"3,24"
2628,720575940626683834,right,L1,325,5,1,-5,6,"5,1"
2629,720575940612867045,right,L1,326,2,16,6,10,"2,16"
2630,720575940628679400,right,L1,327,5,3,-4,7,"5,3"
2631,720575940625023475,right,L1,328,5,-9,-10,1,"5,-9"
2632,720575940614077491,right,L1,329,0,24,12,12,"0,24"
2633,720575940615205087,right,L1,330,3,3,-2,5,"3,3"
2634,720575940631307769,right,L1,331,1,-15,-9,-6,"1,-15"
2635,720575940617263221,right,L1,332,4,-26,-17,-9,"4,-26"
2636,720575940633663917,right,L1,333,0,-21,-11,-10,"0,-21"
2637,720575940640403827,right,L1,334,1,-26,-14,-12,"1,-26"
2638,720575940634490594,right,L1,335,2,8,2,6,"2,8"
2639,720575940613877151,right,L1,336,0,23,11,12,"0,23"
2640,720575940629867599,right,L1,337,-5,-6,2,-8,"-5,-6"
2641,720575940635249775,right,L1,338,-1,0,1,-1,"-1,0"
2642,720575940612661683,right,L1,339,6,11,-1,12,"6,11"
2643,720575940631086636,right,L1,340,-4,17,12,5,"-4,17"
2644,720575940637157232,right,L1,341,6,-17,-15,-2,"6,-17"
2645,720575940628099154,right,L1,342,2,-15,-10,-5,"2,-15"
2646,720575940623488477,right,L1,343,-3,27,16,11,"-3,27"
2647,720575940622986279,right,L1,344,-2,-15,-6,-9,"-2,-15"
2648,720575940627856200,right,L1,345,3,-12,-9,-3,"3,-12"
2649,720575940614750102,right,L1,346,-7,-9,2,-11,"-7,-9"
2650,720575940637518510,right,L1,347,-5,-13,-2,-11,"-5,-13"
2651,720575940637549486,right,L1,348,3,14,4,10,"3,14"
2652,720575940609405963,right,L1,349,-5,-14,-2,-12,"-5,-14"
2653,720575940641623515,right,L1,350,1,15,6,9,"1,15"
2654,720575940647580468,right,L1,351,-1,-17,-8,-9,"-1,-17"
2655,720575940633870125,right,L1,352,-2,28,16,12,"-2,28"
2656,720575940625803620,right,L1,353,2,24,10,14,"2,24"
2657,720575940628558084,right,L1,354,-2,-26,-11,-15,"-2,-26"
2658,720575940632667987,right,L1,355,-7,-6,4,-10,"-7,-6"
2659,720575940606798537,right,L1,356,0,22,11,11,"0,22"
2660,720575940622342689,right,L1,357,4,17,4,13,"4,17"
2661,720575940622788702,right,L1,358,-3,17,11,6,"-3,17"
2662,720575940623631850,right,L1,359,2,23,9,14,"2,23"
2663,720575940612877937,right,L1,360,-5,19,14,5,"-5,19"
2664,720575940611508942,right,L1,361,0,-7,-4,-3,"0,-7"
2665,720575940613513842,right,L1,362,2,-20,-12,-8,"2,-20"
2666,720575940608522761,right,L1,363,7,-4,-9,5,"7,-4"
2667,720575940624948553,right,L1,364,4,4,-2,6,"4,4"
2668,720575940619692965,right,L1,365,4,7,-1,8,"4,7"
2669,720575940626925754,right,L1,366,-5,-20,-5,-15,"-5,-20"
2670,720575940632084239,right,L1,367,-6,-15,-2,-13,"-6,-15"
2671,720575940641361360,right,L1,368,-4,-20,-6,-14,"-4,-20"
2672,720575940625696270,right,L1,369,5,-5,-8,3,"5,-5"
2673,720575940606552422,right,L1,370,-3,21,13,8,"-3,21"
2674,720575940636273520,right,L1,371,6,-5,-9,4,"6,-5"
2675,720575940618596731,right,L1,372,1,-2,-2,0,"1,-2"
2676,720575940628430248,right,L1,373,1,-21,-12,-9,"1,-21"
2677,720575940624703792,right,L1,374,2,13,4,9,"2,13"
2678,720575940636928631,right,L1,375,-6,7,9,-2,"-6,7"
2679,720575940605747902,right,L1,376,-7,-10,2,-12,"-7,-10"
2680,720575940623688653,right,L1,377,0,7,3,4,"0,7"
2681,720575940637773486,right,L1,378,-3,18,12,6,"-3,18"
2682,720575940625058568,right,L1,379,3,-17,-12,-5,"3,-17"
2683,720575940632362809,right,L1,380,-1,29,15,14,"-1,29"
2684,720575940658842497,right,L1,381,-8,-9,3,-12,"-8,-9"
2685,720575940627309394,right,L1,382,3,-6,-6,0,"3,-6"
2686,720575940628546759,right,L1,383,-6,11,11,0,"-6,11"
2687,720575940631269963,right,L1,384,-6,-2,5,-7,"-6,-2"
2688,720575940612526997,right,L1,385,-3,-18,-6,-12,"-3,-18"
2689,720575940639636046,right,L1,386,-6,19,15,4,"-6,19"
2690,720575940618992798,right,L1,387,-1,-15,-7,-8,"-1,-15"
2691,720575940630959704,right,L1,388,3,19,6,13,"3,19"
2692,720575940656058785,right,L1,389,-6,-16,-2,-14,"-6,-16"
2693,720575940622437885,right,L1,390,-6,-9,1,-10,"-6,-9"
2694,720575940627197194,right,L1,391,4,-3,-6,3,"4,-3"
2695,720575940625798332,right,L1,392,-4,7,7,0,"-4,7"
2696,720575940620007919,right,L1,393,-1,22,12,10,"-1,22"
2697,720575940630591084,right,L1,394,-7,-8,3,-11,"-7,-8"
2698,720575940631201142,right,L1,395,0,-22,-11,-11,"0,-22"
2699,720575940623578260,right,L1,396,-1,10,6,4,"-1,10"
2700,720575940614765487,right,L1,397,-3,-19,-7,-12,"-3,-19"
2701,720575940625339261,right,L1,398,-3,22,14,8,"-3,22"
2702,720575940611796690,right,L1,399,-4,-24,-8,-16,"-4,-24"
2703,720575940628302735,right,L1,400,1,-29,-16,-13,"1,-29"
2704,720575940648239492,right,L1,401,-2,-19,-8,-11,"-2,-19"
2705,720575940630726108,right,L1,402,3,26,10,16,"3,26"
2706,720575940618044116,right,L1,403,-2,-12,-4,-8,"-2,-12"
2707,720575940632003640,right,L1,404,-1,20,11,9,"-1,20"
2708,720575940634176668,right,L1,405,3,10,2,8,"3,10"
2709,720575940626651338,right,L1,406,1,-25,-14,-11,"1,-25"
2710,720575940628680977,right,L1,407,-5,-10,0,-10,"-5,-10"
2711,720575940620206983,right,L1,408,-6,-4,4,-8,"-6,-4"
2712,720575940623907533,right,L1,409,0,-3,-2,-1,"0,-3"
2713,720575940629153623,right,L1,410,-2,-2,1,-3,"-2,-2"
2714,720575940631553111,right,L1,411,-5,-19,-5,-14,"-5,-19"
2715,720575940621692251,right,L1,412,-6,21,16,5,"-6,21"
2716,720575940632699715,right,L1,413,-2,-7,-2,-5,"-2,-7"
2717,720575940620344280,right,L1,414,4,21,6,15,"4,21"
2718,720575940628691655,right,L1,415,6,12,0,12,"6,12"
2719,720575940606273056,right,L1,416,3,-8,-7,-1,"3,-8"
2720,720575940633914579,right,L1,417,-6,-10,1,-11,"-6,-10"
2721,720575940627203843,right,L1,418,-2,15,9,6,"-2,15"
2722,720575940637666734,right,L1,419,-3,-11,-3,-8,"-3,-11"
2723,720575940622705946,right,L1,420,6,-3,-8,5,"6,-3"
2724,720575940641654480,right,L1,421,-1,12,7,5,"-1,12"
2725,720575940630186907,right,L1,422,-7,-4,5,-9,"-7,-4"
2726,720575940632060946,right,L1,423,3,-18,-12,-6,"3,-18"
2727,720575940624815847,right,L1,424,-3,-2,2,-4,"-3,-2"
2728,720575940620772369,right,L1,425,3,20,7,13,"3,20"
2729,720575940616116330,right,L1,426,-3,0,3,-3,"-3,0"
2730,720575940620320472,right,L1,427,5,-18,-14,-4,"5,-18"
2731,720575940615389034,right,L1,428,-2,23,13,10,"-2,23"
2732,720575940620711115,right,L1,429,-2,14,9,5,"-2,14"
2733,720575940629790506,right,L1,430,-3,-7,-1,-6,"-3,-7"
2734,720575940630314839,right,L1,431,-2,-10,-3,-7,"-2,-10"
2735,720575940621391297,right,L1,432,-5,7,8,-1,"-5,7"
2736,720575940625293901,right,L1,433,0,-8,-4,-4,"0,-8"
2737,720575940610206403,right,L1,434,-3,7,6,1,"-3,7"
2738,720575940628859408,right,L1,435,5,-17,-14,-3,"5,-17"
2739,720575940619070366,right,L1,436,0,-15,-8,-7,"0,-15"
2740,720575940614592175,right,L1,437,-3,12,9,3,"-3,12"
2741,720575940635862264,right,L1,438,2,27,11,16,"2,27"
2742,720575940630243626,right,L1,439,-3,-9,-2,-7,"-3,-9"
2743,720575940605633714,right,L1,440,1,23,10,13,"1,23"
2744,720575940649784185,right,L1,441,3,-16,-11,-5,"3,-16"
2745,720575940661120385,right,L1,442,-5,25,17,8,"-5,25"
2746,720575940627322122,right,L1,443,-6,4,8,-4,"-6,4"
2747,720575940618460229,right,L1,444,4,-10,-9,-1,"4,-10"
2748,720575940615226770,right,L1,445,-2,8,6,2,"-2,8"
2749,720575940624004095,right,L1,446,2,-14,-9,-5,"2,-14"
2750,720575940622892947,right,L1,447,-1,2,2,0,"-1,2"
2751,720575940626932682,right,L1,448,0,30,15,15,"0,30"
2752,720575940615257767,right,L1,449,6,-16,-14,-2,"6,-16"
2753,720575940623349128,right,L1,450,2,-9,-7,-2,"2,-9"
2754,720575940611088482,right,L1,451,4,20,6,14,"4,20"
2755,720575940622760584,right,L1,452,1,-9,-6,-3,"1,-9"
2756,720575940620343256,right,L1,453,3,25,9,16,"3,25"
2757,720575940623555780,right,L1,454,5,-12,-11,-1,"5,-12"
2758,720575940629775863,right,L1,455,7,-7,-11,4,"7,-7"
2759,720575940638254825,right,L1,456,0,21,10,11,"0,21"
2760,720575940614574511,right,L1,457,-2,17,10,7,"-2,17"
2761,720575940624101117,right,L1,458,5,0,-5,5,"5,0"
2762,720575940610632494,right,L1,459,5,-3,-7,4,"5,-3"
2763,720575940605948332,right,L1,460,-3,-20,-7,-13,"-3,-20"
2764,720575940629995087,right,L1,461,7,-5,-10,5,"7,-5"
2765,720575940639579206,right,L1,462,-1,18,10,8,"-1,18"
2766,720575940621003611,right,L1,463,5,17,3,14,"5,17"
2767,720575940622351228,right,L1,464,4,0,-4,4,"4,0"
2768,720575940622762120,right,L1,465,3,0,-3,3,"3,0"
2769,720575940634797724,right,L1,466,1,14,6,8,"1,14"
2770,720575940631007488,right,L1,467,-2,-20,-8,-12,"-2,-20"
2771,720575940634199778,right,L1,468,-3,11,8,3,"-3,11"
2772,720575940620548289,right,L1,470,4,-9,-9,0,"4,-9"
2773,720575940632054546,right,L1,471,3,-26,-16,-10,"3,-26"
2774,720575940624244818,right,L1,472,1,25,11,14,"1,25"
2775,720575940643811488,right,L1,473,-4,23,15,8,"-4,23"
2776,720575940640218446,right,L1,474,-3,-17,-6,-11,"-3,-17"
2777,720575940613532133,right,L1,475,-4,-1,3,-4,"-4,-1"
2778,720575940629039100,right,L1,476,-1,15,8,7,"-1,15"
2779,720575940607755721,right,L1,477,-3,2,4,-2,"-3,2"
2780,720575940633013807,right,L1,478,-7,16,15,1,"-7,16"
2781,720575940623606040,right,L1,479,-2,10,7,3,"-2,10"
2782,720575940612680817,right,L1,480,3,-19,-13,-6,"3,-19"
2783,720575940621449893,right,L1,481,4,-8,-8,0,"4,-8"
2784,720575940614527725,right,L1,482,1,17,7,10,"1,17"
2785,720575940632976159,right,L1,483,2,-7,-6,-1,"2,-7"
2786,720575940638806854,right,L1,484,3,-9,-8,-1,"3,-9"
2787,720575940639453774,right,L1,485,-3,-3,1,-4,"-3,-3"
2788,720575940625585812,right,L1,486,0,1,0,1,"0,1"
2789,720575940617112321,right,L1,487,1,-1,-2,1,"1,-1"
2790,720575940613435363,right,L1,488,7,5,-5,10,"7,5"
2791,720575940636361140,right,L1,489,-3,10,8,2,"-3,10"
2792,720575940652575222,right,L1,490,-5,6,8,-2,"-5,6"
2793,720575940640144768,right,L1,491,7,-1,-8,7,"7,-1"
2794,720575940632928593,right,L1,492,-7,-2,6,-8,"-7,-2"
2795,720575940627633412,right,L1,493,-3,23,14,9,"-3,23"
2796,720575940632771757,right,L1,494,0,29,14,15,"0,29"
2797,720575940619056413,right,L1,495,4,5,-2,7,"4,5"
2798,720575940610656046,right,L1,496,7,8,-3,11,"7,8"
2799,720575940614959144,right,L1,497,6,1,-6,7,"6,1"
2800,720575940637639908,right,L1,498,6,10,-1,11,"6,10"
2801,720575940622641321,right,L1,499,5,10,0,10,"5,10"
2802,720575940630820879,right,L1,500,7,-8,-11,3,"7,-8"
2803,720575940636086414,right,L1,501,1,2,0,2,"1,2"
2804,720575940613662834,right,L1,502,5,8,-1,9,"5,8"
2805,720575940627423251,right,L1,503,3,17,5,12,"3,17"
2806,720575940621288216,right,L1,504,-2,9,6,3,"-2,9"
2807,720575940626652874,right,L1,505,6,-22,-17,-5,"6,-22"
2808,720575940630710009,right,L1,506,1,-12,-7,-5,"1,-12"
2809,720575940635639999,right,L1,507,-5,-12,-1,-11,"-5,-12"
2810,720575940618896197,right,L1,508,-5,11,10,1,"-5,11"
2811,720575940625933901,right,L1,509,-4,10,9,1,"-4,10"
2812,720575940619699183,right,L1,510,-2,11,7,4,"-2,11"
2813,720575940614027951,right,L1,511,5,-11,-11,0,"5,-11"
2814,720575940616355670,right,L1,512,6,0,-6,6,"6,0"
2815,720575940634850495,right,L1,513,-4,-13,-3,-10,"-4,-13"
2816,720575940620141317,right,L1,514,-4,-10,-1,-9,"-4,-10"
2817,720575940636727726,right,L1,515,-8,-7,4,-11,"-8,-7"
2818,720575940624026762,right,L1,517,6,3,-5,8,"6,3"
2819,720575940619833723,right,L1,518,-4,22,15,7,"-4,22"
2820,720575940624826343,right,L1,519,-5,-5,2,-7,"-5,-5"
2821,720575940625376660,right,L1,520,-2,-22,-9,-13,"-2,-22"
2822,720575940614371490,right,L1,521,6,-9,-11,2,"6,-9"
2823,720575940618737748,right,L1,522,-4,0,4,-4,"-4,0"
2824,720575940633452575,right,L1,523,2,14,5,9,"2,14"
2825,720575940628586728,right,L1,524,4,-20,-14,-6,"4,-20"
2826,720575940640411507,right,L1,525,-1,-20,-9,-11,"-1,-20"
2827,720575940622242684,right,L1,526,0,-10,-5,-5,"0,-10"
2828,720575940627648019,right,L1,527,-4,-8,0,-8,"-4,-8"
2829,720575940618843702,right,L1,528,2,7,1,6,"2,7"
2830,720575940622837272,right,L1,529,2,-2,-3,1,"2,-2"
2831,720575940623313080,right,L1,530,-3,-13,-4,-9,"-3,-13"
2832,720575940630747452,right,L1,531,1,0,-1,1,"1,0"
2833,720575940631300664,right,L1,532,-8,7,11,-4,"-8,7"
2834,720575940635819199,right,L1,533,0,-16,-8,-8,"0,-16"
2835,720575940627775253,right,L1,534,3,2,-2,4,"3,2"
2836,720575940621217601,right,L1,535,8,-4,-10,6,"8,-4"
2837,720575940618573888,right,L1,536,3,4,-1,5,"3,4"
2838,720575940637533870,right,L1,537,0,-23,-12,-11,"0,-23"
2839,720575940636117359,right,L1,538,-4,1,4,-3,"-4,1"
2840,720575940627126458,right,L1,539,-6,15,13,2,"-6,15"
2841,720575940627402633,right,L1,540,-2,-9,-3,-6,"-2,-9"
2842,720575940634203603,right,L1,541,-4,14,11,3,"-4,14"
2843,720575940630706681,right,L1,542,6,-13,-13,0,"6,-13"
2844,720575940623699946,right,L1,543,-1,-4,-1,-3,"-1,-4"
2845,720575940610982242,right,L1,544,3,-13,-10,-3,"3,-13"
2846,720575940624133424,right,L1,545,5,11,0,11,"5,11"
2847,720575940624414472,right,L1,546,3,6,0,6,"3,6"
2848,720575940634332697,right,L1,547,-1,21,11,10,"-1,21"
2849,720575940620513158,right,L1,548,1,-16,-9,-7,"1,-16"
2850,720575940611509198,right,L1,549,0,-9,-5,-4,"0,-9"
2851,720575940641671888,right,L1,550,-2,3,3,0,"-2,3"
2852,720575940622446227,right,L1,551,-4,-9,-1,-8,"-4,-9"
2853,720575940625968016,right,L1,552,4,-1,-5,4,"4,-1"
2854,720575940633296804,right,L1,553,-3,16,11,5,"-3,16"
2855,720575940631339535,right,L1,554,-9,-3,7,-10,"-9,-3"
2856,720575940631261911,right,L1,555,-4,9,8,1,"-4,9"
2857,720575940623061735,right,L1,556,0,10,5,5,"0,10"
2858,720575940633771684,right,L1,557,6,-10,-11,1,"6,-10"
2859,720575940625807859,right,L1,558,-4,-21,-7,-14,"-4,-21"
2860,720575940639427699,right,L1,559,-6,22,17,5,"-6,22"
2861,720575940638574662,right,L1,560,-7,14,14,0,"-7,14"
2862,720575940627838024,right,L1,562,-5,-2,4,-6,"-5,-2"
2863,720575940630785730,right,L1,563,5,-13,-12,-1,"5,-13"
2864,720575940634924444,right,L1,564,3,-23,-15,-8,"3,-23"
2865,720575940648243076,right,L1,565,0,-26,-13,-13,"0,-26"
2866,720575940623441449,right,L1,566,5,-8,-9,1,"5,-8"
2867,720575940626967448,right,L1,567,-2,22,13,9,"-2,22"
2868,720575940625750320,right,L1,568,-6,-8,2,-10,"-6,-8"
2869,720575940639828339,right,L1,569,6,6,-3,9,"6,6"
2870,720575940613977325,right,L1,570,2,25,10,15,"2,25"
2871,720575940624391146,right,L1,571,0,-14,-7,-7,"0,-14"
2872,720575940630089115,right,L1,572,-8,3,9,-6,"-8,3"
2873,720575940638067782,right,L1,573,4,14,3,11,"4,14"
2874,720575940623137868,right,L1,574,-6,5,8,-3,"-6,5"
2875,720575940627084132,right,L1,575,6,9,-2,11,"6,9"
2876,720575940618679579,right,L1,576,0,28,14,14,"0,28"
2877,720575940621304001,right,L1,577,5,-14,-12,-2,"5,-14"
2878,720575940623304230,right,L1,578,4,-11,-10,-1,"4,-11"
2879,720575940627095378,right,L1,579,-3,-10,-2,-8,"-3,-10"
2880,720575940648243588,right,L1,580,-2,-23,-10,-13,"-2,-23"
2881,720575940623570141,right,L1,581,3,9,1,8,"3,9"
2882,720575940618200788,right,L1,582,-1,23,12,11,"-1,23"
2883,720575940612637809,right,L1,583,3,-25,-16,-9,"3,-25"
2884,720575940628480840,right,L1,584,4,23,7,16,"4,23"
2885,720575940617262453,right,L1,585,-1,-23,-11,-12,"-1,-23"
2886,720575940613927139,right,L1,586,2,18,7,11,"2,18"
2887,720575940628229509,right,L1,587,4,22,7,15,"4,22"
2888,720575940623364988,right,L1,588,1,4,1,3,"1,4"
2889,720575940631019607,right,L1,589,-1,-5,-2,-3,"-1,-5"
2890,720575940626833957,right,L1,590,1,9,3,6,"1,9"
2891,720575940628686864,right,L1,591,3,-3,-5,2,"3,-3"
2892,720575940626814782,right,L1,592,3,-28,-17,-11,"3,-28"
2893,720575940636991918,right,L1,593,3,-14,-10,-4,"3,-14"
2894,720575940630712190,right,L1,594,7,-16,-15,-1,"7,-16"
2895,720575940631565817,right,L1,595,7,-12,-13,1,"7,-12"
2896,720575940620350680,right,L1,596,-4,-16,-4,-12,"-4,-16"
2897,720575940626922302,right,L1,597,4,1,-4,5,"4,1"
2898,720575940613516054,right,L1,598,2,-18,-11,-7,"2,-18"
2899,720575940623606296,right,L1,599,-1,9,5,4,"-1,9"
2900,720575940627107605,right,L1,600,3,-10,-8,-2,"3,-10"
2901,720575940616225247,right,L1,601,1,16,7,9,"1,16"
2902,720575940638767423,right,L1,602,4,-2,-5,3,"4,-2"
2903,720575940627533854,right,L1,603,-3,-23,-9,-14,"-3,-23"
2904,720575940628118440,right,L1,604,-6,-17,-3,-14,"-6,-17"
2905,720575940637490266,right,L1,605,3,15,4,11,"3,15"
2906,720575940648240260,right,L1,606,-1,-19,-9,-10,"-1,-19"
2907,720575940628885547,right,L1,607,1,18,8,10,"1,18"
2908,720575940635645279,right,L1,608,1,10,4,6,"1,10"
2909,720575940625330931,right,L1,609,-2,0,2,-2,"-2,0"
2910,720575940628582888,right,L1,610,2,-23,-14,-9,"2,-23"
2911,720575940610081987,right,L1,611,-1,-18,-8,-10,"-1,-18"
2912,720575940640420771,right,L1,612,-3,-26,-10,-16,"-3,-26"
2913,720575940628616209,right,L1,613,-8,-4,6,-10,"-8,-4"
2914,720575940623125735,right,L1,614,-2,-8,-2,-6,"-2,-8"
2915,720575940612325299,right,L1,615,-7,-7,3,-10,"-7,-7"
2916,720575940631278031,right,L1,616,-3,15,10,5,"-3,15"
2917,720575940623829197,right,L1,617,-2,-17,-7,-10,"-2,-17"
2918,720575940612819370,right,L1,618,-1,24,13,11,"-1,24"
2919,720575940606364262,right,L1,619,-4,-19,-6,-13,"-4,-19"
2920,720575940624225789,right,L1,620,7,1,-7,8,"7,1"
2921,720575940632256081,right,L1,621,1,24,11,13,"1,24"
2922,720575940621277318,right,L1,622,-5,20,15,5,"-5,20"
2923,720575940647679028,right,L1,623,1,13,5,8,"1,13"
2924,720575940623791543,right,L1,624,1,-17,-10,-7,"1,-17"
2925,720575940609900100,right,L1,625,-2,24,14,10,"-2,24"
2926,720575940627285147,right,L1,626,-5,-8,1,-9,"-5,-8"
2927,720575940623142349,right,L1,627,0,-1,-1,0,"0,-1"
2928,720575940628806824,right,L1,628,0,0,0,0,"0,0"
2929,720575940631121152,right,L1,629,4,24,8,16,"4,24"
2930,720575940629936027,right,L1,630,4,8,0,8,"4,8"
2931,720575940617948500,right,L1,631,1,26,12,14,"1,26"
2932,720575940636552184,right,L1,632,3,-20,-13,-7,"3,-20"
2933,720575940625059336,right,L1,633,-1,-24,-11,-13,"-1,-24"
2934,720575940639655997,right,L1,634,-3,-15,-5,-10,"-3,-15"
2935,720575940628090387,right,L1,635,6,-6,-9,3,"6,-6"
2936,720575940622397940,right,L1,636,0,6,3,3,"0,6"
2937,720575940631869738,right,L1,637,3,-21,-14,-7,"3,-21"
2938,720575940606810889,right,L1,638,-1,7,4,3,"-1,7"
2939,720575940633194287,right,L1,639,-4,19,13,6,"-4,19"
2940,720575940628454728,right,L1,640,-1,-16,-7,-9,"-1,-16"
2941,720575940631113815,right,L1,641,-8,-5,5,-10,"-8,-5"
2942,720575940620755366,right,L1,642,-5,-11,-1,-10,"-5,-11"
2943,720575940621014465,right,L1,643,6,14,1,13,"6,14"
2944,720575940633313444,right,L1,644,-6,18,15,3,"-6,18"
2945,720575940615631884,right,L1,645,-4,27,17,10,"-4,27"
2946,720575940605330022,right,L1,646,6,17,2,15,"6,17"
2947,720575940614283304,right,L1,647,-4,-7,0,-7,"-4,-7"
2948,720575940644883479,right,L1,648,1,7,2,5,"1,7"
2949,720575940636303728,right,L1,649,-1,5,3,2,"-1,5"
2950,720575940646131566,right,L1,650,-3,-25,-10,-15,"-3,-25"
2951,720575940627039006,right,L1,651,-4,-5,1,-6,"-4,-5"
2952,720575940639675480,right,L1,652,-6,-11,0,-11,"-6,-11"
2953,720575940638721001,right,L1,653,-6,-12,0,-12,"-6,-12"
2954,720575940605376224,right,L1,654,-3,8,7,1,"-3,8"
2955,720575940627489874,right,L1,655,6,-1,-7,6,"6,-1"
2956,720575940620862829,right,L1,656,0,-11,-6,-5,"0,-11"
2957,720575940634324961,right,L1,657,-2,-25,-11,-14,"-2,-25"
2958,720575940624233715,right,L1,658,1,20,9,11,"1,20"
2959,720575940616413469,right,L1,659,-4,-6,1,-7,"-4,-6"
2960,720575940625919928,right,L1,660,2,28,12,16,"2,28"
2961,720575940636124084,right,L1,661,-3,14,10,4,"-3,14"
2962,720575940630733330,right,L1,662,2,-1,-3,2,"2,-1"
2963,720575940621032384,right,L1,663,0,8,4,4,"0,8"
2964,720575940623686792,right,L1,665,7,-2,-8,6,"7,-2"
2965,720575940626706576,right,L1,666,7,-13,-14,1,"7,-13"
2966,720575940631990826,right,L1,667,1,-28,-15,-13,"1,-28"
2967,720575940632804664,right,L1,668,1,19,8,11,"1,19"
2968,720575940628187450,right,L1,669,4,-16,-12,-4,"4,-16"
2969,720575940630986496,right,L1,670,5,5,-3,8,"5,5"
2970,720575940609398539,right,L1,671,-4,-23,-8,-15,"-4,-23"
2971,720575940624202739,right,L1,672,-8,11,13,-2,"-8,11"
2972,720575940622564476,right,L1,673,2,5,0,5,"2,5"
2973,720575940645377828,right,L1,674,-4,-14,-3,-11,"-4,-14"
2974,720575940642781236,right,L1,675,-7,19,16,3,"-7,19"
2975,720575940614760111,right,L1,676,-3,-21,-8,-13,"-3,-21"
2976,720575940611517048,right,L1,677,0,11,5,6,"0,11"
2977,720575940622011357,right,L1,678,3,-7,-7,0,"3,-7"
2978,720575940628912683,right,L1,679,4,18,5,13,"4,18"
2979,720575940623403196,right,L1,680,-1,25,13,12,"-1,25"
2980,720575940609440210,right,L1,681,-2,-21,-9,-12,"-2,-21"
2981,720575940610032579,right,L1,682,6,-8,-10,2,"6,-8"
2982,720575940631966777,right,L1,683,2,6,1,5,"2,6"
2983,720575940618430609,right,L1,684,-6,17,14,3,"-6,17"
2984,720575940624484843,right,L1,685,-5,-9,0,-9,"-5,-9"
2985,720575940620602960,right,L1,686,5,-22,-16,-6,"5,-22"
2986,720575940638053348,right,L1,687,-6,-3,4,-7,"-6,-3"
2987,720575940615795871,right,L1,688,-7,10,12,-2,"-7,10"
2988,720575940635205783,right,L1,689,-2,18,11,7,"-2,18"
2989,720575940607493065,right,L1,690,-7,-3,5,-8,"-7,-3"
2990,720575940642036187,right,L1,691,-9,4,11,-7,"-9,4"
2991,720575940627848841,right,L1,692,-4,24,16,8,"-4,24"
2992,720575940637602990,right,L1,693,-3,25,15,10,"-3,25"
2993,720575940628173394,right,L1,694,4,3,-3,6,"4,3"
2994,720575940620385556,right,L1,695,-6,10,11,-1,"-6,10"
2995,720575940636619621,right,L1,696,-2,16,10,6,"-2,16"
2996,720575940612765462,right,L1,697,1,-22,-12,-10,"1,-22"
2997,720575940635011996,right,L1,698,6,-7,-10,3,"6,-7"
2998,720575940639062350,right,L1,699,-5,0,5,-5,"-5,0"
2999,720575940612753557,right,L1,700,5,15,2,13,"5,15"
3000,720575940623448614,right,L1,701,0,-4,-2,-2,"0,-4"
3001,720575940625738544,right,L1,702,-5,23,16,7,"-5,23"
3002,720575940617330772,right,L1,703,-3,1,3,-2,"-3,1"
3003,720575940628753640,right,L1,704,-7,8,11,-3,"-7,8"
3004,720575940632183115,right,L1,705,1,1,-1,2,"1,1"
3005,720575940614016749,right,L1,706,-7,-12,1,-13,"-7,-12"
3006,720575940620234375,right,L1,707,-2,25,14,11,"-2,25"
3007,720575940645945111,right,L1,708,-4,-25,-9,-16,"-4,-25"
3008,720575940615204862,right,L1,709,-2,-24,-10,-14,"-2,-24"
3009,720575940623441373,right,L1,710,4,-25,-17,-8,"4,-25"
3010,720575940617338683,right,L1,711,-1,19,10,9,"-1,19"
3011,720575940622127088,right,L1,712,-7,12,13,-1,"-7,12"
3012,720575940609480459,right,L1,713,-6,16,14,2,"-6,16"
3013,720575940622836521,right,L1,714,5,12,1,11,"5,12"
3014,720575940640555635,right,L1,715,4,10,1,9,"4,10"
3015,720575940627244165,right,L1,716,4,-6,-7,1,"4,-6"
3016,720575940640399987,right,L1,717,2,-22,-13,-9,"2,-22"
3017,720575940654732193,right,L1,718,-5,24,17,7,"-5,24"
3018,720575940625627372,right,L1,719,1,27,12,15,"1,27"
3019,720575940637164151,right,L1,720,-5,21,15,6,"-5,21"
3020,720575940614340758,right,L1,721,5,13,1,12,"5,13"
3021,720575940622021146,right,L1,722,6,-15,-14,-1,"6,-15"
3022,720575940628208384,right,L1,723,-2,-11,-4,-7,"-2,-11"
3023,720575940624863783,right,L1,724,4,2,-3,5,"4,2"
3024,720575940613200307,right,L1,725,-3,-24,-9,-15,"-3,-24"
3025,720575940640409203,right,L1,726,2,-28,-16,-12,"2,-28"
3026,720575940616971788,right,L1,727,7,6,-4,10,"7,6"
3027,720575940605153708,right,L1,728,7,12,-1,13,"7,12"
3028,720575940628968444,right,L1,729,-3,29,17,12,"-3,29"
3029,720575940618499141,right,L1,730,7,0,-7,7,"7,0"
3030,720575940634583959,right,L1,731,-6,9,10,-1,"-6,9"
3031,720575940626281790,right,L1,732,-3,6,6,0,"-3,6"
3032,720575940625407380,right,L1,733,-5,-17,-4,-13,"-5,-17"
3033,720575940619831710,right,L1,734,2,0,-2,2,"2,0"
3034,720575940632754060,right,L1,735,1,-23,-13,-10,"1,-23"
3035,720575940623927304,right,L1,736,-8,1,8,-7,"-8,1"
3036,720575940620787182,right,L1,737,0,19,9,10,"0,19"
3037,720575940627737481,right,L1,738,-3,13,9,4,"-3,13"
3038,720575940607001801,right,L1,739,-7,2,8,-6,"-7,2"
3039,720575940630986959,right,L1,740,2,-8,-6,-2,"2,-8"
3040,720575940628695751,right,L1,741,-2,-14,-5,-9,"-2,-14"
3041,720575940623527059,right,L1,742,-4,11,9,2,"-4,11"
3042,720575940628426408,right,L1,743,6,-19,-16,-3,"6,-19"
3043,720575940622100464,right,L1,744,-4,25,16,9,"-4,25"
3044,720575940614275299,right,L1,745,0,13,6,7,"0,13"
3045,720575940647261987,right,L1,746,-3,3,4,-1,"-3,3"
3046,720575940637932400,right,L1,747,0,2,1,1,"0,2"
3047,720575940643006349,right,L1,748,-4,20,14,6,"-4,20"
3048,720575940623521003,right,L1,749,-2,1,2,-1,"-2,1"
3049,720575940612641649,right,L1,750,4,-24,-16,-8,"4,-24"
3050,720575940624293578,right,L1,751,1,6,2,4,"1,6"
3051,720575940617961309,right,L1,752,-2,7,5,2,"-2,7"
3052,720575940616364866,right,L1,753,-3,24,15,9,"-3,24"
3053,720575940627013406,right,L1,754,-1,-13,-6,-7,"-1,-13"
3054,720575940647109764,right,L1,755,4,19,5,14,"4,19"
3055,720575940620344792,right,L1,756,5,20,5,15,"5,20"
3056,720575940640407128,right,L1,757,0,-6,-3,-3,"0,-6"
3057,720575940630252764,right,L1,758,5,-1,-6,5,"5,-1"
3058,720575940624769800,right,L1,759,7,14,0,14,"7,14"
3059,720575940616781766,right,L1,760,0,17,8,9,"0,17"
3060,720575940635637951,right,L1,761,-4,-18,-5,-13,"-4,-18"
3061,720575940627707529,right,L1,762,0,14,7,7,"0,14"
3062,720575940633188689,right,L1,763,-5,14,12,2,"-5,14"
3063,720575940633800930,right,L1,764,-8,-6,5,-11,"-8,-6"
3064,720575940632005674,right,L1,765,-3,9,7,2,"-3,9"
3065,720575940618922653,right,L1,766,2,-4,-4,0,"2,-4"
3066,720575940640502435,right,L1,767,1,28,13,15,"1,28"
3067,720575940616129642,right,L1,768,3,5,-1,6,"3,5"
3068,720575940629176875,right,L1,769,4,-27,-18,-9,"4,-27"
3069,720575940621717441,right,L1,770,5,4,-3,7,"5,4"
3070,720575940640162613,right,L1,771,3,-27,-17,-10,"3,-27"
3071,720575940620847124,right,L1,772,1,12,5,7,"1,12"
3072,720575940625354644,right,L1,773,5,-19,-15,-4,"5,-19"
3073,720575940625587484,right,L1,774,-8,6,11,-5,"-8,6"
3074,720575940616277826,right,L1,775,5,22,6,16,"5,22"
3075,720575940620224785,right,L1,776,5,21,5,16,"5,21"
3076,720575940624054310,right,L1,777,6,20,4,16,"6,20"
3077,720575940612955098,right,L1,778,4,25,8,17,"4,25"
3078,720575940605423532,right,L1,779,5,24,7,17,"5,24"
3079,720575940615054186,right,L1,780,-6,25,18,7,"-6,25"
3080,720575940611397218,right,L1,781,-5,26,18,8,"-5,26"
3081,720575940625973692,right,L1,783,-4,28,18,10,"-4,28"
3082,720575940638951002,right,L1,784,-4,29,18,11,"-4,29"
3083,720575940653065462,right,L1,785,-3,30,18,12,"-3,30"
3084,720575940631955653,right,L1,786,-2,30,17,13,"-2,30"
3085,720575940619702848,right,L1,787,3,28,11,17,"3,28"
3086,720575940633067079,right,L1,788,3,27,10,17,"3,27"
3087,720575940616960699,right,L1,789,-3,-27,-11,-16,"-3,-27"
3088,720575940621055141,right,L1,790,-2,-27,-12,-15,"-2,-27"
3089,720575940634395618,right,L1,791,-1,-28,-13,-15,"-1,-28"
3090,720575940612448790,right,L1,792,8,2,-7,9,"8,2"
3091,720575940624779959,right,L1,793,8,-6,-11,5,"8,-6"
3092,720575940630681538,right,L1,794,5,-26,-18,-8,"5,-26"
3093,720575940614548655,right,L1,795,6,-21,-17,-4,"6,-21"
3094,720575940633647789,right,L1,796,4,26,9,17,"4,26"
3095,720575940626380365,right,L2,1,-6,13,12,1,"-6,13"
3096,720575940628140565,right,L2,2,-8,2,9,-7,"-8,2"
3097,720575940622880244,right,L2,3,6,-12,-12,0,"6,-12"
3098,720575940627097290,right,L2,4,-5,-21,-6,-15,"-5,-21"
3099,720575940633817569,right,L2,5,-1,16,9,7,"-1,16"
3100,720575940618289113,right,L2,6,-2,-4,0,-4,"-2,-4"
3101,720575940620313685,right,L2,7,-6,-6,3,-9,"-6,-6"
3102,720575940614856488,right,L2,8,-4,26,17,9,"-4,26"
3103,720575940611964330,right,L2,9,4,9,0,9,"4,9"
3104,720575940625066423,right,L2,10,5,-15,-13,-2,"5,-15"
3105,720575940621699873,right,L2,11,7,-14,-14,0,"7,-14"
3106,720575940606286001,right,L2,12,-7,9,11,-2,"-7,9"
3107,720575940629280617,right,L2,13,-1,-26,-12,-14,"-1,-26"
3108,720575940643901344,right,L2,14,0,-27,-14,-13,"0,-27"
3109,720575940642998413,right,L2,15,2,-3,-4,1,"2,-3"
3110,720575940625236232,right,L2,16,-2,-16,-6,-10,"-2,-16"
3111,720575940643779528,right,L2,17,1,-5,-4,-1,"1,-5"
3112,720575940610204228,right,L2,18,5,-16,-13,-3,"5,-16"
3113,720575940611853522,right,L2,19,-7,17,15,2,"-7,17"
3114,720575940626837379,right,L2,20,3,-11,-9,-2,"3,-11"
3115,720575940631151324,right,L2,21,-2,19,11,8,"-2,19"
3116,720575940614557663,right,L2,22,-1,3,2,1,"-1,3"
3117,720575940630210092,right,L2,23,-3,-16,-5,-11,"-3,-16"
3118,720575940627857278,right,L2,24,-1,-10,-4,-6,"-1,-10"
3119,720575940624505382,right,L2,25,-9,3,10,-7,"-9,3"
3120,720575940627211292,right,L2,26,1,-3,-3,0,"1,-3"
3121,720575940626197434,right,L2,27,0,-25,-13,-12,"0,-25"
3122,720575940619030853,right,L2,28,5,6,-2,8,"5,6"
3123,720575940624145432,right,L2,29,-1,-3,-1,-2,"-1,-3"
3124,720575940637097847,right,L2,30,6,16,2,14,"6,16"
3125,720575940629367114,right,L2,31,0,16,8,8,"0,16"
3126,720575940630065720,right,L2,32,0,12,6,6,"0,12"
3127,720575940631124224,right,L2,33,3,18,6,12,"3,18"
3128,720575940605353760,right,L2,34,6,18,3,15,"6,18"
3129,720575940627291198,right,L2,35,1,-24,-13,-11,"1,-24"
3130,720575940616988884,right,L2,36,6,8,-2,10,"6,8"
3131,720575940645578532,right,L2,37,1,5,1,4,"1,5"
3132,720575940647104291,right,L2,38,0,-2,-1,-1,"0,-2"
3133,720575940615078034,right,L2,39,0,20,10,10,"0,20"
3134,720575940606762418,right,L2,40,-2,-6,-1,-5,"-2,-6"
3135,720575940617297467,right,L2,41,-3,28,17,11,"-3,28"
3136,720575940626023568,right,L2,42,-1,14,8,6,"-1,14"
3137,720575940605701036,right,L2,43,-5,18,14,4,"-5,18"
3138,720575940625814932,right,L2,44,5,-10,-10,0,"5,-10"
3139,720575940639473280,right,L2,45,-5,-1,4,-5,"-5,-1"
3140,720575940629980163,right,L2,46,-5,15,12,3,"-5,15"
3141,720575940619135798,right,L2,47,-9,-1,8,-9,"-9,-1"
3142,720575940628741638,right,L2,48,-4,-22,-7,-15,"-4,-22"
3143,720575940616468383,right,L2,49,4,-4,-6,2,"4,-4"
3144,720575940633137711,right,L2,50,-2,21,12,9,"-2,21"
3145,720575940617259963,right,L2,51,0,-19,-10,-9,"0,-19"
3146,720575940627035932,right,L2,52,-1,-22,-10,-12,"-1,-22"
3147,720575940620582168,right,L2,53,5,14,2,12,"5,14"
3148,720575940625347220,right,L2,54,-4,3,5,-2,"-4,3"
3149,720575940660372609,right,L2,55,-4,-11,-2,-9,"-4,-11"
3150,720575940626784304,right,L2,56,1,-13,-8,-5,"1,-13"
3151,720575940613531109,right,L2,57,6,-11,-12,1,"6,-11"
3152,720575940627099179,right,L2,58,3,12,3,9,"3,12"
3153,720575940639020122,right,L2,59,-2,2,3,-1,"-2,2"
3154,720575940626726704,right,L2,60,-8,8,12,-4,"-8,8"
3155,720575940615759682,right,L2,61,-4,-4,2,-6,"-4,-4"
3156,720575940616751755,right,L2,62,0,-29,-15,-14,"0,-29"
3157,720575940623348067,right,L2,63,4,12,2,10,"4,12"
3158,720575940645329774,right,L2,64,4,-23,-16,-7,"4,-23"
3159,720575940605573088,right,L2,65,-1,28,15,13,"-1,28"
3160,720575940626784560,right,L2,66,2,15,5,10,"2,15"
3161,720575940634283545,right,L2,67,-2,-13,-5,-8,"-2,-13"
3162,720575940625755576,right,L2,68,3,16,5,11,"3,16"
3163,720575940611313966,right,L2,69,1,8,3,5,"1,8"
3164,720575940635925855,right,L2,70,-4,21,14,7,"-4,21"
3165,720575940644518167,right,L2,71,-2,-3,0,-3,"-2,-3"
3166,720575940618327089,right,L2,72,0,-28,-14,-14,"0,-28"
3167,720575940624187575,right,L2,73,2,2,-1,3,"2,2"
3168,720575940640863360,right,L2,74,-1,-9,-4,-5,"-1,-9"
3169,720575940617401601,right,L2,75,-6,14,13,1,"-6,14"
3170,720575940626769957,right,L2,76,-3,-4,1,-5,"-3,-4"
3171,720575940632072296,right,L2,77,2,-5,-5,0,"2,-5"
3172,720575940637864819,right,L2,78,2,20,8,12,"2,20"
3173,720575940627556690,right,L2,79,2,1,-2,3,"2,1"
3174,720575940618431069,right,L2,80,4,13,2,11,"4,13"
3175,720575940621616112,right,L2,81,6,-2,-7,5,"6,-2"
3176,720575940629051651,right,L2,82,-7,7,10,-3,"-7,7"
3177,720575940637951551,right,L2,83,2,-21,-13,-8,"2,-21"
3178,720575940613459314,right,L2,84,-2,12,8,4,"-2,12"
3179,720575940617818342,right,L2,85,4,-22,-15,-7,"4,-22"
3180,720575940622017121,right,L2,86,-5,-7,1,-8,"-5,-7"
3181,720575940614965502,right,L2,87,1,11,4,7,"1,11"
3182,720575940620620504,right,L2,88,7,4,-5,9,"7,4"
3183,720575940628552520,right,L2,89,1,-19,-11,-8,"1,-19"
3184,720575940616158530,right,L2,90,-4,5,6,-1,"-4,5"
3185,720575940633679955,right,L2,91,-1,6,4,2,"-1,6"
3186,720575940629099719,right,L2,92,0,9,4,5,"0,9"
3187,720575940634693089,right,L2,93,-6,3,7,-4,"-6,3"
3188,720575940607829122,right,L2,94,5,18,4,14,"5,18"
3189,720575940630037751,right,L2,95,4,-21,-15,-6,"4,-21"
3190,720575940626813328,right,L2,96,1,-10,-6,-4,"1,-10"
3191,720575940606568126,right,L2,97,-5,2,6,-4,"-5,2"
3192,720575940623137535,right,L2,98,-1,-12,-5,-7,"-1,-12"
3193,720575940626545158,right,L2,99,4,15,3,12,"4,15"
3194,720575940628014991,right,L2,100,2,-10,-7,-3,"2,-10"
3195,720575940612966422,right,L2,101,-7,6,10,-4,"-7,6"
3196,720575940627166564,right,L2,102,3,13,3,10,"3,13"
3197,720575940621349313,right,L2,103,7,9,-3,12,"7,9"
3198,720575940627781272,right,L2,104,-1,-27,-13,-14,"-1,-27"
3199,720575940632998957,right,L2,105,3,22,8,14,"3,22"
3200,720575940623272035,right,L2,106,-7,11,12,-1,"-7,11"
3201,720575940637755310,right,L2,107,8,-2,-9,7,"8,-2"
3202,720575940627504015,right,L2,108,-3,-12,-3,-9,"-3,-12"
3203,720575940633002065,right,L2,109,4,-5,-7,2,"4,-5"
3204,720575940630987991,right,L2,110,-7,0,7,-7,"-7,0"
3205,720575940647574324,right,L2,111,2,-24,-14,-10,"2,-24"
3206,720575940627459642,right,L2,112,-6,1,6,-5,"-6,1"
3207,720575940631613743,right,L2,113,-2,4,4,0,"-2,4"
3208,720575940621817441,right,L2,114,2,-13,-9,-4,"2,-13"
3209,720575940628220682,right,L2,115,-4,2,5,-3,"-4,2"
3210,720575940627291291,right,L2,116,-1,-8,-3,-5,"-1,-8"
3211,720575940609625045,right,L2,117,-8,-2,7,-9,"-8,-2"
3212,720575940630049947,right,L2,118,3,1,-3,4,"3,1"
3213,720575940623621414,right,L2,119,-2,6,5,1,"-2,6"
3214,720575940614654175,right,L2,120,-1,-1,0,-1,"-1,-1"
3215,720575940623112925,right,L2,121,-8,4,10,-6,"-8,4"
3216,720575940624043007,right,L2,122,-5,9,9,0,"-5,9"
3217,720575940632587428,right,L2,123,-8,10,13,-3,"-8,10"
3218,720575940615552423,right,L2,124,1,-7,-5,-2,"1,-7"
3219,720575940643251104,right,L2,125,5,9,-1,10,"5,9"
3220,720575940621286168,right,L2,126,3,11,2,9,"3,11"
3221,720575940617630301,right,L2,127,0,15,7,8,"0,15"
3222,720575940605162668,right,L2,128,3,-22,-14,-8,"3,-22"
3223,720575940623889642,right,L2,129,0,-13,-7,-6,"0,-13"
3224,720575940639847795,right,L2,130,2,12,4,8,"2,12"
3225,720575940619256222,right,L2,131,-6,20,16,4,"-6,20"
3226,720575940634322583,right,L2,132,2,4,0,4,"2,4"
3227,720575940637748446,right,L2,133,-3,20,13,7,"-3,20"
3228,720575940626141221,right,L2,134,-5,-18,-4,-14,"-5,-18"
3229,720575940626250954,right,L2,135,-3,-22,-8,-14,"-3,-22"
3230,720575940634217114,right,L2,136,0,3,1,2,"0,3"
3231,720575940638914276,right,L2,137,5,-7,-9,2,"5,-7"
3232,720575940637236336,right,L2,138,0,27,13,14,"0,27"
3233,720575940616287711,right,L2,139,1,-14,-8,-6,"1,-14"
3234,720575940631507275,right,L2,140,3,8,1,7,"3,8"
3235,720575940605907586,right,L2,141,5,-23,-17,-6,"5,-23"
3236,720575940633246125,right,L2,142,-2,-18,-7,-11,"-2,-18"
3237,720575940631388534,right,L2,143,-4,16,12,4,"-4,16"
3238,720575940636338283,right,L2,144,7,-11,-13,2,"7,-11"
3239,720575940616780731,right,L2,145,0,4,2,2,"0,4"
3240,720575940630873548,right,L2,146,1,-6,-4,-2,"1,-6"
3241,720575940614743007,right,L2,147,1,21,9,12,"1,21"
3242,720575940629995386,right,L2,148,-7,-11,1,-12,"-7,-11"
3243,720575940625969712,right,L2,149,6,-14,-13,-1,"6,-14"
3244,720575940634238690,right,L2,150,-8,5,10,-5,"-8,5"
3245,720575940632494184,right,L2,151,-3,-14,-4,-10,"-3,-14"
3246,720575940625626092,right,L2,152,3,-15,-11,-4,"3,-15"
3247,720575940605817958,right,L2,153,8,0,-8,8,"8,0"
3248,720575940622434072,right,L2,154,-8,0,8,-8,"-8,0"
3249,720575940642039693,right,L2,155,-8,13,14,-1,"-8,13"
3250,720575940639447741,right,L2,156,-9,1,9,-8,"-9,1"
3251,720575940611760994,right,L2,157,-1,-7,-3,-4,"-1,-7"
3252,720575940620574190,right,L2,158,3,-5,-6,1,"3,-5"
3253,720575940645437476,right,L2,159,7,7,-4,11,"7,7"
3254,720575940624487108,right,L2,160,-2,20,12,8,"-2,20"
3255,720575940628086149,right,L2,161,4,-14,-11,-3,"4,-14"
3256,720575940636250292,right,L2,162,-4,-2,3,-5,"-4,-2"
3257,720575940628113655,right,L2,163,-9,7,12,-5,"-9,7"
3258,720575940613183923,right,L2,164,-1,-2,0,-2,"-1,-2"
3259,720575940618212432,right,L2,165,4,16,4,12,"4,16"
3260,720575940614869922,right,L2,166,0,18,9,9,"0,18"
3261,720575940618454621,right,L2,167,0,-17,-9,-8,"0,-17"
3262,720575940624446650,right,L2,168,-1,17,9,8,"-1,17"
3263,720575940632162883,right,L2,169,0,-18,-9,-9,"0,-18"
3264,720575940622005857,right,L2,170,-5,1,5,-4,"-5,1"
3265,720575940616470982,right,L2,171,6,-20,-16,-4,"6,-20"
3266,720575940638197850,right,L2,172,1,22,10,12,"1,22"
3267,720575940605169580,right,L2,173,2,-25,-15,-10,"2,-25"
3268,720575940632754488,right,L2,174,4,-15,-12,-3,"4,-15"
3269,720575940628656401,right,L2,175,-6,-7,2,-9,"-6,-7"
3270,720575940623172632,right,L2,176,-2,13,8,5,"-2,13"
3271,720575940619642021,right,L2,177,-2,-1,1,-2,"-2,-1"
3272,720575940610210372,right,L2,178,2,11,3,8,"2,11"
3273,720575940635245212,right,L2,179,-5,-16,-3,-13,"-5,-16"
3274,720575940624176787,right,L2,180,2,-27,-16,-11,"2,-27"
3275,720575940619142966,right,L2,181,1,-4,-3,-1,"1,-4"
3276,720575940620899019,right,L2,182,7,-10,-12,2,"7,-10"
3277,720575940627518227,right,L2,183,-5,-15,-3,-12,"-5,-15"
3278,720575940629037355,right,L2,184,-6,-5,3,-8,"-6,-5"
3279,720575940621215103,right,L2,185,2,-11,-8,-3,"2,-11"
3280,720575940636216500,right,L2,186,-1,26,14,12,"-1,26"
3281,720575940614200115,right,L2,187,3,21,7,14,"3,21"
3282,720575940632306706,right,L2,188,-5,17,13,4,"-5,17"
3283,720575940620608305,right,L2,189,6,13,0,13,"6,13"
3284,720575940618476317,right,L2,190,-3,-5,0,-5,"-3,-5"
3285,720575940627485461,right,L2,191,-1,-11,-5,-6,"-1,-11"
3286,720575940614383535,right,L2,192,7,10,-2,12,"7,10"
3287,720575940628975690,right,L2,193,-5,4,7,-3,"-5,4"
3288,720575940618366109,right,L2,194,0,-5,-3,-2,"0,-5"
3289,720575940628884606,right,L2,195,-3,-1,2,-3,"-3,-1"
3290,720575940644555168,right,L2,196,-1,8,5,3,"-1,8"
3291,720575940625139640,right,L2,197,0,-20,-10,-10,"0,-20"
3292,720575940647137844,right,L2,198,6,2,-5,7,"6,2"
3293,720575940620744664,right,L2,199,0,-12,-6,-6,"0,-12"
3294,720575940623253068,right,L2,200,-5,12,11,1,"-5,12"
3295,720575940639886755,right,L2,201,-8,9,12,-3,"-8,9"
3296,720575940624952051,right,L2,202,-1,27,14,13,"-1,27"
3297,720575940639016051,right,L2,203,3,-1,-4,3,"3,-1"
3298,720575940647152419,right,L2,204,5,-2,-6,4,"5,-2"
3299,720575940637415902,right,L2,205,5,-6,-8,2,"5,-6"
3300,720575940621289236,right,L2,206,-3,5,5,0,"-3,5"
3301,720575940612369614,right,L2,207,1,29,13,16,"1,29"
3302,720575940647377955,right,L2,208,5,-21,-16,-5,"5,-21"
3303,720575940605364396,right,L2,209,-3,-8,-1,-7,"-3,-8"
3304,720575940634797212,right,L2,210,-6,8,10,-2,"-6,8"
3305,720575940620724160,right,L2,211,-7,-1,6,-7,"-7,-1"
3306,720575940629966848,right,L2,212,2,-16,-10,-6,"2,-16"
3307,720575940629681411,right,L2,213,3,-4,-5,1,"3,-4"
3308,720575940628310794,right,L2,214,-5,3,6,-3,"-5,3"
3309,720575940621443776,right,L2,215,6,7,-3,10,"6,7"
3310,720575940630862843,right,L2,216,2,19,7,12,"2,19"
3311,720575940628742396,right,L2,217,6,15,1,14,"6,15"
3312,720575940629154310,right,L2,218,2,10,3,7,"2,10"
3313,720575940626095504,right,L2,219,6,-4,-8,4,"6,-4"
3314,720575940627818001,right,L2,220,2,-6,-5,-1,"2,-6"
3315,720575940626880144,right,L2,221,-7,3,8,-5,"-7,3"
3316,720575940628230135,right,L2,222,-3,26,16,10,"-3,26"
3317,720575940625650151,right,L2,223,-2,26,15,11,"-2,26"
3318,720575940628034058,right,L2,224,0,5,2,3,"0,5"
3319,720575940628153914,right,L2,225,2,-26,-15,-11,"2,-26"
3320,720575940626796377,right,L2,226,5,19,4,15,"5,19"
3321,720575940611215970,right,L2,227,-7,5,9,-4,"-7,5"
3322,720575940615366050,right,L2,228,-7,1,7,-6,"-7,1"
3323,720575940637583838,right,L2,229,5,2,-4,6,"5,2"
3324,720575940617567325,right,L2,230,2,9,2,7,"2,9"
3325,720575940608161410,right,L2,231,4,-12,-10,-2,"4,-12"
3326,720575940630015055,right,L2,232,-4,13,10,3,"-4,13"
3327,720575940622067828,right,L2,233,4,-13,-11,-2,"4,-13"
3328,720575940635530687,right,L2,234,1,3,0,3,"1,3"
3329,720575940623871978,right,L2,235,4,11,1,10,"4,11"
3330,720575940611994066,right,L2,236,-1,4,3,1,"-1,4"
3331,720575940614293288,right,L2,237,-2,27,15,12,"-2,27"
3332,720575940631431439,right,L2,238,-8,-3,6,-9,"-8,-3"
3333,720575940625527276,right,L2,239,-6,6,9,-3,"-6,6"
3334,720575940621901165,right,L2,240,-4,-3,2,-5,"-4,-3"
3335,720575940631841080,right,L2,241,2,-17,-11,-6,"2,-17"
3336,720575940628160004,right,L2,242,-4,6,7,-1,"-4,6"
3337,720575940616312898,right,L2,243,-1,-21,-10,-11,"-1,-21"
3338,720575940628742662,right,L2,244,-4,-12,-2,-10,"-4,-12"
3339,720575940645007895,right,L2,245,-5,-3,3,-6,"-5,-3"
3340,720575940616982614,right,L2,246,-4,15,11,4,"-4,15"
3341,720575940614855976,right,L2,247,-4,-15,-4,-11,"-4,-15"
3342,720575940609358603,right,L2,248,-6,0,6,-6,"-6,0"
3343,720575940619763358,right,L2,249,2,-12,-8,-4,"2,-12"
3344,720575940629010356,right,L2,250,-1,1,1,0,"-1,1"
3345,720575940639616189,right,L2,251,-1,-14,-6,-8,"-1,-14"
3346,720575940622221948,right,L2,252,3,23,8,15,"3,23"
3347,720575940626356557,right,L2,253,5,16,3,13,"5,16"
3348,720575940605662142,right,L2,254,3,-24,-15,-9,"3,-24"
3349,720575940621407726,right,L2,255,-6,-13,-1,-12,"-6,-13"
3350,720575940634880663,right,L2,256,5,-20,-15,-5,"5,-20"
3351,720575940627786769,right,L2,257,2,21,8,13,"2,21"
3352,720575940633996973,right,L2,258,-4,-17,-5,-12,"-4,-17"
3353,720575940613560549,right,L2,259,-7,-5,4,-9,"-7,-5"
3354,720575940624038340,right,L2,260,-3,19,12,7,"-3,19"
3355,720575940643642932,right,L2,261,-1,13,7,6,"-1,13"
3356,720575940626997434,right,L2,262,1,-11,-7,-4,"1,-11"
3357,720575940620229236,right,L2,263,-3,4,5,-1,"-3,4"
3358,720575940623964969,right,L2,264,-1,-6,-2,-4,"-1,-6"
3359,720575940613706818,right,L2,265,-6,-1,5,-6,"-6,-1"
3360,720575940626591490,right,L2,266,-1,-25,-12,-13,"-1,-25"
3361,720575940614758311,right,L2,267,-6,2,7,-5,"-6,2"
3362,720575940631152492,right,L2,268,7,-6,-10,4,"7,-6"
3363,720575940623452307,right,L2,269,2,-19,-12,-7,"2,-19"
3364,720575940628345733,right,L2,270,1,-8,-5,-3,"1,-8"
3365,720575940626764746,right,L2,271,4,6,-1,7,"4,6"
3366,720575940618547269,right,L2,272,3,-2,-4,2,"3,-2"
3367,720575940629033003,right,L2,273,-6,23,17,6,"-6,23"
3368,720575940632315467,right,L2,275,-8,-1,7,-8,"-8,-1"
3369,720575940624506293,right,L2,276,2,3,-1,4,"2,3"
3370,720575940620384597,right,L2,277,7,-3,-9,6,"7,-3"
3371,720575940617175710,right,L2,278,-5,10,10,0,"-5,10"
3372,720575940626564426,right,L2,279,-4,8,8,0,"-4,8"
3373,720575940623705368,right,L2,280,-6,-14,-1,-13,"-6,-14"
3374,720575940624302921,right,L2,281,-9,2,10,-8,"-9,2"
3375,720575940620716114,right,L2,282,0,26,13,13,"0,26"
3376,720575940639344693,right,L2,283,-4,4,6,-2,"-4,4"
3377,720575940625104568,right,L2,284,0,25,12,13,"0,25"
3378,720575940620035638,right,L2,285,6,-18,-15,-3,"6,-18"
3379,720575940640139598,right,L2,286,0,-24,-12,-12,"0,-24"
3380,720575940612196194,right,L2,287,-5,13,11,2,"-5,13"
3381,720575940616307284,right,L2,289,-1,11,6,5,"-1,11"
3382,720575940613728674,right,L2,290,5,-24,-17,-7,"5,-24"
3383,720575940634694496,right,L2,291,7,2,-6,8,"7,2"
3384,720575940632811880,right,L2,292,-4,18,13,5,"-4,18"
3385,720575940627942675,right,L2,293,4,-17,-13,-4,"4,-17"
3386,720575940633581516,right,L2,294,1,-20,-11,-9,"1,-20"
3387,720575940628136714,right,L2,296,1,-18,-10,-8,"1,-18"
3388,720575940623976291,right,L2,297,7,-9,-12,3,"7,-9"
3389,720575940625282488,right,L2,298,-5,5,7,-2,"-5,5"
3390,720575940637125495,right,L2,299,-4,12,10,2,"-4,12"
3391,720575940620034974,right,L2,300,4,-18,-13,-5,"4,-18"
3392,720575940613675030,right,L2,301,-5,16,13,3,"-5,16"
3393,720575940629290256,right,L2,302,2,17,6,11,"2,17"
3394,720575940614336209,right,L2,303,-5,22,16,6,"-5,22"
3395,720575940633429668,right,L2,304,6,5,-4,9,"6,5"
3396,720575940627290686,right,L2,305,-7,4,9,-5,"-7,4"
3397,720575940628994054,right,L2,306,3,7,0,7,"3,7"
3398,720575940626578521,right,L2,307,5,-25,-18,-7,"5,-25"
3399,720575940624958951,right,L2,308,-5,8,9,-1,"-5,8"
3400,720575940627468821,right,L2,309,-6,12,12,0,"-6,12"
3401,720575940628238824,right,L2,310,2,22,9,13,"2,22"
3402,720575940621683951,right,L2,311,-7,15,14,1,"-7,15"
3403,720575940618238425,right,L2,312,4,-7,-8,1,"4,-7"
3404,720575940629401930,right,L2,313,7,3,-6,9,"7,3"
3405,720575940627363870,right,L2,314,-9,5,11,-6,"-9,5"
3406,720575940618470996,right,L2,315,-3,-6,0,-6,"-3,-6"
3407,720575940629350730,right,L2,316,5,-4,-7,3,"5,-4"
3408,720575940627973754,right,L2,317,-5,-4,3,-7,"-5,-4"
3409,720575940628399121,right,L2,318,4,-19,-14,-5,"4,-19"
3410,720575940625987256,right,L2,319,-2,5,4,1,"-2,5"
3411,720575940631718819,right,L2,320,-2,-5,-1,-4,"-2,-5"
3412,720575940631095552,right,L2,321,8,4,-6,10,"8,4"
3413,720575940632828068,right,L2,322,2,26,11,15,"2,26"
3414,720575940630925911,right,L2,323,-7,-13,0,-13,"-7,-13"
3415,720575940628642759,right,L2,324,3,24,9,15,"3,24"
3416,720575940635361375,right,L2,325,5,1,-5,6,"5,1"
3417,720575940615787330,right,L2,326,2,16,6,10,"2,16"
3418,720575940629861419,right,L2,327,5,3,-4,7,"5,3"
3419,720575940629873018,right,L2,328,5,-9,-10,1,"5,-9"
3420,720575940605827174,right,L2,329,0,24,12,12,"0,24"
3421,720575940621971126,right,L2,330,3,3,-2,5,"3,3"
3422,720575940632350994,right,L2,331,1,-15,-9,-6,"1,-15"
3423,720575940629182055,right,L2,332,4,-26,-17,-9,"4,-26"
3424,720575940605833662,right,L2,333,0,-21,-11,-10,"0,-21"
3425,720575940626843236,right,L2,334,1,-26,-14,-12,"1,-26"
3426,720575940622939869,right,L2,335,2,8,2,6,"2,8"
3427,720575940620778516,right,L2,336,0,23,11,12,"0,23"
3428,720575940641661429,right,L2,337,-5,-6,2,-8,"-5,-6"
3429,720575940625807388,right,L2,338,-1,0,1,-1,"-1,0"
3430,720575940645486103,right,L2,339,6,11,-1,12,"6,11"
3431,720575940618278868,right,L2,340,-4,17,12,5,"-4,17"
3432,720575940623835389,right,L2,341,6,-17,-15,-2,"6,-17"
3433,720575940628001352,right,L2,342,2,-15,-10,-5,"2,-15"
3434,720575940627370302,right,L2,343,-3,27,16,11,"-3,27"
3435,720575940647946804,right,L2,344,-2,-15,-6,-9,"-2,-15"
3436,720575940623650857,right,L2,345,3,-12,-9,-3,"3,-12"
3437,720575940630213120,right,L2,346,-7,-9,2,-11,"-7,-9"
3438,720575940639234621,right,L2,347,-5,-13,-2,-11,"-5,-13"
3439,720575940626172035,right,L2,348,3,14,4,10,"3,14"
3440,720575940622955525,right,L2,349,-5,-14,-2,-12,"-5,-14"
3441,720575940621682102,right,L2,350,1,15,6,9,"1,15"
3442,720575940616991371,right,L2,351,-1,-17,-8,-9,"-1,-17"
3443,720575940630061467,right,L2,352,-2,28,16,12,"-2,28"
3444,720575940638334697,right,L2,353,2,24,10,14,"2,24"
3445,720575940619322539,right,L2,354,-2,-26,-11,-15,"-2,-26"
3446,720575940617249141,right,L2,355,-7,-6,4,-10,"-7,-6"
3447,720575940632485457,right,L2,356,0,22,11,11,"0,22"
3448,720575940606016288,right,L2,357,4,17,4,13,"4,17"
3449,720575940612970262,right,L2,358,-3,17,11,6,"-3,17"
3450,720575940612930582,right,L2,359,2,23,9,14,"2,23"
3451,720575940626014734,right,L2,360,-5,19,14,5,"-5,19"
3452,720575940617194379,right,L2,361,0,-7,-4,-3,"0,-7"
3453,720575940612648817,right,L2,362,2,-20,-12,-8,"2,-20"
3454,720575940628402258,right,L2,363,7,-4,-9,5,"7,-4"
3455,720575940611414574,right,L2,364,4,4,-2,6,"4,4"
3456,720575940623312391,right,L2,365,4,7,-1,8,"4,7"
3457,720575940638263518,right,L2,366,-5,-20,-5,-15,"-5,-20"
3458,720575940626886544,right,L2,367,-6,-15,-2,-13,"-6,-15"
3459,720575940644212640,right,L2,368,-4,-20,-6,-14,"-4,-20"
3460,720575940629023740,right,L2,369,5,-5,-8,3,"5,-5"
3461,720575940613980712,right,L2,370,-3,21,13,8,"-3,21"
3462,720575940633139503,right,L2,371,6,-5,-9,4,"6,-5"
3463,720575940618477753,right,L2,372,1,-2,-2,0,"1,-2"
3464,720575940623220957,right,L2,373,1,-21,-12,-9,"1,-21"
3465,720575940630545274,right,L2,374,2,13,4,9,"2,13"
3466,720575940632766372,right,L2,375,-6,7,9,-2,"-6,7"
3467,720575940606063537,right,L2,376,-7,-10,2,-12,"-7,-10"
3468,720575940606778123,right,L2,377,0,7,3,4,"0,7"
3469,720575940617822438,right,L2,378,-3,18,12,6,"-3,18"
3470,720575940630323834,right,L2,379,3,-17,-12,-5,"3,-17"
3471,720575940634796954,right,L2,380,-1,29,15,14,"-1,29"
3472,720575940641524443,right,L2,381,-8,-9,3,-12,"-8,-9"
3473,720575940613209002,right,L2,382,3,-6,-6,0,"3,-6"
3474,720575940606543490,right,L2,383,-6,11,11,0,"-6,11"
3475,720575940622006881,right,L2,384,-6,-2,5,-7,"-6,-2"
3476,720575940620707916,right,L2,385,-3,-18,-6,-12,"-3,-18"
3477,720575940617281141,right,L2,386,-6,19,15,4,"-6,19"
3478,720575940641618896,right,L2,387,-1,-15,-7,-8,"-1,-15"
3479,720575940623275278,right,L2,388,3,19,6,13,"3,19"
3480,720575940636690094,right,L2,389,-6,-16,-2,-14,"-6,-16"
3481,720575940625060327,right,L2,390,-6,-9,1,-10,"-6,-9"
3482,720575940611708565,right,L2,391,4,-3,-6,3,"4,-3"
3483,720575940613866098,right,L2,392,-4,7,7,0,"-4,7"
3484,720575940621243007,right,L2,393,-1,22,12,10,"-1,22"
3485,720575940621900141,right,L2,394,-7,-8,3,-11,"-7,-8"
3486,720575940623911448,right,L2,395,0,-22,-11,-11,"0,-22"
3487,720575940614755295,right,L2,396,-1,10,6,4,"-1,10"
3488,720575940629023228,right,L2,397,-3,-19,-7,-12,"-3,-19"
3489,720575940640301440,right,L2,398,-3,22,14,8,"-3,22"
3490,720575940612822421,right,L2,399,-4,-24,-8,-16,"-4,-24"
3491,720575940606058924,right,L2,400,1,-29,-16,-13,"1,-29"
3492,720575940630228327,right,L2,401,-2,-19,-8,-11,"-2,-19"
3493,720575940621656158,right,L2,402,3,26,10,16,"3,26"
3494,720575940630805778,right,L2,403,-2,-12,-4,-8,"-2,-12"
3495,720575940633829933,right,L2,404,-1,20,11,9,"-1,20"
3496,720575940618188893,right,L2,405,3,10,2,8,"3,10"
3497,720575940634433180,right,L2,406,1,-25,-14,-11,"1,-25"
3498,720575940645172247,right,L2,407,-5,-10,0,-10,"-5,-10"
3499,720575940617863517,right,L2,408,-6,-4,4,-8,"-6,-4"
3500,720575940632956371,right,L2,409,0,-3,-2,-1,"0,-3"
3501,720575940629125084,right,L2,410,-2,-2,1,-3,"-2,-2"
3502,720575940617543892,right,L2,411,-5,-19,-5,-14,"-5,-19"
3503,720575940624835476,right,L2,412,-6,21,16,5,"-6,21"
3504,720575940625822820,right,L2,413,-2,-7,-2,-5,"-2,-7"
3505,720575940623990152,right,L2,414,4,21,6,15,"4,21"
3506,720575940625769037,right,L2,415,6,12,0,12,"6,12"
3507,720575940615790197,right,L2,416,3,-8,-7,-1,"3,-8"
3508,720575940616039647,right,L2,417,-6,-10,1,-11,"-6,-10"
3509,720575940632505898,right,L2,418,-2,15,9,6,"-2,15"
3510,720575940635565920,right,L2,419,-3,-11,-3,-8,"-3,-11"
3511,720575940625609196,right,L2,420,6,-3,-8,5,"6,-3"
3512,720575940640507533,right,L2,421,-1,12,7,5,"-1,12"
3513,720575940635002137,right,L2,422,-7,-4,5,-9,"-7,-4"
3514,720575940642756493,right,L2,423,3,-18,-12,-6,"3,-18"
3515,720575940627303524,right,L2,424,-3,-2,2,-4,"-3,-2"
3516,720575940620118864,right,L2,425,3,20,7,13,"3,20"
3517,720575940629022972,right,L2,426,-3,0,3,-3,"-3,0"
3518,720575940634900631,right,L2,427,5,-18,-14,-4,"5,-18"
3519,720575940631969099,right,L2,428,-2,23,13,10,"-2,23"
3520,720575940617293398,right,L2,429,-2,14,9,5,"-2,14"
3521,720575940632949218,right,L2,430,-3,-7,-1,-6,"-3,-7"
3522,720575940624080787,right,L2,431,-2,-10,-3,-7,"-2,-10"
3523,720575940625549292,right,L2,432,-5,7,8,-1,"-5,7"
3524,720575940614108566,right,L2,433,0,-8,-4,-4,"0,-8"
3525,720575940606640928,right,L2,434,-3,7,6,1,"-3,7"
3526,720575940614526673,right,L2,435,5,-17,-14,-3,"5,-17"
3527,720575940633440813,right,L2,436,0,-15,-8,-7,"0,-15"
3528,720575940625590460,right,L2,437,-3,12,9,3,"-3,12"
3529,720575940623159209,right,L2,438,2,27,11,16,"2,27"
3530,720575940640134077,right,L2,439,-3,-9,-2,-7,"-3,-9"
3531,720575940642090459,right,L2,440,1,23,10,13,"1,23"
3532,720575940624889870,right,L2,441,3,-16,-11,-5,"3,-16"
3533,720575940638348095,right,L2,442,-5,25,17,8,"-5,25"
3534,720575940621716207,right,L2,443,-6,4,8,-4,"-6,4"
3535,720575940621908720,right,L2,444,4,-10,-9,-1,"4,-10"
3536,720575940622715653,right,L2,445,-2,8,6,2,"-2,8"
3537,720575940638707940,right,L2,446,2,-14,-9,-5,"2,-14"
3538,720575940618933451,right,L2,447,-1,2,2,0,"-1,2"
3539,720575940620521777,right,L2,448,0,30,15,15,"0,30"
3540,720575940638817087,right,L2,449,6,-16,-14,-2,"6,-16"
3541,720575940626417485,right,L2,450,2,-9,-7,-2,"2,-9"
3542,720575940623282893,right,L2,451,4,20,6,14,"4,20"
3543,720575940630637050,right,L2,452,1,-9,-6,-3,"1,-9"
3544,720575940606782300,right,L2,453,3,25,9,16,"3,25"
3545,720575940628661647,right,L2,454,5,-12,-11,-1,"5,-12"
3546,720575940637293943,right,L2,455,7,-7,-11,4,"7,-7"
3547,720575940638139738,right,L2,456,0,21,10,11,"0,21"
3548,720575940613865586,right,L2,457,-2,17,10,7,"-2,17"
3549,720575940609412617,right,L2,458,5,0,-5,5,"5,0"
3550,720575940623968400,right,L2,459,5,-3,-7,4,"5,-3"
3551,720575940614760367,right,L2,460,-3,-20,-7,-13,"-3,-20"
3552,720575940626595530,right,L2,461,7,-5,-10,5,"7,-5"
3553,720575940645667438,right,L2,462,-1,18,10,8,"-1,18"
3554,720575940623145959,right,L2,463,5,17,3,14,"5,17"
3555,720575940640073806,right,L2,464,4,0,-4,4,"4,0"
3556,720575940622353023,right,L2,465,3,0,-3,3,"3,0"
3557,720575940612977834,right,L2,466,1,14,6,8,"1,14"
3558,720575940609061641,right,L2,467,-2,-20,-8,-12,"-2,-20"
3559,720575940616593221,right,L2,468,-3,11,8,3,"-3,11"
3560,720575940607810505,right,L2,469,-7,13,13,0,"-7,13"
3561,720575940624303300,right,L2,470,4,-9,-9,0,"4,-9"
3562,720575940628001149,right,L2,471,3,-26,-16,-10,"3,-26"
3563,720575940627572099,right,L2,472,1,25,11,14,"1,25"
3564,720575940636357231,right,L2,473,-4,23,15,8,"-4,23"
3565,720575940631124729,right,L2,474,-3,-17,-6,-11,"-3,-17"
3566,720575940621643457,right,L2,475,-4,-1,3,-4,"-4,-1"
3567,720575940629149015,right,L2,476,-1,15,8,7,"-1,15"
3568,720575940621292992,right,L2,477,-3,2,4,-2,"-3,2"
3569,720575940631463528,right,L2,478,-7,16,15,1,"-7,16"
3570,720575940628262738,right,L2,479,-2,10,7,3,"-2,10"
3571,720575940632087367,right,L2,480,3,-19,-13,-6,"3,-19"
3572,720575940631235692,right,L2,481,4,-8,-8,0,"4,-8"
3573,720575940638529087,right,L2,482,1,17,7,10,"1,17"
3574,720575940639720637,right,L2,483,2,-7,-6,-1,"2,-7"
3575,720575940620767937,right,L2,484,3,-9,-8,-1,"3,-9"
3576,720575940660952449,right,L2,485,-3,-3,1,-4,"-3,-3"
3577,720575940623537373,right,L2,486,0,1,0,1,"0,1"
3578,720575940618067161,right,L2,487,1,-1,-2,1,"1,-1"
3579,720575940645060296,right,L2,488,7,5,-5,10,"7,5"
3580,720575940624468809,right,L2,489,-3,10,8,2,"-3,10"
3581,720575940617044018,right,L2,490,-5,6,8,-2,"-5,6"
3582,720575940605822654,right,L2,491,7,-1,-8,7,"7,-1"
3583,720575940625066935,right,L2,492,-7,-2,6,-8,"-7,-2"
3584,720575940644552096,right,L2,493,-3,23,14,9,"-3,23"
3585,720575940611201486,right,L2,494,0,29,14,15,"0,29"
3586,720575940621944496,right,L2,495,4,5,-2,7,"4,5"
3587,720575940617947675,right,L2,496,7,8,-3,11,"7,8"
3588,720575940632871737,right,L2,497,6,1,-6,7,"6,1"
3589,720575940621711041,right,L2,498,6,10,-1,11,"6,10"
3590,720575940616865083,right,L2,499,5,10,0,10,"5,10"
3591,720575940623130025,right,L2,500,7,-8,-11,3,"7,-8"
3592,720575940631647063,right,L2,501,1,2,0,2,"1,2"
3593,720575940628134021,right,L2,502,5,8,-1,9,"5,8"
3594,720575940640266584,right,L2,503,3,17,5,12,"3,17"
3595,720575940617655626,right,L2,504,-2,9,6,3,"-2,9"
3596,720575940643830984,right,L2,505,6,-22,-17,-5,"6,-22"
3597,720575940620466768,right,L2,506,1,-12,-7,-5,"1,-12"
3598,720575940655214241,right,L2,507,-5,-12,-1,-11,"-5,-12"
3599,720575940620672704,right,L2,508,-5,11,10,1,"-5,11"
3600,720575940623441151,right,L2,509,-4,10,9,1,"-4,10"
3601,720575940614959628,right,L2,510,-2,11,7,4,"-2,11"
3602,720575940624798717,right,L2,511,5,-11,-11,0,"5,-11"
3603,720575940644892360,right,L2,512,6,0,-6,6,"6,0"
3604,720575940628363602,right,L2,513,-4,-13,-3,-10,"-4,-13"
3605,720575940631564306,right,L2,514,-4,-10,-1,-9,"-4,-10"
3606,720575940614698034,right,L2,515,-8,-7,4,-11,"-8,-7"
3607,720575940615918146,right,L2,516,7,-18,-16,-2,"7,-18"
3608,720575940621479918,right,L2,517,6,3,-5,8,"6,3"
3609,720575940620490661,right,L2,518,-4,22,15,7,"-4,22"
3610,720575940626812560,right,L2,519,-5,-5,2,-7,"-5,-5"
3611,720575940626813072,right,L2,520,-2,-22,-9,-13,"-2,-22"
3612,720575940627511177,right,L2,521,6,-9,-11,2,"6,-9"
3613,720575940616222879,right,L2,522,-4,0,4,-4,"-4,0"
3614,720575940633448147,right,L2,523,2,14,5,9,"2,14"
3615,720575940618231124,right,L2,524,4,-20,-14,-6,"4,-20"
3616,720575940608093106,right,L2,525,-1,-20,-9,-11,"-1,-20"
3617,720575940645337454,right,L2,526,0,-10,-5,-5,"0,-10"
3618,720575940625101240,right,L2,527,-4,-8,0,-8,"-4,-8"
3619,720575940620903662,right,L2,528,2,7,1,6,"2,7"
3620,720575940620324774,right,L2,529,2,-2,-3,1,"2,-2"
3621,720575940621309349,right,L2,530,-3,-13,-4,-9,"-3,-13"
3622,720575940624538662,right,L2,531,1,0,-1,1,"1,0"
3623,720575940626097296,right,L2,532,-8,7,11,-4,"-8,7"
3624,720575940635833791,right,L2,533,0,-16,-8,-8,"0,-16"
3625,720575940609328853,right,L2,534,3,2,-2,4,"3,2"
3626,720575940622728157,right,L2,535,8,-4,-10,6,"8,-4"
3627,720575940621089115,right,L2,536,3,4,-1,5,"3,4"
3628,720575940618171878,right,L2,537,0,-23,-12,-11,"0,-23"
3629,720575940620223326,right,L2,538,-4,1,4,-3,"-4,1"
3630,720575940621391715,right,L2,539,-6,15,13,2,"-6,15"
3631,720575940624143821,right,L2,540,-2,-9,-3,-6,"-2,-9"
3632,720575940639236836,right,L2,541,-4,14,11,3,"-4,14"
3633,720575940613354098,right,L2,542,6,-13,-13,0,"6,-13"
3634,720575940628644507,right,L2,543,-1,-4,-1,-3,"-1,-4"
3635,720575940630159611,right,L2,544,3,-13,-10,-3,"3,-13"
3636,720575940607521458,right,L2,545,5,11,0,11,"5,11"
3637,720575940621830220,right,L2,546,3,6,0,6,"3,6"
3638,720575940621013185,right,L2,547,-1,21,11,10,"-1,21"
3639,720575940628032082,right,L2,548,1,-16,-9,-7,"1,-16"
3640,720575940626024496,right,L2,549,0,-9,-5,-4,"0,-9"
3641,720575940622005601,right,L2,550,-2,3,3,0,"-2,3"
3642,720575940647894068,right,L2,551,-4,-9,-1,-8,"-4,-9"
3643,720575940613039530,right,L2,552,4,-1,-5,4,"4,-1"
3644,720575940629706343,right,L2,553,-3,16,11,5,"-3,16"
3645,720575940624459559,right,L2,554,-9,-3,7,-10,"-9,-3"
3646,720575940605546208,right,L2,555,-4,9,8,1,"-4,9"
3647,720575940620740822,right,L2,556,0,10,5,5,"0,10"
3648,720575940619330496,right,L2,557,6,-10,-11,1,"6,-10"
3649,720575940620907600,right,L2,558,-4,-21,-7,-14,"-4,-21"
3650,720575940621907700,right,L2,559,-6,22,17,5,"-6,22"
3651,720575940608559964,right,L2,560,-7,14,14,0,"-7,14"
3652,720575940609131868,right,L2,561,5,7,-2,9,"5,7"
3653,720575940620939979,right,L2,562,-5,-2,4,-6,"-5,-2"
3654,720575940640108120,right,L2,563,5,-13,-12,-1,"5,-13"
3655,720575940620778587,right,L2,564,3,-23,-15,-8,"3,-23"
3656,720575940622963461,right,L2,565,0,-26,-13,-13,"0,-26"
3657,720575940614578538,right,L2,566,5,-8,-9,1,"5,-8"
3658,720575940620691538,right,L2,567,-2,22,13,9,"-2,22"
3659,720575940613558501,right,L2,568,-6,-8,2,-10,"-6,-8"
3660,720575940625150285,right,L2,569,6,6,-3,9,"6,6"
3661,720575940633170515,right,L2,570,2,25,10,15,"2,25"
3662,720575940641169536,right,L2,571,0,-14,-7,-7,"0,-14"
3663,720575940653734049,right,L2,572,-8,3,9,-6,"-8,3"
3664,720575940612012714,right,L2,573,4,14,3,11,"4,14"
3665,720575940624155829,right,L2,574,-6,5,8,-3,"-6,5"
3666,720575940653342966,right,L2,575,6,9,-2,11,"6,9"
3667,720575940624052715,right,L2,576,0,28,14,14,"0,28"
3668,720575940646592035,right,L2,577,5,-14,-12,-2,"5,-14"
3669,720575940652739062,right,L2,578,4,-11,-10,-1,"4,-11"
3670,720575940608822539,right,L2,579,-3,-10,-2,-8,"-3,-10"
3671,720575940627131710,right,L2,580,-2,-23,-10,-13,"-2,-23"
3672,720575940605871974,right,L2,581,3,9,1,8,"3,9"
3673,720575940626997604,right,L2,582,-1,23,12,11,"-1,23"
3674,720575940645491748,right,L2,583,3,-25,-16,-9,"3,-25"
3675,720575940621601389,right,L2,584,4,23,7,16,"4,23"
3676,720575940628770472,right,L2,585,-1,-23,-11,-12,"-1,-23"
3677,720575940613623449,right,L2,586,2,18,7,11,"2,18"
3678,720575940627335549,right,L2,587,4,22,7,15,"4,22"
3679,720575940630863104,right,L2,588,1,4,1,3,"1,4"
3680,720575940615679906,right,L2,589,-1,-5,-2,-3,"-1,-5"
3681,720575940636562031,right,L2,590,1,9,3,6,"1,9"
3682,720575940604910508,right,L2,591,3,-3,-5,2,"3,-3"
3683,720575940613232370,right,L2,592,3,-28,-17,-11,"3,-28"
3684,720575940630866681,right,L2,593,3,-14,-10,-4,"3,-14"
3685,720575940635565152,right,L2,594,7,-16,-15,-1,"7,-16"
3686,720575940623347336,right,L2,595,7,-12,-13,1,"7,-12"
3687,720575940632456463,right,L2,596,-4,-16,-4,-12,"-4,-16"
3688,720575940617462233,right,L2,597,4,1,-4,5,"4,1"
3689,720575940624314406,right,L2,598,2,-18,-11,-7,"2,-18"
3690,720575940637314405,right,L2,599,-1,9,5,4,"-1,9"
3691,720575940619065373,right,L2,600,3,-10,-8,-2,"3,-10"
3692,720575940622000054,right,L2,601,1,16,7,9,"1,16"
3693,720575940644714275,right,L2,602,4,-2,-5,3,"4,-2"
3694,720575940637220494,right,L2,603,-3,-23,-9,-14,"-3,-23"
3695,720575940634949567,right,L2,604,-6,-17,-3,-14,"-6,-17"
3696,720575940612909226,right,L2,605,3,15,4,11,"3,15"
3697,720575940628343685,right,L2,606,-1,-19,-9,-10,"-1,-19"
3698,720575940628880646,right,L2,607,1,18,8,10,"1,18"
3699,720575940620474673,right,L2,608,1,10,4,6,"1,10"
3700,720575940655593889,right,L2,609,-2,0,2,-2,"-2,0"
3701,720575940618046465,right,L2,610,2,-23,-14,-9,"2,-23"
3702,720575940639824499,right,L2,611,-1,-18,-8,-10,"-1,-18"
3703,720575940617199547,right,L2,612,-3,-26,-10,-16,"-3,-26"
3704,720575940613511141,right,L2,613,-8,-4,6,-10,"-8,-4"
3705,720575940614855464,right,L2,614,-2,-8,-2,-6,"-2,-8"
3706,720575940622599685,right,L2,615,-7,-7,3,-10,"-7,-7"
3707,720575940625514023,right,L2,616,-3,15,10,5,"-3,15"
3708,720575940620889803,right,L2,617,-2,-17,-7,-10,"-2,-17"
3709,720575940629222087,right,L2,618,-1,24,13,11,"-1,24"
3710,720575940630195559,right,L2,619,-4,-19,-6,-13,"-4,-19"
3711,720575940634435775,right,L2,620,7,1,-7,8,"7,1"
3712,720575940620203870,right,L2,621,1,24,11,13,"1,24"
3713,720575940620086277,right,L2,622,-5,20,15,5,"-5,20"
3714,720575940612708010,right,L2,623,1,13,5,8,"1,13"
3715,720575940621409371,right,L2,624,1,-17,-10,-7,"1,-17"
3716,720575940621096813,right,L2,625,-2,24,14,10,"-2,24"
3717,720575940629466983,right,L2,626,-5,-8,1,-9,"-5,-8"
3718,720575940610325038,right,L2,627,0,-1,-1,0,"0,-1"
3719,720575940640202557,right,L2,628,0,0,0,0,"0,0"
3720,720575940623924429,right,L2,629,4,24,8,16,"4,24"
3721,720575940626763210,right,L2,630,4,8,0,8,"4,8"
3722,720575940620724306,right,L2,631,1,26,12,14,"1,26"
3723,720575940632448616,right,L2,632,3,-20,-13,-7,"3,-20"
3724,720575940627830801,right,L2,633,-1,-24,-11,-13,"-1,-24"
3725,720575940626003600,right,L2,634,-3,-15,-5,-10,"-3,-15"
3726,720575940616589766,right,L2,635,6,-6,-9,3,"6,-6"
3727,720575940623073427,right,L2,636,0,6,3,3,"0,6"
3728,720575940627416339,right,L2,637,3,-21,-14,-7,"3,-21"
3729,720575940647428643,right,L2,638,-1,7,4,3,"-1,7"
3730,720575940611206008,right,L2,639,-4,19,13,6,"-4,19"
3731,720575940635265699,right,L2,640,-1,-16,-7,-9,"-1,-16"
3732,720575940613323762,right,L2,641,-8,-5,5,-10,"-8,-5"
3733,720575940624991496,right,L2,642,-5,-11,-1,-10,"-5,-11"
3734,720575940612959146,right,L2,643,6,14,1,13,"6,14"
3735,720575940612198513,right,L2,644,-6,18,15,3,"-6,18"
3736,720575940624288136,right,L2,645,-4,27,17,10,"-4,27"
3737,720575940630281078,right,L2,646,6,17,2,15,"6,17"
3738,720575940618449031,right,L2,647,-4,-7,0,-7,"-4,-7"
3739,720575940633162567,right,L2,648,1,7,2,5,"1,7"
3740,720575940621102677,right,L2,649,-1,5,3,2,"-1,5"
3741,720575940619786955,right,L2,650,-3,-25,-10,-15,"-3,-25"
3742,720575940627828746,right,L2,651,-4,-5,1,-6,"-4,-5"
3743,720575940628116392,right,L2,652,-6,-11,0,-11,"-6,-11"
3744,720575940613372402,right,L2,653,-6,-12,0,-12,"-6,-12"
3745,720575940622074790,right,L2,654,-3,8,7,1,"-3,8"
3746,720575940615446270,right,L2,655,6,-1,-7,6,"6,-1"
3747,720575940645401124,right,L2,656,0,-11,-6,-5,"0,-11"
3748,720575940635037358,right,L2,657,-2,-25,-11,-14,"-2,-25"
3749,720575940624364952,right,L2,658,1,20,9,11,"1,20"
3750,720575940627686226,right,L2,659,-4,-6,1,-7,"-4,-6"
3751,720575940631085783,right,L2,660,2,28,12,16,"2,28"
3752,720575940629396841,right,L2,661,-3,14,10,4,"-3,14"
3753,720575940611913170,right,L2,662,2,-1,-3,2,"2,-1"
3754,720575940606811657,right,L2,663,0,8,4,4,"0,8"
3755,720575940621702497,right,L2,664,1,-27,-15,-12,"1,-27"
3756,720575940632988755,right,L2,665,7,-2,-8,6,"7,-2"
3757,720575940607227010,right,L2,666,7,-13,-14,1,"7,-13"
3758,720575940621195941,right,L2,667,1,-28,-15,-13,"1,-28"
3759,720575940615018402,right,L2,668,1,19,8,11,"1,19"
3760,720575940625061117,right,L2,669,4,-16,-12,-4,"4,-16"
3761,720575940613070771,right,L2,670,5,5,-3,8,"5,5"
3762,720575940622659798,right,L2,671,-4,-23,-8,-15,"-4,-23"
3763,720575940624882108,right,L2,672,-8,11,13,-2,"-8,11"
3764,720575940605402284,right,L2,673,2,5,0,5,"2,5"
3765,720575940637545038,right,L2,674,-4,-14,-3,-11,"-4,-14"
3766,720575940625141029,right,L2,675,-7,19,16,3,"-7,19"
3767,720575940622329626,right,L2,676,-3,-21,-8,-13,"-3,-21"
3768,720575940620734544,right,L2,677,0,11,5,6,"0,11"
3769,720575940605091104,right,L2,678,3,-7,-7,0,"3,-7"
3770,720575940607219669,right,L2,679,4,18,5,13,"4,18"
3771,720575940630516983,right,L2,680,-1,25,13,12,"-1,25"
3772,720575940635576160,right,L2,681,-2,-21,-9,-12,"-2,-21"
3773,720575940624115859,right,L2,682,6,-8,-10,2,"6,-8"
3774,720575940622126945,right,L2,683,2,6,1,5,"2,6"
3775,720575940618876317,right,L2,684,-6,17,14,3,"-6,17"
3776,720575940621250113,right,L2,685,-5,-9,0,-9,"-5,-9"
3777,720575940622571269,right,L2,686,5,-22,-16,-6,"5,-22"
3778,720575940618068198,right,L2,687,-6,-3,4,-7,"-6,-3"
3779,720575940624793673,right,L2,688,-7,10,12,-2,"-7,10"
3780,720575940623173921,right,L2,689,-2,18,11,7,"-2,18"
3781,720575940625274772,right,L2,690,-7,-3,5,-8,"-7,-3"
3782,720575940638788585,right,L2,691,-9,4,11,-7,"-9,4"
3783,720575940621546066,right,L2,692,-4,24,16,8,"-4,24"
3784,720575940639429190,right,L2,693,-3,25,15,10,"-3,25"
3785,720575940635303319,right,L2,694,4,3,-3,6,"4,3"
3786,720575940621645238,right,L2,695,-6,10,11,-1,"-6,10"
3787,720575940620491712,right,L2,696,-2,16,10,6,"-2,16"
3788,720575940615549250,right,L2,697,1,-22,-12,-10,"1,-22"
3789,720575940633611980,right,L2,698,6,-7,-10,3,"6,-7"
3790,720575940615805855,right,L2,699,-5,0,5,-5,"-5,0"
3791,720575940622787805,right,L2,700,5,15,2,13,"5,15"
3792,720575940625120585,right,L2,701,0,-4,-2,-2,"0,-4"
3793,720575940607856818,right,L2,702,-5,23,16,7,"-5,23"
3794,720575940636065588,right,L2,703,-3,1,3,-2,"-3,1"
3795,720575940627265176,right,L2,704,-7,8,11,-3,"-7,8"
3796,720575940655871393,right,L2,705,1,1,-1,2,"1,1"
3797,720575940620920429,right,L2,706,-7,-12,1,-13,"-7,-12"
3798,720575940615444222,right,L2,707,-2,25,14,11,"-2,25"
3799,720575940640249934,right,L2,708,-4,-25,-9,-16,"-4,-25"
3800,720575940634167833,right,L2,709,-2,-24,-10,-14,"-2,-24"
3801,720575940630700281,right,L2,710,4,-25,-17,-8,"4,-25"
3802,720575940620941038,right,L2,711,-1,19,10,9,"-1,19"
3803,720575940626299710,right,L2,712,-7,12,13,-1,"-7,12"
3804,720575940613711894,right,L2,713,-6,16,14,2,"-6,16"
3805,720575940634024403,right,L2,714,5,12,1,11,"5,12"
3806,720575940616865339,right,L2,715,4,10,1,9,"4,10"
3807,720575940627304841,right,L2,716,4,-6,-7,1,"4,-6"
3808,720575940624868024,right,L2,717,2,-22,-13,-9,"2,-22"
3809,720575940624957529,right,L2,718,-5,24,17,7,"-5,24"
3810,720575940618654528,right,L2,719,1,27,12,15,"1,27"
3811,720575940625864530,right,L2,720,-5,21,15,6,"-5,21"
3812,720575940638842345,right,L2,721,5,13,1,12,"5,13"
3813,720575940612437454,right,L2,722,6,-15,-14,-1,"6,-15"
3814,720575940626950181,right,L2,723,-2,-11,-4,-7,"-2,-11"
3815,720575940621705897,right,L2,724,4,2,-3,5,"4,2"
3816,720575940637296013,right,L2,725,-3,-24,-9,-15,"-3,-24"
3817,720575940608087474,right,L2,726,2,-28,-16,-12,"2,-28"
3818,720575940627383044,right,L2,727,7,6,-4,10,"7,6"
3819,720575940606574210,right,L2,728,7,12,-1,13,"7,12"
3820,720575940619948854,right,L2,729,-3,29,17,12,"-3,29"
3821,720575940623549661,right,L2,730,7,0,-7,7,"7,0"
3822,720575940613935400,right,L2,731,-6,9,10,-1,"-6,9"
3823,720575940611568248,right,L2,732,-3,6,6,0,"-3,6"
3824,720575940628284426,right,L2,733,-5,-17,-4,-13,"-5,-17"
3825,720575940628782185,right,L2,734,2,0,-2,2,"2,0"
3826,720575940614807954,right,L2,735,1,-23,-13,-10,"1,-23"
3827,720575940625897404,right,L2,736,-8,1,8,-7,"-8,1"
3828,720575940633290321,right,L2,737,0,19,9,10,"0,19"
3829,720575940627326978,right,L2,738,-3,13,9,4,"-3,13"
3830,720575940628915688,right,L2,739,-7,2,8,-6,"-7,2"
3831,720575940620264289,right,L2,740,2,-8,-6,-2,"2,-8"
3832,720575940628635409,right,L2,741,-2,-14,-5,-9,"-2,-14"
3833,720575940645102372,right,L2,742,-4,11,9,2,"-4,11"
3834,720575940636123755,right,L2,743,6,-19,-16,-3,"6,-19"
3835,720575940629588752,right,L2,744,-4,25,16,9,"-4,25"
3836,720575940621093547,right,L2,745,0,13,6,7,"0,13"
3837,720575940627715764,right,L2,746,-3,3,4,-1,"-3,3"
3838,720575940624135704,right,L2,747,0,2,1,1,"0,2"
3839,720575940618274489,right,L2,748,-4,20,14,6,"-4,20"
3840,720575940630123351,right,L2,749,-2,1,2,-1,"-2,1"
3841,720575940623241727,right,L2,750,4,-24,-16,-8,"4,-24"
3842,720575940614200722,right,L2,751,1,6,2,4,"1,6"
3843,720575940622173790,right,L2,752,-2,7,5,2,"-2,7"
3844,720575940611833208,right,L2,753,-3,24,15,9,"-3,24"
3845,720575940626091597,right,L2,754,-1,-13,-6,-7,"-1,-13"
3846,720575940618313762,right,L2,755,4,19,5,14,"4,19"
3847,720575940632454969,right,L2,756,5,20,5,15,"5,20"
3848,720575940635091993,right,L2,757,0,-6,-3,-3,"0,-6"
3849,720575940630964540,right,L2,758,5,-1,-6,5,"5,-1"
3850,720575940628885251,right,L2,759,7,14,0,14,"7,14"
3851,720575940615804817,right,L2,760,0,17,8,9,"0,17"
3852,720575940623496486,right,L2,761,-4,-18,-5,-13,"-4,-18"
3853,720575940625075453,right,L2,762,0,14,7,7,"0,14"
3854,720575940613253874,right,L2,763,-5,14,12,2,"-5,14"
3855,720575940612998258,right,L2,764,-8,-6,5,-11,"-8,-6"
3856,720575940633606052,right,L2,765,-3,9,7,2,"-3,9"
3857,720575940639648334,right,L2,766,2,-4,-4,0,"2,-4"
3858,720575940616827222,right,L2,767,1,28,13,15,"1,28"
3859,720575940624227366,right,L2,768,3,5,-1,6,"3,5"
3860,720575940648480388,right,L2,769,4,-27,-18,-9,"4,-27"
3861,720575940628223802,right,L2,770,5,4,-3,7,"5,4"
3862,720575940609805269,right,L2,771,3,-27,-17,-10,"3,-27"
3863,720575940627747082,right,L2,772,1,12,5,7,"1,12"
3864,720575940636098923,right,L2,773,5,-19,-15,-4,"5,-19"
3865,720575940637327686,right,L2,774,-8,6,11,-5,"-8,6"
3866,720575940628606026,right,L2,775,5,22,6,16,"5,22"
3867,720575940618782021,right,L2,776,5,21,5,16,"5,21"
3868,720575940617261910,right,L2,777,6,20,4,16,"6,20"
3869,720575940618041830,right,L2,778,4,25,8,17,"4,25"
3870,720575940630115454,right,L2,779,5,24,7,17,"5,24"
3871,720575940629902608,right,L2,780,-6,25,18,7,"-6,25"
3872,720575940629916176,right,L2,781,-5,26,18,8,"-5,26"
3873,720575940625625236,right,L2,782,-5,27,18,9,"-5,27"
3874,720575940624382442,right,L2,783,-4,28,18,10,"-4,28"
3875,720575940659743105,right,L2,784,-4,29,18,11,"-4,29"
3876,720575940620857680,right,L2,787,3,28,11,17,"3,28"
3877,720575940641317328,right,L2,788,3,27,10,17,"3,27"
3878,720575940622016282,right,L2,789,-3,-27,-11,-16,"-3,-27"
3879,720575940630229095,right,L2,790,-2,-27,-12,-15,"-2,-27"
3880,720575940622390132,right,L2,791,-1,-28,-13,-15,"-1,-28"
3881,720575940642058971,right,L2,792,8,2,-7,9,"8,2"
3882,720575940621218881,right,L2,793,8,-6,-11,5,"8,-6"
3883,720575940622152948,right,L2,794,5,-26,-18,-8,"5,-26"
3884,720575940612105329,right,L2,795,6,-21,-17,-4,"6,-21"
3885,720575940631836503,right,L2,796,4,26,9,17,"4,26"
3886,720575940628710933,right,L3,1,-6,13,12,1,"-6,13"
3887,720575940652492278,right,L3,2,-8,2,9,-7,"-8,2"
3888,720575940621560240,right,L3,3,6,-12,-12,0,"6,-12"
3889,720575940631599311,right,L3,4,-5,-21,-6,-15,"-5,-21"
3890,720575940645807726,right,L3,5,-1,16,9,7,"-1,16"
3891,720575940620458305,right,L3,6,-2,-4,0,-4,"-2,-4"
3892,720575940616280763,right,L3,7,-6,-6,3,-9,"-6,-6"
3893,720575940635789943,right,L3,9,4,9,0,9,"4,9"
3894,720575940621554864,right,L3,10,5,-15,-13,-2,"5,-15"
3895,720575940621648880,right,L3,11,7,-14,-14,0,"7,-14"
3896,720575940611279566,right,L3,12,-7,9,11,-2,"-7,9"
3897,720575940655977889,right,L3,14,0,-27,-14,-13,"0,-27"
3898,720575940617675961,right,L3,15,2,-3,-4,1,"2,-3"
3899,720575940626428615,right,L3,16,-2,-16,-6,-10,"-2,-16"
3900,720575940634695520,right,L3,17,1,-5,-4,-1,"1,-5"
3901,720575940618772416,right,L3,18,5,-16,-13,-3,"5,-16"
3902,720575940638099689,right,L3,19,-7,17,15,2,"-7,17"
3903,720575940623638666,right,L3,20,3,-11,-9,-2,"3,-11"
3904,720575940628260368,right,L3,21,-2,19,11,8,"-2,19"
3905,720575940624446652,right,L3,22,-1,3,2,1,"-1,3"
3906,720575940622493769,right,L3,23,-3,-16,-5,-11,"-3,-16"
3907,720575940617746105,right,L3,24,-1,-10,-4,-6,"-1,-10"
3908,720575940638672454,right,L3,25,-9,3,10,-7,"-9,3"
3909,720575940628226310,right,L3,26,1,-3,-3,0,"1,-3"
3910,720575940627384709,right,L3,27,0,-25,-13,-12,"0,-25"
3911,720575940624388331,right,L3,28,5,6,-2,8,"5,6"
3912,720575940618039197,right,L3,29,-1,-3,-1,-2,"-1,-3"
3913,720575940628460785,right,L3,30,6,16,2,14,"6,16"
3914,720575940611059012,right,L3,31,0,16,8,8,"0,16"
3915,720575940643777844,right,L3,32,0,12,6,6,"0,12"
3916,720575940640913571,right,L3,33,3,18,6,12,"3,18"
3917,720575940616155458,right,L3,34,6,18,3,15,"6,18"
3918,720575940617582941,right,L3,35,1,-24,-13,-11,"1,-24"
3919,720575940624256999,right,L3,36,6,8,-2,10,"6,8"
3920,720575940634176537,right,L3,37,1,5,1,4,"1,5"
3921,720575940626805604,right,L3,38,0,-2,-1,-1,"0,-2"
3922,720575940618871297,right,L3,39,0,20,10,10,"0,20"
3923,720575940630470348,right,L3,41,-3,28,17,11,"-3,28"
3924,720575940620744430,right,L3,42,-1,14,8,6,"-1,14"
3925,720575940648528772,right,L3,43,-5,18,14,4,"-5,18"
3926,720575940631550539,right,L3,44,5,-10,-10,0,"5,-10"
3927,720575940609494741,right,L3,45,-5,-1,4,-5,"-5,-1"
3928,720575940629899307,right,L3,47,-9,-1,8,-9,"-9,-1"
3929,720575940622267370,right,L3,48,-4,-22,-7,-15,"-4,-22"
3930,720575940622498889,right,L3,49,4,-4,-6,2,"4,-4"
3931,720575940623637981,right,L3,51,0,-19,-10,-9,"0,-19"
3932,720575940614643454,right,L3,52,-1,-22,-10,-12,"-1,-22"
3933,720575940621445808,right,L3,53,5,14,2,12,"5,14"
3934,720575940619679552,right,L3,54,-4,3,5,-2,"-4,3"
3935,720575940652603126,right,L3,55,-4,-11,-2,-9,"-4,-11"
3936,720575940624121269,right,L3,56,1,-13,-8,-5,"1,-13"
3937,720575940627401561,right,L3,57,6,-11,-12,1,"6,-11"
3938,720575940623214861,right,L3,58,3,12,3,9,"3,12"
3939,720575940632671336,right,L3,59,-2,2,3,-1,"-2,2"
3940,720575940618947230,right,L3,60,-8,8,12,-4,"-8,8"
3941,720575940615134870,right,L3,61,-4,-4,2,-6,"-4,-4"
3942,720575940622516556,right,L3,62,0,-29,-15,-14,"0,-29"
3943,720575940618721364,right,L3,63,4,12,2,10,"4,12"
3944,720575940617312729,right,L3,64,4,-23,-16,-7,"4,-23"
3945,720575940628661391,right,L3,66,2,15,5,10,"2,15"
3946,720575940612452978,right,L3,67,-2,-13,-5,-8,"-2,-13"
3947,720575940625337933,right,L3,68,3,16,5,11,"3,16"
3948,720575940646005539,right,L3,69,1,8,3,5,"1,8"
3949,720575940620608853,right,L3,70,-4,21,14,7,"-4,21"
3950,720575940625955646,right,L3,71,-2,-3,0,-3,"-2,-3"
3951,720575940623234729,right,L3,72,0,-28,-14,-14,"0,-28"
3952,720575940627464329,right,L3,73,2,2,-1,3,"2,2"
3953,720575940635247267,right,L3,74,-1,-9,-4,-5,"-1,-9"
3954,720575940614289361,right,L3,76,-3,-4,1,-5,"-3,-4"
3955,720575940620337799,right,L3,77,2,-5,-5,0,"2,-5"
3956,720575940624433300,right,L3,78,2,20,8,12,"2,20"
3957,720575940646547235,right,L3,79,2,1,-2,3,"2,1"
3958,720575940629535217,right,L3,80,4,13,2,11,"4,13"
3959,720575940628486761,right,L3,81,6,-2,-7,5,"6,-2"
3960,720575940654887329,right,L3,82,-7,7,10,-3,"-7,7"
3961,720575940622678742,right,L3,83,2,-21,-13,-8,"2,-21"
3962,720575940629929039,right,L3,84,-2,12,8,4,"-2,12"
3963,720575940624255671,right,L3,85,4,-22,-15,-7,"4,-22"
3964,720575940627477050,right,L3,86,-5,-7,1,-8,"-5,-7"
3965,720575940606158514,right,L3,87,1,11,4,7,"1,11"
3966,720575940624276405,right,L3,89,1,-19,-11,-8,"1,-19"
3967,720575940622108225,right,L3,90,-4,5,6,-1,"-4,5"
3968,720575940630243252,right,L3,91,-1,6,4,2,"-1,6"
3969,720575940621161933,right,L3,92,0,9,4,5,"0,9"
3970,720575940624298643,right,L3,94,5,18,4,14,"5,18"
3971,720575940637046903,right,L3,95,4,-21,-15,-6,"4,-21"
3972,720575940632640312,right,L3,96,1,-10,-6,-4,"1,-10"
3973,720575940635567979,right,L3,97,-5,2,6,-4,"-5,2"
3974,720575940627662138,right,L3,98,-1,-12,-5,-7,"-1,-12"
3975,720575940626024122,right,L3,99,4,15,3,12,"4,15"
3976,720575940634730521,right,L3,100,2,-10,-7,-3,"2,-10"
3977,720575940626672906,right,L3,101,-7,6,10,-4,"-7,6"
3978,720575940626376188,right,L3,102,3,13,3,10,"3,13"
3979,720575940628258833,right,L3,103,7,9,-3,12,"7,9"
3980,720575940632433100,right,L3,105,3,22,8,14,"3,22"
3981,720575940632700243,right,L3,106,-7,11,12,-1,"-7,11"
3982,720575940622189948,right,L3,107,8,-2,-9,7,"8,-2"
3983,720575940631206967,right,L3,108,-3,-12,-3,-9,"-3,-12"
3984,720575940620332167,right,L3,109,4,-5,-7,2,"4,-5"
3985,720575940628044154,right,L3,110,-7,0,7,-7,"-7,0"
3986,720575940622578526,right,L3,111,2,-24,-14,-10,"2,-24"
3987,720575940630218358,right,L3,114,2,-13,-9,-4,"2,-13"
3988,720575940614911394,right,L3,116,-1,-8,-3,-5,"-1,-8"
3989,720575940608163849,right,L3,118,3,1,-3,4,"3,1"
3990,720575940632452626,right,L3,119,-2,6,5,1,"-2,6"
3991,720575940646632324,right,L3,120,-1,-1,0,-1,"-1,-1"
3992,720575940623227016,right,L3,121,-8,4,10,-6,"-8,4"
3993,720575940615883067,right,L3,123,-8,10,13,-3,"-8,10"
3994,720575940632029241,right,L3,124,1,-7,-5,-2,"1,-7"
3995,720575940620059631,right,L3,125,5,9,-1,10,"5,9"
3996,720575940628460548,right,L3,126,3,11,2,9,"3,11"
3997,720575940610708600,right,L3,127,0,15,7,8,"0,15"
3998,720575940624561589,right,L3,128,3,-22,-14,-8,"3,-22"
3999,720575940645127447,right,L3,129,0,-13,-7,-6,"0,-13"
4000,720575940626863229,right,L3,130,2,12,4,8,"2,12"
4001,720575940630434048,right,L3,131,-6,20,16,4,"-6,20"
4002,720575940623140755,right,L3,132,2,4,0,4,"2,4"
4003,720575940627179786,right,L3,133,-3,20,13,7,"-3,20"
4004,720575940621267316,right,L3,134,-5,-18,-4,-14,"-5,-18"
4005,720575940638136154,right,L3,135,-3,-22,-8,-14,"-3,-22"
4006,720575940620629697,right,L3,136,0,3,1,2,"0,3"
4007,720575940611493347,right,L3,137,5,-7,-9,2,"5,-7"
4008,720575940624229629,right,L3,138,0,27,13,14,"0,27"
4009,720575940630131706,right,L3,139,1,-14,-8,-6,"1,-14"
4010,720575940609896405,right,L3,140,3,8,1,7,"3,8"
4011,720575940618170949,right,L3,141,5,-23,-17,-6,"5,-23"
4012,720575940612374737,right,L3,142,-2,-18,-7,-11,"-2,-18"
4013,720575940622203312,right,L3,143,-4,16,12,4,"-4,16"
4014,720575940614567917,right,L3,144,7,-11,-13,2,"7,-11"
4015,720575940622614277,right,L3,145,0,4,2,2,"0,4"
4016,720575940647662388,right,L3,146,1,-6,-4,-2,"1,-6"
4017,720575940655612833,right,L3,147,1,21,9,12,"1,21"
4018,720575940620364965,right,L3,149,6,-14,-13,-1,"6,-14"
4019,720575940612010865,right,L3,150,-8,5,10,-5,"-8,5"
4020,720575940642421493,right,L3,151,-3,-14,-4,-10,"-3,-14"
4021,720575940627997592,right,L3,152,3,-15,-11,-4,"3,-15"
4022,720575940616070250,right,L3,153,8,0,-8,8,"8,0"
4023,720575940624649452,right,L3,154,-8,0,8,-8,"-8,0"
4024,720575940643548468,right,L3,155,-8,13,14,-1,"-8,13"
4025,720575940634270931,right,L3,156,-9,1,9,-8,"-9,1"
4026,720575940626630658,right,L3,157,-1,-7,-3,-4,"-1,-7"
4027,720575940639398453,right,L3,158,3,-5,-6,1,"3,-5"
4028,720575940624291464,right,L3,159,7,7,-4,11,"7,7"
4029,720575940615699306,right,L3,162,-4,-2,3,-5,"-4,-2"
4030,720575940615065922,right,L3,163,-9,7,12,-5,"-9,7"
4031,720575940623677993,right,L3,164,-1,-2,0,-2,"-1,-2"
4032,720575940630983767,right,L3,165,4,16,4,12,"4,16"
4033,720575940653540513,right,L3,166,0,18,9,9,"0,18"
4034,720575940624218549,right,L3,167,0,-17,-9,-8,"0,-17"
4035,720575940626005136,right,L3,168,-1,17,9,8,"-1,17"
4036,720575940623583882,right,L3,169,0,-18,-9,-9,"0,-18"
4037,720575940616967180,right,L3,170,-5,1,5,-4,"-5,1"
4038,720575940618038612,right,L3,171,6,-20,-16,-4,"6,-20"
4039,720575940652489718,right,L3,172,1,22,10,12,"1,22"
4040,720575940624107460,right,L3,173,2,-25,-15,-10,"2,-25"
4041,720575940613304291,right,L3,174,4,-15,-12,-3,"4,-15"
4042,720575940627318794,right,L3,175,-6,-7,2,-9,"-6,-7"
4043,720575940631433027,right,L3,176,-2,13,8,5,"-2,13"
4044,720575940611260821,right,L3,177,-2,-1,1,-2,"-2,-1"
4045,720575940627855000,right,L3,178,2,11,3,8,"2,11"
4046,720575940636440677,right,L3,179,-5,-16,-3,-13,"-5,-16"
4047,720575940646108014,right,L3,180,2,-27,-16,-11,"2,-27"
4048,720575940620910612,right,L3,181,1,-4,-3,-1,"1,-4"
4049,720575940621793371,right,L3,182,7,-10,-12,2,"7,-10"
4050,720575940628597135,right,L3,183,-5,-15,-3,-12,"-5,-15"
4051,720575940629357415,right,L3,184,-6,-5,3,-8,"-6,-5"
4052,720575940624486909,right,L3,185,2,-11,-8,-3,"2,-11"
4053,720575940619081198,right,L3,186,-1,26,14,12,"-1,26"
4054,720575940614103347,right,L3,187,3,21,7,14,"3,21"
4055,720575940612771697,right,L3,188,-5,17,13,4,"-5,17"
4056,720575940633437357,right,L3,189,6,13,0,13,"6,13"
4057,720575940613646545,right,L3,190,-3,-5,0,-5,"-3,-5"
4058,720575940630154999,right,L3,191,-1,-11,-5,-6,"-1,-11"
4059,720575940633926573,right,L3,192,7,10,-2,12,"7,10"
4060,720575940627746393,right,L3,193,-5,4,7,-3,"-5,4"
4061,720575940605273772,right,L3,194,0,-5,-3,-2,"0,-5"
4062,720575940628179196,right,L3,195,-3,-1,2,-3,"-3,-1"
4063,720575940620637776,right,L3,196,-1,8,5,3,"-1,8"
4064,720575940605268140,right,L3,197,0,-20,-10,-10,"0,-20"
4065,720575940617409083,right,L3,198,6,2,-5,7,"6,2"
4066,720575940627544658,right,L3,199,0,-12,-6,-6,"0,-12"
4067,720575940626081724,right,L3,200,-5,12,11,1,"-5,12"
4068,720575940625971642,right,L3,201,-8,9,12,-3,"-8,9"
4069,720575940621925364,right,L3,202,-1,27,14,13,"-1,27"
4070,720575940628082793,right,L3,203,3,-1,-4,3,"3,-1"
4071,720575940619345221,right,L3,204,5,-2,-6,4,"5,-2"
4072,720575940613032598,right,L3,205,5,-6,-8,2,"5,-6"
4073,720575940625104904,right,L3,207,1,29,13,16,"1,29"
4074,720575940631509753,right,L3,208,5,-21,-16,-5,"5,-21"
4075,720575940635270751,right,L3,209,-3,-8,-1,-7,"-3,-8"
4076,720575940625858803,right,L3,210,-6,8,10,-2,"-6,8"
4077,720575940613032854,right,L3,211,-7,-1,6,-7,"-7,-1"
4078,720575940660107649,right,L3,212,2,-16,-10,-6,"2,-16"
4079,720575940631570007,right,L3,213,3,-4,-5,1,"3,-4"
4080,720575940605762528,right,L3,214,-5,3,6,-3,"-5,3"
4081,720575940620903760,right,L3,215,6,7,-3,10,"6,7"
4082,720575940621371574,right,L3,216,2,19,7,12,"2,19"
4083,720575940621955354,right,L3,217,6,15,1,14,"6,15"
4084,720575940606608002,right,L3,218,2,10,3,7,"2,10"
4085,720575940624208391,right,L3,219,6,-4,-8,4,"6,-4"
4086,720575940624874727,right,L3,220,2,-6,-5,-1,"2,-6"
4087,720575940646073879,right,L3,221,-7,3,8,-5,"-7,3"
4088,720575940624222472,right,L3,222,-3,26,16,10,"-3,26"
4089,720575940639184701,right,L3,223,-2,26,15,11,"-2,26"
4090,720575940619152549,right,L3,225,2,-26,-15,-11,"2,-26"
4091,720575940629009155,right,L3,226,5,19,4,15,"5,19"
4092,720575940630100839,right,L3,227,-7,5,9,-4,"-7,5"
4093,720575940614680210,right,L3,229,5,2,-4,6,"5,2"
4094,720575940625849232,right,L3,230,2,9,2,7,"2,9"
4095,720575940615141782,right,L3,231,4,-12,-10,-2,"4,-12"
4096,720575940626915715,right,L3,232,-4,13,10,3,"-4,13"
4097,720575940624194707,right,L3,233,4,-13,-11,-2,"4,-13"
4098,720575940613189994,right,L3,235,4,11,1,10,"4,11"
4099,720575940634102241,right,L3,236,-1,4,3,1,"-1,4"
4100,720575940644030920,right,L3,237,-2,27,15,12,"-2,27"
4101,720575940609607435,right,L3,238,-8,-3,6,-9,"-8,-3"
4102,720575940626985554,right,L3,239,-6,6,9,-3,"-6,6"
4103,720575940610609362,right,L3,240,-4,-3,2,-5,"-4,-3"
4104,720575940647422596,right,L3,241,2,-17,-11,-6,"2,-17"
4105,720575940620724417,right,L3,243,-1,-21,-10,-11,"-1,-21"
4106,720575940623331208,right,L3,244,-4,-12,-2,-10,"-4,-12"
4107,720575940633989995,right,L3,245,-5,-3,3,-6,"-5,-3"
4108,720575940628084873,right,L3,246,-4,15,11,4,"-4,15"
4109,720575940613909544,right,L3,247,-4,-15,-4,-11,"-4,-15"
4110,720575940635283903,right,L3,248,-6,0,6,-6,"-6,0"
4111,720575940613776365,right,L3,249,2,-12,-8,-4,"2,-12"
4112,720575940622472959,right,L3,250,-1,1,1,0,"-1,1"
4113,720575940622986535,right,L3,251,-1,-14,-6,-8,"-1,-14"
4114,720575940626934141,right,L3,252,3,23,8,15,"3,23"
4115,720575940618985541,right,L3,253,5,16,3,13,"5,16"
4116,720575940627870345,right,L3,254,3,-24,-15,-9,"3,-24"
4117,720575940613538223,right,L3,255,-6,-13,-1,-12,"-6,-13"
4118,720575940622733277,right,L3,256,5,-20,-15,-5,"5,-20"
4119,720575940608906179,right,L3,257,2,21,8,13,"2,21"
4120,720575940623589770,right,L3,258,-4,-17,-5,-12,"-4,-17"
4121,720575940628661135,right,L3,259,-7,-5,4,-9,"-7,-5"
4122,720575940612399822,right,L3,260,-3,19,12,7,"-3,19"
4123,720575940627823381,right,L3,261,-1,13,7,6,"-1,13"
4124,720575940632981293,right,L3,262,1,-11,-7,-4,"1,-11"
4125,720575940628128649,right,L3,263,-3,4,5,-1,"-3,4"
4126,720575940625062653,right,L3,264,-1,-6,-2,-4,"-1,-6"
4127,720575940621985520,right,L3,266,-1,-25,-12,-13,"-1,-25"
4128,720575940656012193,right,L3,267,-6,2,7,-5,"-6,2"
4129,720575940632902739,right,L3,268,7,-6,-10,4,"7,-6"
4130,720575940631144143,right,L3,269,2,-19,-12,-7,"2,-19"
4131,720575940626690704,right,L3,270,1,-8,-5,-3,"1,-8"
4132,720575940618961624,right,L3,271,4,6,-1,7,"4,6"
4133,720575940608509276,right,L3,272,3,-2,-4,2,"3,-2"
4134,720575940617373585,right,L3,273,-6,23,17,6,"-6,23"
4135,720575940626788144,right,L3,274,6,4,-4,8,"6,4"
4136,720575940631499562,right,L3,275,-8,-1,7,-8,"-8,-1"
4137,720575940646916404,right,L3,276,2,3,-1,4,"2,3"
4138,720575940613684205,right,L3,277,7,-3,-9,6,"7,-3"
4139,720575940609905476,right,L3,278,-5,10,10,0,"-5,10"
4140,720575940645569572,right,L3,279,-4,8,8,0,"-4,8"
4141,720575940631095095,right,L3,280,-6,-14,-1,-13,"-6,-14"
4142,720575940627160339,right,L3,281,-9,2,10,-8,"-9,2"
4143,720575940622275542,right,L3,282,0,26,13,13,"0,26"
4144,720575940621676422,right,L3,284,0,25,12,13,"0,25"
4145,720575940615681938,right,L3,285,6,-18,-15,-3,"6,-18"
4146,720575940622502388,right,L3,286,0,-24,-12,-12,"0,-24"
4147,720575940661118593,right,L3,287,-5,13,11,2,"-5,13"
4148,720575940621062474,right,L3,289,-1,11,6,5,"-1,11"
4149,720575940605686462,right,L3,290,5,-24,-17,-7,"5,-24"
4150,720575940616318988,right,L3,291,7,2,-6,8,"7,2"
4151,720575940613378986,right,L3,292,-4,18,13,5,"-4,18"
4152,720575940638570974,right,L3,293,4,-17,-13,-4,"4,-17"
4153,720575940623543187,right,L3,294,1,-20,-11,-9,"1,-20"
4154,720575940622384041,right,L3,296,1,-18,-10,-8,"1,-18"
4155,720575940609391113,right,L3,297,7,-9,-12,3,"7,-9"
4156,720575940633646637,right,L3,298,-5,5,7,-2,"-5,5"
4157,720575940628964849,right,L3,299,-4,12,10,2,"-4,12"
4158,720575940628289413,right,L3,300,4,-18,-13,-5,"4,-18"
4159,720575940621670127,right,L3,301,-5,16,13,3,"-5,16"
4160,720575940639291718,right,L3,302,2,17,6,11,"2,17"
4161,720575940608597084,right,L3,303,-5,22,16,6,"-5,22"
4162,720575940606034092,right,L3,304,6,5,-4,9,"6,5"
4163,720575940606586982,right,L3,305,-7,4,9,-5,"-7,4"
4164,720575940622485748,right,L3,306,3,7,0,7,"3,7"
4165,720575940632229930,right,L3,307,5,-25,-18,-7,"5,-25"
4166,720575940623009050,right,L3,308,-5,8,9,-1,"-5,8"
4167,720575940613818134,right,L3,309,-6,12,12,0,"-6,12"
4168,720575940627206915,right,L3,310,2,22,9,13,"2,22"
4169,720575940610692676,right,L3,311,-7,15,14,1,"-7,15"
4170,720575940616803513,right,L3,312,4,-7,-8,1,"4,-7"
4171,720575940626856336,right,L3,313,7,3,-6,9,"7,3"
4172,720575940642277773,right,L3,314,-9,5,11,-6,"-9,5"
4173,720575940638490714,right,L3,315,-3,-6,0,-6,"-3,-6"
4174,720575940622702344,right,L3,316,5,-4,-7,3,"5,-4"
4175,720575940628870782,right,L3,317,-5,-4,3,-7,"-5,-4"
4176,720575940625113068,right,L3,318,4,-19,-14,-5,"4,-19"
4177,720575940627019326,right,L3,319,-2,5,4,1,"-2,5"
4178,720575940639895203,right,L3,320,-2,-5,-1,-4,"-2,-5"
4179,720575940616218015,right,L3,322,2,26,11,15,"2,26"
4180,720575940636720558,right,L3,323,-7,-13,0,-13,"-7,-13"
4181,720575940627685397,right,L3,324,3,24,9,15,"3,24"
4182,720575940607638723,right,L3,325,5,1,-5,6,"5,1"
4183,720575940617748881,right,L3,326,2,16,6,10,"2,16"
4184,720575940635116313,right,L3,327,5,3,-4,7,"5,3"
4185,720575940623666835,right,L3,328,5,-9,-10,1,"5,-9"
4186,720575940654764961,right,L3,329,0,24,12,12,"0,24"
4187,720575940616406284,right,L3,330,3,3,-2,5,"3,3"
4188,720575940624105098,right,L3,331,1,-15,-9,-6,"1,-15"
4189,720575940621563713,right,L3,332,4,-26,-17,-9,"4,-26"
4190,720575940608387442,right,L3,333,0,-21,-11,-10,"0,-21"
4191,720575940614277357,right,L3,334,1,-26,-14,-12,"1,-26"
4192,720575940618324037,right,L3,335,2,8,2,6,"2,8"
4193,720575940614219518,right,L3,336,0,23,11,12,"0,23"
4194,720575940636583269,right,L3,337,-5,-6,2,-8,"-5,-6"
4195,720575940627416552,right,L3,338,-1,0,1,-1,"-1,0"
4196,720575940641713909,right,L3,339,6,11,-1,12,"6,11"
4197,720575940632065231,right,L3,341,6,-17,-15,-2,"6,-17"
4198,720575940627937301,right,L3,342,2,-15,-10,-5,"2,-15"
4199,720575940616798732,right,L3,343,-3,27,16,11,"-3,27"
4200,720575940613680194,right,L3,344,-2,-15,-6,-9,"-2,-15"
4201,720575940625492301,right,L3,345,3,-12,-9,-3,"3,-12"
4202,720575940630503639,right,L3,346,-7,-9,2,-11,"-7,-9"
4203,720575940624748948,right,L3,347,-5,-13,-2,-11,"-5,-13"
4204,720575940623125577,right,L3,348,3,14,4,10,"3,14"
4205,720575940628324112,right,L3,349,-5,-14,-2,-12,"-5,-14"
4206,720575940612306867,right,L3,350,1,15,6,9,"1,15"
4207,720575940625217294,right,L3,351,-1,-17,-8,-9,"-1,-17"
4208,720575940627785605,right,L3,352,-2,28,16,12,"-2,28"
4209,720575940627832263,right,L3,353,2,24,10,14,"2,24"
4210,720575940628819459,right,L3,354,-2,-26,-11,-15,"-2,-26"
4211,720575940623294088,right,L3,355,-7,-6,4,-10,"-7,-6"
4212,720575940622761949,right,L3,356,0,22,11,11,"0,22"
4213,720575940622515839,right,L3,357,4,17,4,13,"4,17"
4214,720575940627935058,right,L3,358,-3,17,11,6,"-3,17"
4215,720575940637615838,right,L3,359,2,23,9,14,"2,23"
4216,720575940612075618,right,L3,360,-5,19,14,5,"-5,19"
4217,720575940628058440,right,L3,361,0,-7,-4,-3,"0,-7"
4218,720575940652611062,right,L3,362,2,-20,-12,-8,"2,-20"
4219,720575940620492880,right,L3,363,7,-4,-9,5,"7,-4"
4220,720575940614307299,right,L3,364,4,4,-2,6,"4,4"
4221,720575940633023202,right,L3,365,4,7,-1,8,"4,7"
4222,720575940626919623,right,L3,366,-5,-20,-5,-15,"-5,-20"
4223,720575940632172113,right,L3,367,-6,-15,-2,-13,"-6,-15"
4224,720575940624585959,right,L3,368,-4,-20,-6,-14,"-4,-20"
4225,720575940623804157,right,L3,369,5,-5,-8,3,"5,-5"
4226,720575940626546992,right,L3,370,-3,21,13,8,"-3,21"
4227,720575940635314795,right,L3,371,6,-5,-9,4,"6,-5"
4228,720575940628246088,right,L3,372,1,-2,-2,0,"1,-2"
4229,720575940616570299,right,L3,373,1,-21,-12,-9,"1,-21"
4230,720575940633382752,right,L3,374,2,13,4,9,"2,13"
4231,720575940629070747,right,L3,375,-6,7,9,-2,"-6,7"
4232,720575940632334127,right,L3,376,-7,-10,2,-12,"-7,-10"
4233,720575940618140699,right,L3,377,0,7,3,4,"0,7"
4234,720575940628323461,right,L3,378,-3,18,12,6,"-3,18"
4235,720575940612487630,right,L3,379,3,-17,-12,-5,"3,-17"
4236,720575940622352972,right,L3,381,-8,-9,3,-12,"-8,-9"
4237,720575940605586622,right,L3,382,3,-6,-6,0,"3,-6"
4238,720575940634444439,right,L3,384,-6,-2,5,-7,"-6,-2"
4239,720575940623379592,right,L3,385,-3,-18,-6,-12,"-3,-18"
4240,720575940640653144,right,L3,386,-6,19,15,4,"-6,19"
4241,720575940632397327,right,L3,387,-1,-15,-7,-8,"-1,-15"
4242,720575940624264009,right,L3,388,3,19,6,13,"3,19"
4243,720575940627577105,right,L3,389,-6,-16,-2,-14,"-6,-16"
4244,720575940632178316,right,L3,390,-6,-9,1,-10,"-6,-9"
4245,720575940612715175,right,L3,391,4,-3,-6,3,"4,-3"
4246,720575940610664601,right,L3,392,-4,7,7,0,"-4,7"
4247,720575940630975313,right,L3,393,-1,22,12,10,"-1,22"
4248,720575940618294744,right,L3,394,-7,-8,3,-11,"-7,-8"
4249,720575940627328018,right,L3,395,0,-22,-11,-11,"0,-22"
4250,720575940620103558,right,L3,396,-1,10,6,4,"-1,10"
4251,720575940621345857,right,L3,397,-3,-19,-7,-12,"-3,-19"
4252,720575940630499319,right,L3,398,-3,22,14,8,"-3,22"
4253,720575940617720550,right,L3,399,-4,-24,-8,-16,"-4,-24"
4254,720575940632400971,right,L3,400,1,-29,-16,-13,"1,-29"
4255,720575940624496969,right,L3,401,-2,-19,-8,-11,"-2,-19"
4256,720575940631712331,right,L3,402,3,26,10,16,"3,26"
4257,720575940607392898,right,L3,403,-2,-12,-4,-8,"-2,-12"
4258,720575940619123483,right,L3,404,-1,20,11,9,"-1,20"
4259,720575940612580761,right,L3,405,3,10,2,8,"3,10"
4260,720575940625032947,right,L3,406,1,-25,-14,-11,"1,-25"
4261,720575940621396718,right,L3,407,-5,-10,0,-10,"-5,-10"
4262,720575940646990388,right,L3,408,-6,-4,4,-8,"-6,-4"
4263,720575940621766260,right,L3,409,0,-3,-2,-1,"0,-3"
4264,720575940607284610,right,L3,410,-2,-2,1,-3,"-2,-2"
4265,720575940614442658,right,L3,411,-5,-19,-5,-14,"-5,-19"
4266,720575940609928971,right,L3,412,-6,21,16,5,"-6,21"
4267,720575940625539082,right,L3,414,4,21,6,15,"4,21"
4268,720575940621397089,right,L3,415,6,12,0,12,"6,12"
4269,720575940626822960,right,L3,416,3,-8,-7,-1,"3,-8"
4270,720575940611525582,right,L3,417,-6,-10,1,-11,"-6,-10"
4271,720575940637114743,right,L3,418,-2,15,9,6,"-2,15"
4272,720575940626427847,right,L3,419,-3,-11,-3,-8,"-3,-11"
4273,720575940615507167,right,L3,420,6,-3,-8,5,"6,-3"
4274,720575940645381742,right,L3,423,3,-18,-12,-6,"3,-18"
4275,720575940629869059,right,L3,424,-3,-2,2,-4,"-3,-2"
4276,720575940629426475,right,L3,425,3,20,7,13,"3,20"
4277,720575940623586756,right,L3,426,-3,0,3,-3,"-3,0"
4278,720575940626784152,right,L3,427,5,-18,-14,-4,"5,-18"
4279,720575940634267548,right,L3,428,-2,23,13,10,"-2,23"
4280,720575940627905566,right,L3,429,-2,14,9,5,"-2,14"
4281,720575940607963826,right,L3,430,-3,-7,-1,-6,"-3,-7"
4282,720575940625865008,right,L3,431,-2,-10,-3,-7,"-2,-10"
4283,720575940620517803,right,L3,432,-5,7,8,-1,"-5,7"
4284,720575940609411849,right,L3,433,0,-8,-4,-4,"0,-8"
4285,720575940619982238,right,L3,434,-3,7,6,1,"-3,7"
4286,720575940617304379,right,L3,435,5,-17,-14,-3,"5,-17"
4287,720575940625484621,right,L3,436,0,-15,-8,-7,"0,-15"
4288,720575940623277667,right,L3,437,-3,12,9,3,"-3,12"
4289,720575940622475248,right,L3,438,2,27,11,16,"2,27"
4290,720575940660346241,right,L3,439,-3,-9,-2,-7,"-3,-9"
4291,720575940620584721,right,L3,440,1,23,10,13,"1,23"
4292,720575940615151446,right,L3,441,3,-16,-11,-5,"3,-16"
4293,720575940632815917,right,L3,442,-5,25,17,8,"-5,25"
4294,720575940619300766,right,L3,444,4,-10,-9,-1,"4,-10"
4295,720575940636721775,right,L3,445,-2,8,6,2,"-2,8"
4296,720575940634132380,right,L3,446,2,-14,-9,-5,"2,-14"
4297,720575940626136862,right,L3,447,-1,2,2,0,"-1,2"
4298,720575940629916571,right,L3,448,0,30,15,15,"0,30"
4299,720575940620271239,right,L3,449,6,-16,-14,-2,"6,-16"
4300,720575940628535083,right,L3,450,2,-9,-7,-2,"2,-9"
4301,720575940630998359,right,L3,451,4,20,6,14,"4,20"
4302,720575940624142118,right,L3,452,1,-9,-6,-3,"1,-9"
4303,720575940629019398,right,L3,453,3,25,9,16,"3,25"
4304,720575940660377729,right,L3,454,5,-12,-11,-1,"5,-12"
4305,720575940606095462,right,L3,455,7,-7,-11,4,"7,-7"
4306,720575940631477315,right,L3,456,0,21,10,11,"0,21"
4307,720575940641045888,right,L3,457,-2,17,10,7,"-2,17"
4308,720575940628167305,right,L3,458,5,0,-5,5,"5,0"
4309,720575940617128593,right,L3,459,5,-3,-7,4,"5,-3"
4310,720575940622119518,right,L3,460,-3,-20,-7,-13,"-3,-20"
4311,720575940647188532,right,L3,461,7,-5,-10,5,"7,-5"
4312,720575940624109704,right,L3,462,-1,18,10,8,"-1,18"
4313,720575940607648178,right,L3,463,5,17,3,14,"5,17"
4314,720575940631393554,right,L3,464,4,0,-4,4,"4,0"
4315,720575940637494494,right,L3,465,3,0,-3,3,"3,0"
4316,720575940633656365,right,L3,466,1,14,6,8,"1,14"
4317,720575940625624869,right,L3,467,-2,-20,-8,-12,"-2,-20"
4318,720575940613847249,right,L3,470,4,-9,-9,0,"4,-9"
4319,720575940638682458,right,L3,471,3,-26,-16,-10,"3,-26"
4320,720575940626974986,right,L3,472,1,25,11,14,"1,25"
4321,720575940610535410,right,L3,473,-4,23,15,8,"-4,23"
4322,720575940625021683,right,L3,474,-3,-17,-6,-11,"-3,-17"
4323,720575940642551515,right,L3,475,-4,-1,3,-4,"-4,-1"
4324,720575940621155905,right,L3,476,-1,15,8,7,"-1,15"
4325,720575940635962559,right,L3,479,-2,10,7,3,"-2,10"
4326,720575940618194617,right,L3,480,3,-19,-13,-6,"3,-19"
4327,720575940618173341,right,L3,481,4,-8,-8,0,"4,-8"
4328,720575940611377926,right,L3,482,1,17,7,10,"1,17"
4329,720575940628533351,right,L3,483,2,-7,-6,-1,"2,-7"
4330,720575940612871338,right,L3,484,3,-9,-8,-1,"3,-9"
4331,720575940639378485,right,L3,485,-3,-3,1,-4,"-3,-3"
4332,720575940622672349,right,L3,486,0,1,0,1,"0,1"
4333,720575940620369243,right,L3,487,1,-1,-2,1,"1,-1"
4334,720575940618964052,right,L3,488,7,5,-5,10,"7,5"
4335,720575940632495585,right,L3,490,-5,6,8,-2,"-5,6"
4336,720575940625539111,right,L3,491,7,-1,-8,7,"7,-1"
4337,720575940626035789,right,L3,492,-7,-2,6,-8,"-7,-2"
4338,720575940633306323,right,L3,493,-3,23,14,9,"-3,23"
4339,720575940620752464,right,L3,495,4,5,-2,7,"4,5"
4340,720575940616093599,right,L3,496,7,8,-3,11,"7,8"
4341,720575940635254367,right,L3,497,6,1,-6,7,"6,1"
4342,720575940615402463,right,L3,498,6,10,-1,11,"6,10"
4343,720575940616075570,right,L3,499,5,10,0,10,"5,10"
4344,720575940610814414,right,L3,500,7,-8,-11,3,"7,-8"
4345,720575940628534549,right,L3,501,1,2,0,2,"1,2"
4346,720575940624765959,right,L3,502,5,8,-1,9,"5,8"
4347,720575940642382477,right,L3,503,3,17,5,12,"3,17"
4348,720575940612345038,right,L3,504,-2,9,6,3,"-2,9"
4349,720575940623162623,right,L3,505,6,-22,-17,-5,"6,-22"
4350,720575940635674872,right,L3,506,1,-12,-7,-5,"1,-12"
4351,720575940618069531,right,L3,507,-5,-12,-1,-11,"-5,-12"
4352,720575940630746220,right,L3,508,-5,11,10,1,"-5,11"
4353,720575940623392904,right,L3,509,-4,10,9,1,"-4,10"
4354,720575940644478880,right,L3,510,-2,11,7,4,"-2,11"
4355,720575940631885895,right,L3,511,5,-11,-11,0,"5,-11"
4356,720575940621925108,right,L3,512,6,0,-6,6,"6,0"
4357,720575940623557815,right,L3,513,-4,-13,-3,-10,"-4,-13"
4358,720575940623375692,right,L3,514,-4,-10,-1,-9,"-4,-10"
4359,720575940632547615,right,L3,515,-8,-7,4,-11,"-8,-7"
4360,720575940643709344,right,L3,516,7,-18,-16,-2,"7,-18"
4361,720575940612875121,right,L3,518,-4,22,15,7,"-4,22"
4362,720575940622591446,right,L3,519,-5,-5,2,-7,"-5,-5"
4363,720575940629579851,right,L3,520,-2,-22,-9,-13,"-2,-22"
4364,720575940629973698,right,L3,521,6,-9,-11,2,"6,-9"
4365,720575940625365996,right,L3,522,-4,0,4,-4,"-4,0"
4366,720575940619047169,right,L3,523,2,14,5,9,"2,14"
4367,720575940623559175,right,L3,524,4,-20,-14,-6,"4,-20"
4368,720575940628566858,right,L3,525,-1,-20,-9,-11,"-1,-20"
4369,720575940637251502,right,L3,526,0,-10,-5,-5,"0,-10"
4370,720575940647063428,right,L3,527,-4,-8,0,-8,"-4,-8"
4371,720575940627966218,right,L3,528,2,7,1,6,"2,7"
4372,720575940636654254,right,L3,529,2,-2,-3,1,"2,-2"
4373,720575940617360955,right,L3,530,-3,-13,-4,-9,"-3,-13"
4374,720575940616798813,right,L3,531,1,0,-1,1,"1,0"
4375,720575940627966333,right,L3,532,-8,7,11,-4,"-8,7"
4376,720575940625028536,right,L3,533,0,-16,-8,-8,"0,-16"
4377,720575940623568324,right,L3,534,3,2,-2,4,"3,2"
4378,720575940614901098,right,L3,535,8,-4,-10,6,"8,-4"
4379,720575940621891617,right,L3,536,3,4,-1,5,"3,4"
4380,720575940633470116,right,L3,537,0,-23,-12,-11,"0,-23"
4381,720575940606489702,right,L3,538,-4,1,4,-3,"-4,1"
4382,720575940616543291,right,L3,540,-2,-9,-3,-6,"-2,-9"
4383,720575940638926938,right,L3,541,-4,14,11,3,"-4,14"
4384,720575940612464882,right,L3,542,6,-13,-13,0,"6,-13"
4385,720575940613087766,right,L3,543,-1,-4,-1,-3,"-1,-4"
4386,720575940639028058,right,L3,544,3,-13,-10,-3,"3,-13"
4387,720575940621943557,right,L3,545,5,11,0,11,"5,11"
4388,720575940621113584,right,L3,546,3,6,0,6,"3,6"
4389,720575940621789445,right,L3,548,1,-16,-9,-7,"1,-16"
4390,720575940632409903,right,L3,549,0,-9,-5,-4,"0,-9"
4391,720575940615983846,right,L3,550,-2,3,3,0,"-2,3"
4392,720575940627979909,right,L3,551,-4,-9,-1,-8,"-4,-9"
4393,720575940644276424,right,L3,552,4,-1,-5,4,"4,-1"
4394,720575940621838830,right,L3,553,-3,16,11,5,"-3,16"
4395,720575940632958946,right,L3,555,-4,9,8,1,"-4,9"
4396,720575940630299855,right,L3,556,0,10,5,5,"0,10"
4397,720575940639182313,right,L3,557,6,-10,-11,1,"6,-10"
4398,720575940635138723,right,L3,558,-4,-21,-7,-14,"-4,-21"
4399,720575940633263277,right,L3,559,-6,22,17,5,"-6,22"
4400,720575940640211571,right,L3,560,-7,14,14,0,"-7,14"
4401,720575940630516862,right,L3,561,5,7,-2,9,"5,7"
4402,720575940629937516,right,L3,562,-5,-2,4,-6,"-5,-2"
4403,720575940625992496,right,L3,563,5,-13,-12,-1,"5,-13"
4404,720575940635653812,right,L3,564,3,-23,-15,-8,"3,-23"
4405,720575940632740127,right,L3,565,0,-26,-13,-13,"0,-26"
4406,720575940628068546,right,L3,566,5,-8,-9,1,"5,-8"
4407,720575940619992240,right,L3,568,-6,-8,2,-10,"-6,-8"
4408,720575940625972668,right,L3,569,6,6,-3,9,"6,6"
4409,720575940631324175,right,L3,570,2,25,10,15,"2,25"
4410,720575940615125910,right,L3,571,0,-14,-7,-7,"0,-14"
4411,720575940631467001,right,L3,572,-8,3,9,-6,"-8,3"
4412,720575940623327231,right,L3,573,4,14,3,11,"4,14"
4413,720575940623057386,right,L3,575,6,9,-2,11,"6,9"
4414,720575940634161634,right,L3,576,0,28,14,14,"0,28"
4415,720575940618028545,right,L3,577,5,-14,-12,-2,"5,-14"
4416,720575940632777420,right,L3,578,4,-11,-10,-1,"4,-11"
4417,720575940611576526,right,L3,579,-3,-10,-2,-8,"-3,-10"
4418,720575940604889568,right,L3,580,-2,-23,-10,-13,"-2,-23"
4419,720575940621320052,right,L3,581,3,9,1,8,"3,9"
4420,720575940645487127,right,L3,582,-1,23,12,11,"-1,23"
4421,720575940613915567,right,L3,583,3,-25,-16,-9,"3,-25"
4422,720575940626380730,right,L3,584,4,23,7,16,"4,23"
4423,720575940622338428,right,L3,585,-1,-23,-11,-12,"-1,-23"
4424,720575940627406930,right,L3,586,2,18,7,11,"2,18"
4425,720575940612083057,right,L3,587,4,22,7,15,"4,22"
4426,720575940620343175,right,L3,589,-1,-5,-2,-3,"-1,-5"
4427,720575940612502514,right,L3,591,3,-3,-5,2,"3,-3"
4428,720575940625309116,right,L3,594,7,-16,-15,-1,"7,-16"
4429,720575940622411340,right,L3,595,7,-12,-13,1,"7,-12"
4430,720575940621765620,right,L3,596,-4,-16,-4,-12,"-4,-16"
4431,720575940628627456,right,L3,597,4,1,-4,5,"4,1"
4432,720575940626348350,right,L3,598,2,-18,-11,-7,"2,-18"
4433,720575940636987767,right,L3,600,3,-10,-8,-2,"3,-10"
4434,720575940629379834,right,L3,601,1,16,7,9,"1,16"
4435,720575940621004885,right,L3,602,4,-2,-5,3,"4,-2"
4436,720575940624809480,right,L3,603,-3,-23,-9,-14,"-3,-23"
4437,720575940623007159,right,L3,604,-6,-17,-3,-14,"-6,-17"
4438,720575940621502068,right,L3,605,3,15,4,11,"3,15"
4439,720575940608846275,right,L3,606,-1,-19,-9,-10,"-1,-19"
4440,720575940617184315,right,L3,607,1,18,8,10,"1,18"
4441,720575940638541278,right,L3,608,1,10,4,6,"1,10"
4442,720575940620206529,right,L3,609,-2,0,2,-2,"-2,0"
4443,720575940645156631,right,L3,610,2,-23,-14,-9,"2,-23"
4444,720575940624158903,right,L3,611,-1,-18,-8,-10,"-1,-18"
4445,720575940617363673,right,L3,612,-3,-26,-10,-16,"-3,-26"
4446,720575940605345410,right,L3,614,-2,-8,-2,-6,"-2,-8"
4447,720575940623297318,right,L3,615,-7,-7,3,-10,"-7,-7"
4448,720575940612717461,right,L3,616,-3,15,10,5,"-3,15"
4449,720575940621543028,right,L3,617,-2,-17,-7,-10,"-2,-17"
4450,720575940620692562,right,L3,618,-1,24,13,11,"-1,24"
4451,720575940608684811,right,L3,619,-4,-19,-6,-13,"-4,-19"
4452,720575940623428829,right,L3,620,7,1,-7,8,"7,1"
4453,720575940620804434,right,L3,621,1,24,11,13,"1,24"
4454,720575940619076987,right,L3,622,-5,20,15,5,"-5,20"
4455,720575940641257973,right,L3,623,1,13,5,8,"1,13"
4456,720575940623511532,right,L3,624,1,-17,-10,-7,"1,-17"
4457,720575940638336326,right,L3,625,-2,24,14,10,"-2,24"
4458,720575940631378959,right,L3,626,-5,-8,1,-9,"-5,-8"
4459,720575940644772900,right,L3,627,0,-1,-1,0,"0,-1"
4460,720575940633084499,right,L3,629,4,24,8,16,"4,24"
4461,720575940639213631,right,L3,630,4,8,0,8,"4,8"
4462,720575940627055749,right,L3,631,1,26,12,14,"1,26"
4463,720575940660306305,right,L3,632,3,-20,-13,-7,"3,-20"
4464,720575940618324697,right,L3,633,-1,-24,-11,-13,"-1,-24"
4465,720575940631130850,right,L3,634,-3,-15,-5,-10,"-3,-15"
4466,720575940619082478,right,L3,635,6,-6,-9,3,"6,-6"
4467,720575940618375569,right,L3,636,0,6,3,3,"0,6"
4468,720575940649887609,right,L3,637,3,-21,-14,-7,"3,-21"
4469,720575940641780621,right,L3,638,-1,7,4,3,"-1,7"
4470,720575940628077640,right,L3,640,-1,-16,-7,-9,"-1,-16"
4471,720575940630066176,right,L3,641,-8,-5,5,-10,"-8,-5"
4472,720575940631602447,right,L3,642,-5,-11,-1,-10,"-5,-11"
4473,720575940617811293,right,L3,643,6,14,1,13,"6,14"
4474,720575940629064188,right,L3,644,-6,18,15,3,"-6,18"
4475,720575940628760848,right,L3,645,-4,27,17,10,"-4,27"
4476,720575940630295034,right,L3,646,6,17,2,15,"6,17"
4477,720575940626914960,right,L3,647,-4,-7,0,-7,"-4,-7"
4478,720575940619012510,right,L3,648,1,7,2,5,"1,7"
4479,720575940627846404,right,L3,649,-1,5,3,2,"-1,5"
4480,720575940620199444,right,L3,650,-3,-25,-10,-15,"-3,-25"
4481,720575940632306962,right,L3,651,-4,-5,1,-6,"-4,-5"
4482,720575940620706543,right,L3,652,-6,-11,0,-11,"-6,-11"
4483,720575940628323856,right,L3,653,-6,-12,0,-12,"-6,-12"
4484,720575940606554558,right,L3,654,-3,8,7,1,"-3,8"
4485,720575940614172847,right,L3,655,6,-1,-7,6,"6,-1"
4486,720575940609738435,right,L3,656,0,-11,-6,-5,"0,-11"
4487,720575940622591709,right,L3,657,-2,-25,-11,-14,"-2,-25"
4488,720575940640540112,right,L3,658,1,20,9,11,"1,20"
4489,720575940623881924,right,L3,659,-4,-6,1,-7,"-4,-6"
4490,720575940642079477,right,L3,660,2,28,12,16,"2,28"
4491,720575940619137819,right,L3,661,-3,14,10,4,"-3,14"
4492,720575940622779998,right,L3,662,2,-1,-3,2,"2,-1"
4493,720575940636935494,right,L3,663,0,8,4,4,"0,8"
4494,720575940615981206,right,L3,664,1,-27,-15,-12,"1,-27"
4495,720575940614234258,right,L3,665,7,-2,-8,6,"7,-2"
4496,720575940637029744,right,L3,666,7,-13,-14,1,"7,-13"
4497,720575940627201380,right,L3,667,1,-28,-15,-13,"1,-28"
4498,720575940625315709,right,L3,668,1,19,8,11,"1,19"
4499,720575940635295083,right,L3,669,4,-16,-12,-4,"4,-16"
4500,720575940620235456,right,L3,670,5,5,-3,8,"5,5"
4501,720575940630204286,right,L3,671,-4,-23,-8,-15,"-4,-23"
4502,720575940618919003,right,L3,672,-8,11,13,-2,"-8,11"
4503,720575940610839620,right,L3,673,2,5,0,5,"2,5"
4504,720575940633603680,right,L3,674,-4,-14,-3,-11,"-4,-14"
4505,720575940621265780,right,L3,675,-7,19,16,3,"-7,19"
4506,720575940615693218,right,L3,676,-3,-21,-8,-13,"-3,-21"
4507,720575940636090223,right,L3,677,0,11,5,6,"0,11"
4508,720575940635757560,right,L3,678,3,-7,-7,0,"3,-7"
4509,720575940626613178,right,L3,679,4,18,5,13,"4,18"
4510,720575940633385043,right,L3,680,-1,25,13,12,"-1,25"
4511,720575940629436519,right,L3,681,-2,-21,-9,-12,"-2,-21"
4512,720575940630545367,right,L3,682,6,-8,-10,2,"6,-8"
4513,720575940617655014,right,L3,683,2,6,1,5,"2,6"
4514,720575940635195804,right,L3,684,-6,17,14,3,"-6,17"
4515,720575940644150324,right,L3,685,-5,-9,0,-9,"-5,-9"
4516,720575940635260511,right,L3,686,5,-22,-16,-6,"5,-22"
4517,720575940615151190,right,L3,687,-6,-3,4,-7,"-6,-3"
4518,720575940623830822,right,L3,688,-7,10,12,-2,"-7,10"
4519,720575940617994811,right,L3,689,-2,18,11,7,"-2,18"
4520,720575940623799699,right,L3,690,-7,-3,5,-8,"-7,-3"
4521,720575940631325497,right,L3,691,-9,4,11,-7,"-9,4"
4522,720575940631869783,right,L3,692,-4,24,16,8,"-4,24"
4523,720575940625408048,right,L3,693,-3,25,15,10,"-3,25"
4524,720575940628575631,right,L3,694,4,3,-3,6,"4,3"
4525,720575940606723164,right,L3,695,-6,10,11,-1,"-6,10"
4526,720575940618936221,right,L3,696,-2,16,10,6,"-2,16"
4527,720575940617027909,right,L3,697,1,-22,-12,-10,"1,-22"
4528,720575940631403023,right,L3,698,6,-7,-10,3,"6,-7"
4529,720575940644067232,right,L3,700,5,15,2,13,"5,15"
4530,720575940626387044,right,L3,701,0,-4,-2,-2,"0,-4"
4531,720575940640429008,right,L3,702,-5,23,16,7,"-5,23"
4532,720575940605763040,right,L3,703,-3,1,3,-2,"-3,1"
4533,720575940613154739,right,L3,704,-7,8,11,-3,"-7,8"
4534,720575940623494438,right,L3,705,1,1,-1,2,"1,1"
4535,720575940611667349,right,L3,707,-2,25,14,11,"-2,25"
4536,720575940647354659,right,L3,708,-4,-25,-9,-16,"-4,-25"
4537,720575940635046574,right,L3,709,-2,-24,-10,-14,"-2,-24"
4538,720575940617222237,right,L3,710,4,-25,-17,-8,"4,-25"
4539,720575940608573707,right,L3,711,-1,19,10,9,"-1,19"
4540,720575940624961806,right,L3,712,-7,12,13,-1,"-7,12"
4541,720575940619667732,right,L3,713,-6,16,14,2,"-6,16"
4542,720575940627220099,right,L3,714,5,12,1,11,"5,12"
4543,720575940614020527,right,L3,715,4,10,1,9,"4,10"
4544,720575940627317002,right,L3,716,4,-6,-7,1,"4,-6"
4545,720575940623097121,right,L3,717,2,-22,-13,-9,"2,-22"
4546,720575940617653204,right,L3,718,-5,24,17,7,"-5,24"
4547,720575940633877293,right,L3,719,1,27,12,15,"1,27"
4548,720575940615323857,right,L3,720,-5,21,15,6,"-5,21"
4549,720575940650823289,right,L3,721,5,13,1,12,"5,13"
4550,720575940619625118,right,L3,722,6,-15,-14,-1,"6,-15"
4551,720575940634222873,right,L3,723,-2,-11,-4,-7,"-2,-11"
4552,720575940622674189,right,L3,724,4,2,-3,5,"4,2"
4553,720575940632590540,right,L3,725,-3,-24,-9,-15,"-3,-24"
4554,720575940611628498,right,L3,726,2,-28,-16,-12,"2,-28"
4555,720575940612898417,right,L3,727,7,6,-4,10,"7,6"
4556,720575940626009893,right,L3,728,7,12,-1,13,"7,12"
4557,720575940612289890,right,L3,730,7,0,-7,7,"7,0"
4558,720575940625442960,right,L3,731,-6,9,10,-1,"-6,9"
4559,720575940628920316,right,L3,732,-3,6,6,0,"-3,6"
4560,720575940629871063,right,L3,733,-5,-17,-4,-13,"-5,-17"
4561,720575940619728007,right,L3,734,2,0,-2,2,"2,0"
4562,720575940626948185,right,L3,735,1,-23,-13,-10,"1,-23"
4563,720575940627832392,right,L3,736,-8,1,8,-7,"-8,1"
4564,720575940615915974,right,L3,737,0,19,9,10,"0,19"
4565,720575940633352100,right,L3,738,-3,13,9,4,"-3,13"
4566,720575940630627706,right,L3,739,-7,2,8,-6,"-7,2"
4567,720575940622526708,right,L3,740,2,-8,-6,-2,"2,-8"
4568,720575940660133249,right,L3,741,-2,-14,-5,-9,"-2,-14"
4569,720575940627334525,right,L3,742,-4,11,9,2,"-4,11"
4570,720575940627176222,right,L3,743,6,-19,-16,-3,"6,-19"
4571,720575940634627042,right,L3,744,-4,25,16,9,"-4,25"
4572,720575940629270778,right,L3,745,0,13,6,7,"0,13"
4573,720575940628215378,right,L3,746,-3,3,4,-1,"-3,3"
4574,720575940634800888,right,L3,747,0,2,1,1,"0,2"
4575,720575940634178751,right,L3,749,-2,1,2,-1,"-2,1"
4576,720575940612488089,right,L3,750,4,-24,-16,-8,"4,-24"
4577,720575940631639627,right,L3,751,1,6,2,4,"1,6"
4578,720575940632748883,right,L3,753,-3,24,15,9,"-3,24"
4579,720575940633042989,right,L3,754,-1,-13,-6,-7,"-1,-13"
4580,720575940618393413,right,L3,755,4,19,5,14,"4,19"
4581,720575940640643901,right,L3,756,5,20,5,15,"5,20"
4582,720575940626345293,right,L3,757,0,-6,-3,-3,"0,-6"
4583,720575940620327303,right,L3,758,5,-1,-6,5,"5,-1"
4584,720575940633892179,right,L3,759,7,14,0,14,"7,14"
4585,720575940622501449,right,L3,760,0,17,8,9,"0,17"
4586,720575940627063448,right,L3,761,-4,-18,-5,-13,"-4,-18"
4587,720575940626912787,right,L3,762,0,14,7,7,"0,14"
4588,720575940608253788,right,L3,764,-8,-6,5,-11,"-8,-6"
4589,720575940647651892,right,L3,765,-3,9,7,2,"-3,9"
4590,720575940621665974,right,L3,766,2,-4,-4,0,"2,-4"
4591,720575940646092567,right,L3,767,1,28,13,15,"1,28"
4592,720575940630024464,right,L3,768,3,5,-1,6,"3,5"
4593,720575940630938668,right,L3,769,4,-27,-18,-9,"4,-27"
4594,720575940615071122,right,L3,770,5,4,-3,7,"5,4"
4595,720575940607513730,right,L3,771,3,-27,-17,-10,"3,-27"
4596,720575940637506014,right,L3,772,1,12,5,7,"1,12"
4597,720575940626588700,right,L3,773,5,-19,-15,-4,"5,-19"
4598,720575940624335880,right,L3,774,-8,6,11,-5,"-8,6"
4599,720575940618490651,right,L3,775,5,22,6,16,"5,22"
4600,720575940619933611,right,L3,776,5,21,5,16,"5,21"
4601,720575940614121699,right,L3,777,6,20,4,16,"6,20"
4602,720575940628709894,right,L3,778,4,25,8,17,"4,25"
4603,720575940605432492,right,L3,779,5,24,7,17,"5,24"
4604,720575940617720806,right,L3,780,-6,25,18,7,"-6,25"
4605,720575940627210810,right,L3,781,-5,26,18,8,"-5,26"
4606,720575940618561209,right,L3,787,3,28,11,17,"3,28"
4607,720575940622503412,right,L3,788,3,27,10,17,"3,27"
4608,720575940615543975,right,L3,789,-3,-27,-11,-16,"-3,-27"
4609,720575940620949089,right,L3,790,-2,-27,-12,-15,"-2,-27"
4610,720575940621700973,right,L3,791,-1,-28,-13,-15,"-1,-28"
4611,720575940632489645,right,L3,792,8,2,-7,9,"8,2"
4612,720575940618607188,right,L3,793,8,-6,-11,5,"8,-6"
4613,720575940624374212,right,L3,794,5,-26,-18,-8,"5,-26"
4614,720575940625228828,right,L3,795,6,-21,-17,-4,"6,-21"
4615,720575940617114461,right,L3,796,4,26,9,17,"4,26"
4616,720575940620174040,right,L4,1,-6,13,12,1,"-6,13"
4617,720575940621364340,right,L4,2,-8,2,9,-7,"-8,2"
4618,720575940629690575,right,L4,3,6,-12,-12,0,"6,-12"
4619,720575940629563152,right,L4,4,-5,-21,-6,-15,"-5,-21"
4620,720575940627685739,right,L4,5,-1,16,9,7,"-1,16"
4621,720575940623802564,right,L4,6,-2,-4,0,-4,"-2,-4"
4622,720575940633101759,right,L4,7,-6,-6,3,-9,"-6,-6"
4623,720575940616532492,right,L4,8,-4,26,17,9,"-4,26"
4624,720575940613912487,right,L4,9,4,9,0,9,"4,9"
4625,720575940628055573,right,L4,10,5,-15,-13,-2,"5,-15"
4626,720575940631594604,right,L4,11,7,-14,-14,0,"7,-14"
4627,720575940643836468,right,L4,12,-7,9,11,-2,"-7,9"
4628,720575940632504168,right,L4,13,-1,-26,-12,-14,"-1,-26"
4629,720575940623905304,right,L4,14,0,-27,-14,-13,"0,-27"
4630,720575940615123858,right,L4,15,2,-3,-4,1,"2,-3"
4631,720575940625241843,right,L4,16,-2,-16,-6,-10,"-2,-16"
4632,720575940626944899,right,L4,17,1,-5,-4,-1,"1,-5"
4633,720575940618004637,right,L4,18,5,-16,-13,-3,"5,-16"
4634,720575940622776346,right,L4,19,-7,17,15,2,"-7,17"
4635,720575940614570961,right,L4,20,3,-11,-9,-2,"3,-11"
4636,720575940635582132,right,L4,21,-2,19,11,8,"-2,19"
4637,720575940627326553,right,L4,22,-1,3,2,1,"-1,3"
4638,720575940627313283,right,L4,23,-3,-16,-5,-11,"-3,-16"
4639,720575940618200733,right,L4,24,-1,-10,-4,-6,"-1,-10"
4640,720575940629770256,right,L4,25,-9,3,10,-7,"-9,3"
4641,720575940631156311,right,L4,26,1,-3,-3,0,"1,-3"
4642,720575940624852733,right,L4,27,0,-25,-13,-12,"0,-25"
4643,720575940639171389,right,L4,28,5,6,-2,8,"5,6"
4644,720575940630752251,right,L4,29,-1,-3,-1,-2,"-1,-3"
4645,720575940632872396,right,L4,30,6,16,2,14,"6,16"
4646,720575940627666283,right,L4,31,0,16,8,8,"0,16"
4647,720575940612708775,right,L4,32,0,12,6,6,"0,12"
4648,720575940615992070,right,L4,33,3,18,6,12,"3,18"
4649,720575940617631961,right,L4,35,1,-24,-13,-11,"1,-24"
4650,720575940616582466,right,L4,36,6,8,-2,10,"6,8"
4651,720575940638508510,right,L4,37,1,5,1,4,"1,5"
4652,720575940616034246,right,L4,38,0,-2,-1,-1,"0,-2"
4653,720575940617293529,right,L4,39,0,20,10,10,"0,20"
4654,720575940655307169,right,L4,40,-2,-6,-1,-5,"-2,-6"
4655,720575940621012133,right,L4,41,-3,28,17,11,"-3,28"
4656,720575940621571254,right,L4,42,-1,14,8,6,"-1,14"
4657,720575940630910070,right,L4,43,-5,18,14,4,"-5,18"
4658,720575940633377740,right,L4,45,-5,-1,4,-5,"-5,-1"
4659,720575940637778094,right,L4,46,-5,15,12,3,"-5,15"
4660,720575940616834165,right,L4,47,-9,-1,8,-9,"-9,-1"
4661,720575940632045586,right,L4,48,-4,-22,-7,-15,"-4,-22"
4662,720575940612367473,right,L4,49,4,-4,-6,2,"4,-4"
4663,720575940642864781,right,L4,50,-2,21,12,9,"-2,21"
4664,720575940627732569,right,L4,51,0,-19,-10,-9,"0,-19"
4665,720575940646283886,right,L4,52,-1,-22,-10,-12,"-1,-22"
4666,720575940620902059,right,L4,53,5,14,2,12,"5,14"
4667,720575940637210542,right,L4,54,-4,3,5,-2,"-4,3"
4668,720575940606024294,right,L4,55,-4,-11,-2,-9,"-4,-11"
4669,720575940631239747,right,L4,56,1,-13,-8,-5,"1,-13"
4670,720575940626798338,right,L4,57,6,-11,-12,1,"6,-11"
4671,720575940627098923,right,L4,58,3,12,3,9,"3,12"
4672,720575940640701811,right,L4,59,-2,2,3,-1,"-2,2"
4673,720575940629928783,right,L4,60,-8,8,12,-4,"-8,8"
4674,720575940647341364,right,L4,61,-4,-4,2,-6,"-4,-4"
4675,720575940636789902,right,L4,63,4,12,2,10,"4,12"
4676,720575940635543391,right,L4,64,4,-23,-16,-7,"4,-23"
4677,720575940624003476,right,L4,65,-1,28,15,13,"-1,28"
4678,720575940635365216,right,L4,66,2,15,5,10,"2,15"
4679,720575940627293470,right,L4,67,-2,-13,-5,-8,"-2,-13"
4680,720575940605885286,right,L4,68,3,16,5,11,"3,16"
4681,720575940611348178,right,L4,69,1,8,3,5,"1,8"
4682,720575940606029746,right,L4,70,-4,21,14,7,"-4,21"
4683,720575940632090435,right,L4,71,-2,-3,0,-3,"-2,-3"
4684,720575940638159582,right,L4,72,0,-28,-14,-14,"0,-28"
4685,720575940614284463,right,L4,73,2,2,-1,3,"2,2"
4686,720575940621597110,right,L4,74,-1,-9,-4,-5,"-1,-9"
4687,720575940641026267,right,L4,75,-6,14,13,1,"-6,14"
4688,720575940621346147,right,L4,76,-3,-4,1,-5,"-3,-4"
4689,720575940614095400,right,L4,77,2,-5,-5,0,"2,-5"
4690,720575940634973591,right,L4,79,2,1,-2,3,"2,1"
4691,720575940646311476,right,L4,80,4,13,2,11,"4,13"
4692,720575940620560043,right,L4,81,6,-2,-7,5,"6,-2"
4693,720575940652954870,right,L4,82,-7,7,10,-3,"-7,7"
4694,720575940635065963,right,L4,83,2,-21,-13,-8,"2,-21"
4695,720575940611102020,right,L4,84,-2,12,8,4,"-2,12"
4696,720575940630556268,right,L4,85,4,-22,-15,-7,"4,-22"
4697,720575940625354782,right,L4,86,-5,-7,1,-8,"-5,-7"
4698,720575940638504425,right,L4,87,1,11,4,7,"1,11"
4699,720575940620523942,right,L4,88,7,4,-5,9,"7,4"
4700,720575940625254733,right,L4,89,1,-19,-11,-8,"1,-19"
4701,720575940629172779,right,L4,90,-4,5,6,-1,"-4,5"
4702,720575940643778612,right,L4,91,-1,6,4,2,"-1,6"
4703,720575940633770029,right,L4,92,0,9,4,5,"0,9"
4704,720575940618383060,right,L4,93,-6,3,7,-4,"-6,3"
4705,720575940630197701,right,L4,94,5,18,4,14,"5,18"
4706,720575940628709628,right,L4,95,4,-21,-15,-6,"4,-21"
4707,720575940629494288,right,L4,96,1,-10,-6,-4,"1,-10"
4708,720575940627511960,right,L4,97,-5,2,6,-4,"-5,2"
4709,720575940628077762,right,L4,98,-1,-12,-5,-7,"-1,-12"
4710,720575940634276833,right,L4,99,4,15,3,12,"4,15"
4711,720575940612275685,right,L4,100,2,-10,-7,-3,"2,-10"
4712,720575940643439396,right,L4,101,-7,6,10,-4,"-7,6"
4713,720575940631046395,right,L4,102,3,13,3,10,"3,13"
4714,720575940618651170,right,L4,104,-1,-27,-13,-14,"-1,-27"
4715,720575940638494441,right,L4,105,3,22,8,14,"3,22"
4716,720575940627877960,right,L4,106,-7,11,12,-1,"-7,11"
4717,720575940635228579,right,L4,108,-3,-12,-3,-9,"-3,-12"
4718,720575940614365359,right,L4,109,4,-5,-7,2,"4,-5"
4719,720575940629191942,right,L4,110,-7,0,7,-7,"-7,0"
4720,720575940624670443,right,L4,111,2,-24,-14,-10,"2,-24"
4721,720575940636690551,right,L4,112,-6,1,6,-5,"-6,1"
4722,720575940607590322,right,L4,113,-2,4,4,0,"-2,4"
4723,720575940626236965,right,L4,114,2,-13,-9,-4,"2,-13"
4724,720575940618522397,right,L4,115,-4,2,5,-3,"-4,2"
4725,720575940635229859,right,L4,116,-1,-8,-3,-5,"-1,-8"
4726,720575940636291179,right,L4,117,-8,-2,7,-9,"-8,-2"
4727,720575940630172666,right,L4,118,3,1,-3,4,"3,1"
4728,720575940643826996,right,L4,119,-2,6,5,1,"-2,6"
4729,720575940626321701,right,L4,120,-1,-1,0,-1,"-1,-1"
4730,720575940626795364,right,L4,121,-8,4,10,-6,"-8,4"
4731,720575940635029399,right,L4,122,-5,9,9,0,"-5,9"
4732,720575940629865475,right,L4,123,-8,10,13,-3,"-8,10"
4733,720575940636786533,right,L4,124,1,-7,-5,-2,"1,-7"
4734,720575940629562668,right,L4,125,5,9,-1,10,"5,9"
4735,720575940637996451,right,L4,126,3,11,2,9,"3,11"
4736,720575940606013886,right,L4,127,0,15,7,8,"0,15"
4737,720575940623159465,right,L4,128,3,-22,-14,-8,"3,-22"
4738,720575940617536827,right,L4,129,0,-13,-7,-6,"0,-13"
4739,720575940627150467,right,L4,130,2,12,4,8,"2,12"
4740,720575940628589898,right,L4,131,-6,20,16,4,"-6,20"
4741,720575940633965026,right,L4,132,2,4,0,4,"2,4"
4742,720575940620396480,right,L4,134,-5,-18,-4,-14,"-5,-18"
4743,720575940627854973,right,L4,135,-3,-22,-8,-14,"-3,-22"
4744,720575940618135872,right,L4,136,0,3,1,2,"0,3"
4745,720575940630144962,right,L4,137,5,-7,-9,2,"5,-7"
4746,720575940620668498,right,L4,138,0,27,13,14,"0,27"
4747,720575940634551452,right,L4,139,1,-14,-8,-6,"1,-14"
4748,720575940637038734,right,L4,140,3,8,1,7,"3,8"
4749,720575940620651173,right,L4,142,-2,-18,-7,-11,"-2,-18"
4750,720575940640670579,right,L4,144,7,-11,-13,2,"7,-11"
4751,720575940629160491,right,L4,146,1,-6,-4,-2,"1,-6"
4752,720575940630848460,right,L4,147,1,21,9,12,"1,21"
4753,720575940621904618,right,L4,148,-7,-11,1,-12,"-7,-11"
4754,720575940630410487,right,L4,149,6,-14,-13,-1,"6,-14"
4755,720575940661057409,right,L4,150,-8,5,10,-5,"-8,5"
4756,720575940634258913,right,L4,152,3,-15,-11,-4,"3,-15"
4757,720575940615710431,right,L4,154,-8,0,8,-8,"-8,0"
4758,720575940623334732,right,L4,155,-8,13,14,-1,"-8,13"
4759,720575940632227897,right,L4,156,-9,1,9,-8,"-9,1"
4760,720575940625670477,right,L4,157,-1,-7,-3,-4,"-1,-7"
4761,720575940630507372,right,L4,158,3,-5,-6,1,"3,-5"
4762,720575940621757249,right,L4,159,7,7,-4,11,"7,7"
4763,720575940627692626,right,L4,160,-2,20,12,8,"-2,20"
4764,720575940603718316,right,L4,161,4,-14,-11,-3,"4,-14"
4765,720575940617989094,right,L4,162,-4,-2,3,-5,"-4,-2"
4766,720575940628621544,right,L4,163,-9,7,12,-5,"-9,7"
4767,720575940626322213,right,L4,164,-1,-2,0,-2,"-1,-2"
4768,720575940622516182,right,L4,165,4,16,4,12,"4,16"
4769,720575940628047944,right,L4,166,0,18,9,9,"0,18"
4770,720575940609694659,right,L4,167,0,-17,-9,-8,"0,-17"
4771,720575940641846747,right,L4,168,-1,17,9,8,"-1,17"
4772,720575940618859421,right,L4,169,0,-18,-9,-9,"0,-18"
4773,720575940606200352,right,L4,170,-5,1,5,-4,"-5,1"
4774,720575940622323440,right,L4,171,6,-20,-16,-4,"6,-20"
4775,720575940619909592,right,L4,172,1,22,10,12,"1,22"
4776,720575940609696963,right,L4,173,2,-25,-15,-10,"2,-25"
4777,720575940608806492,right,L4,174,4,-15,-12,-3,"4,-15"
4778,720575940634331503,right,L4,175,-6,-7,2,-9,"-6,-7"
4779,720575940623918104,right,L4,176,-2,13,8,5,"-2,13"
4780,720575940611917977,right,L4,177,-2,-1,1,-2,"-2,-1"
4781,720575940638521833,right,L4,178,2,11,3,8,"2,11"
4782,720575940629071771,right,L4,179,-5,-16,-3,-13,"-5,-16"
4783,720575940625883064,right,L4,180,2,-27,-16,-11,"2,-27"
4784,720575940615574239,right,L4,181,1,-4,-3,-1,"1,-4"
4785,720575940634701281,right,L4,182,7,-10,-12,2,"7,-10"
4786,720575940635156387,right,L4,183,-5,-15,-3,-12,"-5,-15"
4787,720575940640538765,right,L4,184,-6,-5,3,-8,"-6,-5"
4788,720575940628203336,right,L4,185,2,-11,-8,-3,"2,-11"
4789,720575940623237731,right,L4,186,-1,26,14,12,"-1,26"
4790,720575940627065899,right,L4,187,3,21,7,14,"3,21"
4791,720575940623927832,right,L4,188,-5,17,13,4,"-5,17"
4792,720575940629140423,right,L4,189,6,13,0,13,"6,13"
4793,720575940617815768,right,L4,190,-3,-5,0,-5,"-3,-5"
4794,720575940621284006,right,L4,191,-1,-11,-5,-6,"-1,-11"
4795,720575940621637033,right,L4,192,7,10,-2,12,"7,10"
4796,720575940630359749,right,L4,193,-5,4,7,-3,"-5,4"
4797,720575940612138725,right,L4,194,0,-5,-3,-2,"0,-5"
4798,720575940627517180,right,L4,195,-3,-1,2,-3,"-3,-1"
4799,720575940627061022,right,L4,196,-1,8,5,3,"-1,8"
4800,720575940610394436,right,L4,197,0,-20,-10,-10,"0,-20"
4801,720575940614283439,right,L4,199,0,-12,-6,-6,"0,-12"
4802,720575940627310697,right,L4,200,-5,12,11,1,"-5,12"
4803,720575940628849148,right,L4,201,-8,9,12,-3,"-8,9"
4804,720575940617142645,right,L4,202,-1,27,14,13,"-1,27"
4805,720575940613613795,right,L4,203,3,-1,-4,3,"3,-1"
4806,720575940609804612,right,L4,204,5,-2,-6,4,"5,-2"
4807,720575940618491220,right,L4,205,5,-6,-8,2,"5,-6"
4808,720575940635831647,right,L4,206,-3,5,5,0,"-3,5"
4809,720575940621260453,right,L4,208,5,-21,-16,-5,"5,-21"
4810,720575940650672374,right,L4,209,-3,-8,-1,-7,"-3,-8"
4811,720575940627904529,right,L4,210,-6,8,10,-2,"-6,8"
4812,720575940622201076,right,L4,212,2,-16,-10,-6,"2,-16"
4813,720575940615818764,right,L4,213,3,-4,-5,1,"3,-4"
4814,720575940631748427,right,L4,214,-5,3,6,-3,"-5,3"
4815,720575940619842469,right,L4,215,6,7,-3,10,"6,7"
4816,720575940614279599,right,L4,216,2,19,7,12,"2,19"
4817,720575940630118594,right,L4,218,2,10,3,7,"2,10"
4818,720575940624994708,right,L4,219,6,-4,-8,4,"6,-4"
4819,720575940627075912,right,L4,220,2,-6,-5,-1,"2,-6"
4820,720575940613112598,right,L4,221,-7,3,8,-5,"-7,3"
4821,720575940622534524,right,L4,222,-3,26,16,10,"-3,26"
4822,720575940629102974,right,L4,224,0,5,2,3,"0,5"
4823,720575940645348388,right,L4,225,2,-26,-15,-11,"2,-26"
4824,720575940626640113,right,L4,226,5,19,4,15,"5,19"
4825,720575940614578174,right,L4,228,-7,1,7,-6,"-7,1"
4826,720575940621989185,right,L4,229,5,2,-4,6,"5,2"
4827,720575940618365981,right,L4,230,2,9,2,7,"2,9"
4828,720575940607368201,right,L4,231,4,-12,-10,-2,"4,-12"
4829,720575940621762113,right,L4,232,-4,13,10,3,"-4,13"
4830,720575940646768675,right,L4,233,4,-13,-11,-2,"4,-13"
4831,720575940620126043,right,L4,234,1,3,0,3,"1,3"
4832,720575940616371485,right,L4,235,4,11,1,10,"4,11"
4833,720575940630640847,right,L4,236,-1,4,3,1,"-1,4"
4834,720575940645227300,right,L4,239,-6,6,9,-3,"-6,6"
4835,720575940626398922,right,L4,240,-4,-3,2,-5,"-4,-3"
4836,720575940628151300,right,L4,241,2,-17,-11,-6,"2,-17"
4837,720575940638920164,right,L4,242,-4,6,7,-1,"-4,6"
4838,720575940640047669,right,L4,243,-1,-21,-10,-11,"-1,-21"
4839,720575940628179968,right,L4,245,-5,-3,3,-6,"-5,-3"
4840,720575940632702035,right,L4,246,-4,15,11,4,"-4,15"
4841,720575940613247346,right,L4,247,-4,-15,-4,-11,"-4,-15"
4842,720575940634331759,right,L4,248,-6,0,6,-6,"-6,0"
4843,720575940636664183,right,L4,249,2,-12,-8,-4,"2,-12"
4844,720575940636668517,right,L4,250,-1,1,1,0,"-1,1"
4845,720575940611137723,right,L4,251,-1,-14,-6,-8,"-1,-14"
4846,720575940618761243,right,L4,252,3,23,8,15,"3,23"
4847,720575940615995398,right,L4,253,5,16,3,13,"5,16"
4848,720575940626873530,right,L4,255,-6,-13,-1,-12,"-6,-13"
4849,720575940614434479,right,L4,256,5,-20,-15,-5,"5,-20"
4850,720575940652862454,right,L4,257,2,21,8,13,"2,21"
4851,720575940622355973,right,L4,258,-4,-17,-5,-12,"-4,-17"
4852,720575940622738696,right,L4,259,-7,-5,4,-9,"-7,-5"
4853,720575940621793518,right,L4,260,-3,19,12,7,"-3,19"
4854,720575940630288758,right,L4,261,-1,13,7,6,"-1,13"
4855,720575940624231935,right,L4,262,1,-11,-7,-4,"1,-11"
4856,720575940631497209,right,L4,263,-3,4,5,-1,"-3,4"
4857,720575940619885958,right,L4,264,-1,-6,-2,-4,"-1,-6"
4858,720575940620314145,right,L4,265,-6,-1,5,-6,"-6,-1"
4859,720575940622785705,right,L4,266,-1,-25,-12,-13,"-1,-25"
4860,720575940618202013,right,L4,267,-6,2,7,-5,"-6,2"
4861,720575940613894381,right,L4,268,7,-6,-10,4,"7,-6"
4862,720575940631051515,right,L4,269,2,-19,-12,-7,"2,-19"
4863,720575940629825274,right,L4,270,1,-8,-5,-3,"1,-8"
4864,720575940609429717,right,L4,271,4,6,-1,7,"4,6"
4865,720575940617760861,right,L4,272,3,-2,-4,2,"3,-2"
4866,720575940618044417,right,L4,273,-6,23,17,6,"-6,23"
4867,720575940637170350,right,L4,275,-8,-1,7,-8,"-8,-1"
4868,720575940625665101,right,L4,276,2,3,-1,4,"2,3"
4869,720575940607738825,right,L4,277,7,-3,-9,6,"7,-3"
4870,720575940625397581,right,L4,278,-5,10,10,0,"-5,10"
4871,720575940614276845,right,L4,279,-4,8,8,0,"-4,8"
4872,720575940610678392,right,L4,280,-6,-14,-1,-13,"-6,-14"
4873,720575940606185602,right,L4,281,-9,2,10,-8,"-9,2"
4874,720575940604213937,right,L4,284,0,25,12,13,"0,25"
4875,720575940627176478,right,L4,285,6,-18,-15,-3,"6,-18"
4876,720575940628898103,right,L4,286,0,-24,-12,-12,"0,-24"
4877,720575940625287497,right,L4,287,-5,13,11,2,"-5,13"
4878,720575940619299275,right,L4,289,-1,11,6,5,"-1,11"
4879,720575940612028110,right,L4,290,5,-24,-17,-7,"5,-24"
4880,720575940632396050,right,L4,291,7,2,-6,8,"7,2"
4881,720575940618066461,right,L4,293,4,-17,-13,-4,"4,-17"
4882,720575940619342390,right,L4,294,1,-20,-11,-9,"1,-20"
4883,720575940625332199,right,L4,295,-2,29,16,13,"-2,29"
4884,720575940630937391,right,L4,296,1,-18,-10,-8,"1,-18"
4885,720575940638728420,right,L4,297,7,-9,-12,3,"7,-9"
4886,720575940635048811,right,L4,298,-5,5,7,-2,"-5,5"
4887,720575940623730314,right,L4,299,-4,12,10,2,"-4,12"
4888,720575940632342412,right,L4,300,4,-18,-13,-5,"4,-18"
4889,720575940640802904,right,L4,301,-5,16,13,3,"-5,16"
4890,720575940623581439,right,L4,302,2,17,6,11,"2,17"
4891,720575940637838558,right,L4,303,-5,22,16,6,"-5,22"
4892,720575940630836956,right,L4,304,6,5,-4,9,"6,5"
4893,720575940605254880,right,L4,305,-7,4,9,-5,"-7,4"
4894,720575940611510234,right,L4,306,3,7,0,7,"3,7"
4895,720575940618481947,right,L4,308,-5,8,9,-1,"-5,8"
4896,720575940634313884,right,L4,309,-6,12,12,0,"-6,12"
4897,720575940630643650,right,L4,310,2,22,9,13,"2,22"
4898,720575940633964770,right,L4,311,-7,15,14,1,"-7,15"
4899,720575940609347029,right,L4,312,4,-7,-8,1,"4,-7"
4900,720575940629365504,right,L4,313,7,3,-6,9,"7,3"
4901,720575940625144905,right,L4,314,-9,5,11,-6,"-9,5"
4902,720575940637566030,right,L4,315,-3,-6,0,-6,"-3,-6"
4903,720575940632839394,right,L4,316,5,-4,-7,3,"5,-4"
4904,720575940635184547,right,L4,317,-5,-4,3,-7,"-5,-4"
4905,720575940625421500,right,L4,318,4,-19,-14,-5,"4,-19"
4906,720575940632696899,right,L4,319,-2,5,4,1,"-2,5"
4907,720575940634731631,right,L4,320,-2,-5,-1,-4,"-2,-5"
4908,720575940623028250,right,L4,321,8,4,-6,10,"8,4"
4909,720575940627580029,right,L4,322,2,26,11,15,"2,26"
4910,720575940628356593,right,L4,323,-7,-13,0,-13,"-7,-13"
4911,720575940632957727,right,L4,324,3,24,9,15,"3,24"
4912,720575940620406699,right,L4,325,5,1,-5,6,"5,1"
4913,720575940626213008,right,L4,326,2,16,6,10,"2,16"
4914,720575940622185654,right,L4,327,5,3,-4,7,"5,3"
4915,720575940636363188,right,L4,328,5,-9,-10,1,"5,-9"
4916,720575940646136686,right,L4,329,0,24,12,12,"0,24"
4917,720575940639975485,right,L4,330,3,3,-2,5,"3,3"
4918,720575940614428335,right,L4,331,1,-15,-9,-6,"1,-15"
4919,720575940631577595,right,L4,332,4,-26,-17,-9,"4,-26"
4920,720575940619218752,right,L4,333,0,-21,-11,-10,"0,-21"
4921,720575940635599211,right,L4,334,1,-26,-14,-12,"1,-26"
4922,720575940617540667,right,L4,335,2,8,2,6,"2,8"
4923,720575940630421036,right,L4,336,0,23,11,12,"0,23"
4924,720575940634729870,right,L4,337,-5,-6,2,-8,"-5,-6"
4925,720575940643664948,right,L4,338,-1,0,1,-1,"-1,0"
4926,720575940614965650,right,L4,341,6,-17,-15,-2,"6,-17"
4927,720575940604960992,right,L4,342,2,-15,-10,-5,"2,-15"
4928,720575940621548370,right,L4,343,-3,27,16,11,"-3,27"
4929,720575940622058623,right,L4,344,-2,-15,-6,-9,"-2,-15"
4930,720575940623407309,right,L4,345,3,-12,-9,-3,"3,-12"
4931,720575940631685903,right,L4,346,-7,-9,2,-11,"-7,-9"
4932,720575940613683427,right,L4,347,-5,-13,-2,-11,"-5,-13"
4933,720575940631343813,right,L4,348,3,14,4,10,"3,14"
4934,720575940634391265,right,L4,349,-5,-14,-2,-12,"-5,-14"
4935,720575940617146454,right,L4,350,1,15,6,9,"1,15"
4936,720575940616914482,right,L4,351,-1,-17,-8,-9,"-1,-17"
4937,720575940625432299,right,L4,352,-2,28,16,12,"-2,28"
4938,720575940630855735,right,L4,353,2,24,10,14,"2,24"
4939,720575940630564090,right,L4,354,-2,-26,-11,-15,"-2,-26"
4940,720575940615186315,right,L4,355,-7,-6,4,-10,"-7,-6"
4941,720575940624331593,right,L4,356,0,22,11,11,"0,22"
4942,720575940633446507,right,L4,357,4,17,4,13,"4,17"
4943,720575940627181828,right,L4,358,-3,17,11,6,"-3,17"
4944,720575940621082049,right,L4,359,2,23,9,14,"2,23"
4945,720575940645803630,right,L4,360,-5,19,14,5,"-5,19"
4946,720575940615007399,right,L4,361,0,-7,-4,-3,"0,-7"
4947,720575940618176315,right,L4,362,2,-20,-12,-8,"2,-20"
4948,720575940624024102,right,L4,363,7,-4,-9,5,"7,-4"
4949,720575940608595209,right,L4,364,4,4,-2,6,"4,4"
4950,720575940620818358,right,L4,365,4,7,-1,8,"4,7"
4951,720575940620277720,right,L4,367,-6,-15,-2,-13,"-6,-15"
4952,720575940624556436,right,L4,369,5,-5,-8,3,"5,-5"
4953,720575940609034761,right,L4,370,-3,21,13,8,"-3,21"
4954,720575940641484496,right,L4,371,6,-5,-9,4,"6,-5"
4955,720575940618290649,right,L4,372,1,-2,-2,0,"1,-2"
4956,720575940618278996,right,L4,373,1,-21,-12,-9,"1,-21"
4957,720575940612826085,right,L4,374,2,13,4,9,"2,13"
4958,720575940620786113,right,L4,375,-6,7,9,-2,"-6,7"
4959,720575940630980859,right,L4,376,-7,-10,2,-12,"-7,-10"
4960,720575940620058539,right,L4,377,0,7,3,4,"0,7"
4961,720575940623313677,right,L4,378,-3,18,12,6,"-3,18"
4962,720575940627612181,right,L4,379,3,-17,-12,-5,"3,-17"
4963,720575940647636020,right,L4,380,-1,29,15,14,"-1,29"
4964,720575940638062141,right,L4,381,-8,-9,3,-12,"-8,-9"
4965,720575940628649237,right,L4,382,3,-6,-6,0,"3,-6"
4966,720575940642792589,right,L4,383,-6,11,11,0,"-6,11"
4967,720575940621297944,right,L4,384,-6,-2,5,-7,"-6,-2"
4968,720575940642460635,right,L4,385,-3,-18,-6,-12,"-3,-18"
4969,720575940617195147,right,L4,386,-6,19,15,4,"-6,19"
4970,720575940631117568,right,L4,387,-1,-15,-7,-8,"-1,-15"
4971,720575940616676806,right,L4,389,-6,-16,-2,-14,"-6,-16"
4972,720575940623640653,right,L4,390,-6,-9,1,-10,"-6,-9"
4973,720575940629320236,right,L4,391,4,-3,-6,3,"4,-3"
4974,720575940620652564,right,L4,392,-4,7,7,0,"-4,7"
4975,720575940619321965,right,L4,394,-7,-8,3,-11,"-7,-8"
4976,720575940628114344,right,L4,395,0,-22,-11,-11,"0,-22"
4977,720575940621062986,right,L4,396,-1,10,6,4,"-1,10"
4978,720575940619742561,right,L4,397,-3,-19,-7,-12,"-3,-19"
4979,720575940625599420,right,L4,399,-4,-24,-8,-16,"-4,-24"
4980,720575940629330537,right,L4,400,1,-29,-16,-13,"1,-29"
4981,720575940625098388,right,L4,401,-2,-19,-8,-11,"-2,-19"
4982,720575940609015644,right,L4,402,3,26,10,16,"3,26"
4983,720575940623793290,right,L4,403,-2,-12,-4,-8,"-2,-12"
4984,720575940606469250,right,L4,404,-1,20,11,9,"-1,20"
4985,720575940617734612,right,L4,405,3,10,2,8,"3,10"
4986,720575940615872927,right,L4,406,1,-25,-14,-11,"1,-25"
4987,720575940614083596,right,L4,407,-5,-10,0,-10,"-5,-10"
4988,720575940640052699,right,L4,408,-6,-4,4,-8,"-6,-4"
4989,720575940626752770,right,L4,409,0,-3,-2,-1,"0,-3"
4990,720575940622628476,right,L4,410,-2,-2,1,-3,"-2,-2"
4991,720575940620174808,right,L4,412,-6,21,16,5,"-6,21"
4992,720575940642568864,right,L4,413,-2,-7,-2,-5,"-2,-7"
4993,720575940639081030,right,L4,414,4,21,6,15,"4,21"
4994,720575940638968016,right,L4,415,6,12,0,12,"6,12"
4995,720575940632618067,right,L4,416,3,-8,-7,-1,"3,-8"
4996,720575940627146283,right,L4,417,-6,-10,1,-11,"-6,-10"
4997,720575940605411244,right,L4,418,-2,15,9,6,"-2,15"
4998,720575940628561095,right,L4,419,-3,-11,-3,-8,"-3,-11"
4999,720575940630638044,right,L4,420,6,-3,-8,5,"6,-3"
5000,720575940626575716,right,L4,422,-7,-4,5,-9,"-7,-4"
5001,720575940607985330,right,L4,423,3,-18,-12,-6,"3,-18"
5002,720575940646668323,right,L4,424,-3,-2,2,-4,"-3,-2"
5003,720575940609758403,right,L4,425,3,20,7,13,"3,20"
5004,720575940621756276,right,L4,426,-3,0,3,-3,"-3,0"
5005,720575940618814277,right,L4,427,5,-18,-14,-4,"5,-18"
5006,720575940623839782,right,L4,428,-2,23,13,10,"-2,23"
5007,720575940608985867,right,L4,429,-2,14,9,5,"-2,14"
5008,720575940612298536,right,L4,430,-3,-7,-1,-6,"-3,-7"
5009,720575940625039764,right,L4,431,-2,-10,-3,-7,"-2,-10"
5010,720575940616206534,right,L4,432,-5,7,8,-1,"-5,7"
5011,720575940620125387,right,L4,433,0,-8,-4,-4,"0,-8"
5012,720575940636414831,right,L4,435,5,-17,-14,-3,"5,-17"
5013,720575940620585094,right,L4,436,0,-15,-8,-7,"0,-15"
5014,720575940630431532,right,L4,437,-3,12,9,3,"-3,12"
5015,720575940635232163,right,L4,439,-3,-9,-2,-7,"-3,-9"
5016,720575940606082750,right,L4,440,1,23,10,13,"1,23"
5017,720575940617986589,right,L4,441,3,-16,-11,-5,"3,-16"
5018,720575940630428716,right,L4,442,-5,25,17,8,"-5,25"
5019,720575940624038122,right,L4,443,-6,4,8,-4,"-6,4"
5020,720575940623675613,right,L4,444,4,-10,-9,-1,"4,-10"
5021,720575940643863092,right,L4,445,-2,8,6,2,"-2,8"
5022,720575940620965741,right,L4,446,2,-14,-9,-5,"2,-14"
5023,720575940621087514,right,L4,447,-1,2,2,0,"-1,2"
5024,720575940616636940,right,L4,448,0,30,15,15,"0,30"
5025,720575940625301799,right,L4,449,6,-16,-14,-2,"6,-16"
5026,720575940633515603,right,L4,450,2,-9,-7,-2,"2,-9"
5027,720575940627760186,right,L4,452,1,-9,-6,-3,"1,-9"
5028,720575940614228530,right,L4,453,3,25,9,16,"3,25"
5029,720575940637073582,right,L4,454,5,-12,-11,-1,"5,-12"
5030,720575940647081251,right,L4,455,7,-7,-11,4,"7,-7"
5031,720575940631861266,right,L4,456,0,21,10,11,"0,21"
5032,720575940622869462,right,L4,457,-2,17,10,7,"-2,17"
5033,720575940621141851,right,L4,458,5,0,-5,5,"5,0"
5034,720575940633767836,right,L4,459,5,-3,-7,4,"5,-3"
5035,720575940621278401,right,L4,460,-3,-20,-7,-13,"-3,-20"
5036,720575940614590957,right,L4,461,7,-5,-10,5,"7,-5"
5037,720575940626403842,right,L4,462,-1,18,10,8,"-1,18"
5038,720575940629316099,right,L4,463,5,17,3,14,"5,17"
5039,720575940627883025,right,L4,464,4,0,-4,4,"4,0"
5040,720575940614031614,right,L4,465,3,0,-3,3,"3,0"
5041,720575940621418155,right,L4,466,1,14,6,8,"1,14"
5042,720575940645799022,right,L4,467,-2,-20,-8,-12,"-2,-20"
5043,720575940629597169,right,L4,468,-3,11,8,3,"-3,11"
5044,720575940611502546,right,L4,469,-7,13,13,0,"-7,13"
5045,720575940613087510,right,L4,470,4,-9,-9,0,"4,-9"
5046,720575940617477009,right,L4,471,3,-26,-16,-10,"3,-26"
5047,720575940632585287,right,L4,472,1,25,11,14,"1,25"
5048,720575940636965477,right,L4,473,-4,23,15,8,"-4,23"
5049,720575940641261008,right,L4,474,-3,-17,-6,-11,"-3,-17"
5050,720575940612375002,right,L4,475,-4,-1,3,-4,"-4,-1"
5051,720575940626851831,right,L4,476,-1,15,8,7,"-1,15"
5052,720575940612606899,right,L4,477,-3,2,4,-2,"-3,2"
5053,720575940618794141,right,L4,478,-7,16,15,1,"-7,16"
5054,720575940629311747,right,L4,479,-2,10,7,3,"-2,10"
5055,720575940631471890,right,L4,481,4,-8,-8,0,"4,-8"
5056,720575940619344438,right,L4,482,1,17,7,10,"1,17"
5057,720575940623192105,right,L4,483,2,-7,-6,-1,"2,-7"
5058,720575940608677724,right,L4,484,3,-9,-8,-1,"3,-9"
5059,720575940607211977,right,L4,485,-3,-3,1,-4,"-3,-3"
5060,720575940620768080,right,L4,486,0,1,0,1,"0,1"
5061,720575940619753057,right,L4,487,1,-1,-2,1,"1,-1"
5062,720575940631539852,right,L4,488,7,5,-5,10,"7,5"
5063,720575940611541939,right,L4,489,-3,10,8,2,"-3,10"
5064,720575940614436147,right,L4,492,-7,-2,6,-8,"-7,-2"
5065,720575940621926753,right,L4,493,-3,23,14,9,"-3,23"
5066,720575940642375925,right,L4,494,0,29,14,15,"0,29"
5067,720575940612423026,right,L4,495,4,5,-2,7,"4,5"
5068,720575940605786656,right,L4,497,6,1,-6,7,"6,1"
5069,720575940645157320,right,L4,498,6,10,-1,11,"6,10"
5070,720575940620439209,right,L4,499,5,10,0,10,"5,10"
5071,720575940610484036,right,L4,500,7,-8,-11,3,"7,-8"
5072,720575940611413858,right,L4,501,1,2,0,2,"1,2"
5073,720575940626406087,right,L4,502,5,8,-1,9,"5,8"
5074,720575940637678558,right,L4,503,3,17,5,12,"3,17"
5075,720575940621204941,right,L4,504,-2,9,6,3,"-2,9"
5076,720575940632505903,right,L4,506,1,-12,-7,-5,"1,-12"
5077,720575940636233208,right,L4,507,-5,-12,-1,-11,"-5,-12"
5078,720575940624318135,right,L4,508,-5,11,10,1,"-5,11"
5079,720575940609852427,right,L4,509,-4,10,9,1,"-4,10"
5080,720575940605116640,right,L4,510,-2,11,7,4,"-2,11"
5081,720575940645955694,right,L4,511,5,-11,-11,0,"5,-11"
5082,720575940607693442,right,L4,512,6,0,-6,6,"6,0"
5083,720575940616514354,right,L4,513,-4,-13,-3,-10,"-4,-13"
5084,720575940603987390,right,L4,514,-4,-10,-1,-9,"-4,-10"
5085,720575940626857065,right,L4,515,-8,-7,4,-11,"-8,-7"
5086,720575940635621783,right,L4,517,6,3,-5,8,"6,3"
5087,720575940640194392,right,L4,518,-4,22,15,7,"-4,22"
5088,720575940610409946,right,L4,519,-5,-5,2,-7,"-5,-5"
5089,720575940639783101,right,L4,520,-2,-22,-9,-13,"-2,-22"
5090,720575940627388029,right,L4,521,6,-9,-11,2,"6,-9"
5091,720575940627264002,right,L4,522,-4,0,4,-4,"-4,0"
5092,720575940616763509,right,L4,523,2,14,5,9,"2,14"
5093,720575940622816332,right,L4,524,4,-20,-14,-6,"4,-20"
5094,720575940617739357,right,L4,525,-1,-20,-9,-11,"-1,-20"
5095,720575940626144574,right,L4,526,0,-10,-5,-5,"0,-10"
5096,720575940635224995,right,L4,527,-4,-8,0,-8,"-4,-8"
5097,720575940612741338,right,L4,528,2,7,1,6,"2,7"
5098,720575940629431034,right,L4,529,2,-2,-3,1,"2,-2"
5099,720575940645053732,right,L4,530,-3,-13,-4,-9,"-3,-13"
5100,720575940645631524,right,L4,531,1,0,-1,1,"1,0"
5101,720575940659648641,right,L4,532,-8,7,11,-4,"-8,7"
5102,720575940629192747,right,L4,533,0,-16,-8,-8,"0,-16"
5103,720575940647887236,right,L4,534,3,2,-2,4,"3,2"
5104,720575940610289250,right,L4,536,3,4,-1,5,"3,4"
5105,720575940619439936,right,L4,537,0,-23,-12,-11,"0,-23"
5106,720575940614732798,right,L4,538,-4,1,4,-3,"-4,1"
5107,720575940628011602,right,L4,539,-6,15,13,2,"-6,15"
5108,720575940633375405,right,L4,540,-2,-9,-3,-6,"-2,-9"
5109,720575940610278724,right,L4,541,-4,14,11,3,"-4,14"
5110,720575940622298793,right,L4,542,6,-13,-13,0,"6,-13"
5111,720575940635238307,right,L4,543,-1,-4,-1,-3,"-1,-4"
5112,720575940616978518,right,L4,544,3,-13,-10,-3,"3,-13"
5113,720575940655390113,right,L4,545,5,11,0,11,"5,11"
5114,720575940625282236,right,L4,546,3,6,0,6,"3,6"
5115,720575940627708779,right,L4,547,-1,21,11,10,"-1,21"
5116,720575940621475949,right,L4,548,1,-16,-9,-7,"1,-16"
5117,720575940622006192,right,L4,549,0,-9,-5,-4,"0,-9"
5118,720575940612608741,right,L4,550,-2,3,3,0,"-2,3"
5119,720575940628587324,right,L4,551,-4,-9,-1,-8,"-4,-9"
5120,720575940613924589,right,L4,552,4,-1,-5,4,"4,-1"
5121,720575940640122421,right,L4,553,-3,16,11,5,"-3,16"
5122,720575940642163957,right,L4,555,-4,9,8,1,"-4,9"
5123,720575940622097012,right,L4,556,0,10,5,5,"0,10"
5124,720575940635730527,right,L4,557,6,-10,-11,1,"6,-10"
5125,720575940631152847,right,L4,558,-4,-21,-7,-14,"-4,-21"
5126,720575940620851392,right,L4,559,-6,22,17,5,"-6,22"
5127,720575940608805827,right,L4,560,-7,14,14,0,"-7,14"
5128,720575940629902096,right,L4,561,5,7,-2,9,"5,7"
5129,720575940618927451,right,L4,562,-5,-2,4,-6,"-5,-2"
5130,720575940620623307,right,L4,563,5,-13,-12,-1,"5,-13"
5131,720575940639962429,right,L4,564,3,-23,-15,-8,"3,-23"
5132,720575940626225229,right,L4,565,0,-26,-13,-13,"0,-26"
5133,720575940629642907,right,L4,567,-2,22,13,9,"-2,22"
5134,720575940624418110,right,L4,568,-6,-8,2,-10,"-6,-8"
5135,720575940614742447,right,L4,570,2,25,10,15,"2,25"
5136,720575940631689901,right,L4,571,0,-14,-7,-7,"0,-14"
5137,720575940626423580,right,L4,572,-8,3,9,-6,"-8,3"
5138,720575940627817800,right,L4,573,4,14,3,11,"4,14"
5139,720575940629302910,right,L4,574,-6,5,8,-3,"-6,5"
5140,720575940651798262,right,L4,575,6,9,-2,11,"6,9"
5141,720575940632216643,right,L4,576,0,28,14,14,"0,28"
5142,720575940638344026,right,L4,577,5,-14,-12,-2,"5,-14"
5143,720575940618922309,right,L4,578,4,-11,-10,-1,"4,-11"
5144,720575940644179656,right,L4,579,-3,-10,-2,-8,"-3,-10"
5145,720575940621284011,right,L4,580,-2,-23,-10,-13,"-2,-23"
5146,720575940632713247,right,L4,581,3,9,1,8,"3,9"
5147,720575940617689995,right,L4,582,-1,23,12,11,"-1,23"
5148,720575940640661923,right,L4,583,3,-25,-16,-9,"3,-25"
5149,720575940629930831,right,L4,584,4,23,7,16,"4,23"
5150,720575940634309401,right,L4,585,-1,-23,-11,-12,"-1,-23"
5151,720575940607265237,right,L4,586,2,18,7,11,"2,18"
5152,720575940628072458,right,L4,588,1,4,1,3,"1,4"
5153,720575940609638339,right,L4,589,-1,-5,-2,-3,"-1,-5"
5154,720575940624294069,right,L4,590,1,9,3,6,"1,9"
5155,720575940628370960,right,L4,591,3,-3,-5,2,"3,-3"
5156,720575940639611957,right,L4,593,3,-14,-10,-4,"3,-14"
5157,720575940622752332,right,L4,595,7,-12,-13,1,"7,-12"
5158,720575940632634252,right,L4,596,-4,-16,-4,-12,"-4,-16"
5159,720575940633537505,right,L4,597,4,1,-4,5,"4,1"
5160,720575940623560328,right,L4,598,2,-18,-11,-7,"2,-18"
5161,720575940623922952,right,L4,599,-1,9,5,4,"-1,9"
5162,720575940606009446,right,L4,600,3,-10,-8,-2,"3,-10"
5163,720575940612338289,right,L4,601,1,16,7,9,"1,16"
5164,720575940617281373,right,L4,602,4,-2,-5,3,"4,-2"
5165,720575940620969637,right,L4,603,-3,-23,-9,-14,"-3,-23"
5166,720575940623627229,right,L4,604,-6,-17,-3,-14,"-6,-17"
5167,720575940637306677,right,L4,605,3,15,4,11,"3,15"
5168,720575940626316730,right,L4,607,1,18,8,10,"1,18"
5169,720575940609503189,right,L4,608,1,10,4,6,"1,10"
5170,720575940622473991,right,L4,609,-2,0,2,-2,"-2,0"
5171,720575940634256354,right,L4,610,2,-23,-14,-9,"2,-23"
5172,720575940631319377,right,L4,611,-1,-18,-8,-10,"-1,-18"
5173,720575940632894535,right,L4,612,-3,-26,-10,-16,"-3,-26"
5174,720575940634330991,right,L4,613,-8,-4,6,-10,"-8,-4"
5175,720575940635232931,right,L4,614,-2,-8,-2,-6,"-2,-8"
5176,720575940626085519,right,L4,615,-7,-7,3,-10,"-7,-7"
5177,720575940624763796,right,L4,616,-3,15,10,5,"-3,15"
5178,720575940627703897,right,L4,617,-2,-17,-7,-10,"-2,-17"
5179,720575940627784266,right,L4,618,-1,24,13,11,"-1,24"
5180,720575940605544108,right,L4,619,-4,-19,-6,-13,"-4,-19"
5181,720575940631226711,right,L4,620,7,1,-7,8,"7,1"
5182,720575940623822474,right,L4,621,1,24,11,13,"1,24"
5183,720575940633093459,right,L4,622,-5,20,15,5,"-5,20"
5184,720575940622409195,right,L4,623,1,13,5,8,"1,13"
5185,720575940627535961,right,L4,624,1,-17,-10,-7,"1,-17"
5186,720575940613600227,right,L4,625,-2,24,14,10,"-2,24"
5187,720575940617211806,right,L4,626,-5,-8,1,-9,"-5,-8"
5188,720575940611972302,right,L4,627,0,-1,-1,0,"0,-1"
5189,720575940655029921,right,L4,628,0,0,0,0,"0,0"
5190,720575940630424108,right,L4,629,4,24,8,16,"4,24"
5191,720575940627762053,right,L4,630,4,8,0,8,"4,8"
5192,720575940615083154,right,L4,631,1,26,12,14,"1,26"
5193,720575940632961932,right,L4,632,3,-20,-13,-7,"3,-20"
5194,720575940609099529,right,L4,633,-1,-24,-11,-13,"-1,-24"
5195,720575940626107696,right,L4,635,6,-6,-9,3,"6,-6"
5196,720575940631454312,right,L4,636,0,6,3,3,"0,6"
5197,720575940627999570,right,L4,637,3,-21,-14,-7,"3,-21"
5198,720575940626325029,right,L4,639,-4,19,13,6,"-4,19"
5199,720575940624126954,right,L4,640,-1,-16,-7,-9,"-1,-16"
5200,720575940624939928,right,L4,642,-5,-11,-1,-10,"-5,-11"
5201,720575940628638167,right,L4,643,6,14,1,13,"6,14"
5202,720575940632394380,right,L4,644,-6,18,15,3,"-6,18"
5203,720575940639597877,right,L4,646,6,17,2,15,"6,17"
5204,720575940635230627,right,L4,647,-4,-7,0,-7,"-4,-7"
5205,720575940631283543,right,L4,648,1,7,2,5,"1,7"
5206,720575940638733109,right,L4,649,-1,5,3,2,"-1,5"
5207,720575940624425107,right,L4,650,-3,-25,-10,-15,"-3,-25"
5208,720575940635170211,right,L4,651,-4,-5,1,-6,"-4,-5"
5209,720575940635141795,right,L4,652,-6,-11,0,-11,"-6,-11"
5210,720575940627260426,right,L4,653,-6,-12,0,-12,"-6,-12"
5211,720575940624297608,right,L4,654,-3,8,7,1,"-3,8"
5212,720575940606382257,right,L4,655,6,-1,-7,6,"6,-1"
5213,720575940632264531,right,L4,656,0,-11,-6,-5,"0,-11"
5214,720575940628637973,right,L4,657,-2,-25,-11,-14,"-2,-25"
5215,720575940620320336,right,L4,658,1,20,9,11,"1,20"
5216,720575940635172003,right,L4,659,-4,-6,1,-7,"-4,-6"
5217,720575940636695919,right,L4,660,2,28,12,16,"2,28"
5218,720575940633224237,right,L4,661,-3,14,10,4,"-3,14"
5219,720575940631644178,right,L4,662,2,-1,-3,2,"2,-1"
5220,720575940622078725,right,L4,663,0,8,4,4,"0,8"
5221,720575940623292381,right,L4,664,1,-27,-15,-12,"1,-27"
5222,720575940632353351,right,L4,665,7,-2,-8,6,"7,-2"
5223,720575940605986336,right,L4,667,1,-28,-15,-13,"1,-28"
5224,720575940635073131,right,L4,668,1,19,8,11,"1,19"
5225,720575940633938713,right,L4,669,4,-16,-12,-4,"4,-16"
5226,720575940631974687,right,L4,670,5,5,-3,8,"5,5"
5227,720575940627430296,right,L4,671,-4,-23,-8,-15,"-4,-23"
5228,720575940613115877,right,L4,672,-8,11,13,-2,"-8,11"
5229,720575940629101386,right,L4,673,2,5,0,5,"2,5"
5230,720575940616122402,right,L4,674,-4,-14,-3,-11,"-4,-14"
5231,720575940610975044,right,L4,675,-7,19,16,3,"-7,19"
5232,720575940637300621,right,L4,676,-3,-21,-8,-13,"-3,-21"
5233,720575940628722438,right,L4,677,0,11,5,6,"0,11"
5234,720575940646776611,right,L4,678,3,-7,-7,0,"3,-7"
5235,720575940628899323,right,L4,679,4,18,5,13,"4,18"
5236,720575940627580541,right,L4,681,-2,-21,-9,-12,"-2,-21"
5237,720575940609347541,right,L4,682,6,-8,-10,2,"6,-8"
5238,720575940619636871,right,L4,683,2,6,1,5,"2,6"
5239,720575940617056724,right,L4,684,-6,17,14,3,"-6,17"
5240,720575940627005443,right,L4,685,-5,-9,0,-9,"-5,-9"
5241,720575940624740075,right,L4,686,5,-22,-16,-6,"5,-22"
5242,720575940613009298,right,L4,687,-6,-3,4,-7,"-6,-3"
5243,720575940637280430,right,L4,688,-7,10,12,-2,"-7,10"
5244,720575940615637983,right,L4,689,-2,18,11,7,"-2,18"
5245,720575940616984374,right,L4,690,-7,-3,5,-8,"-7,-3"
5246,720575940618582785,right,L4,691,-9,4,11,-7,"-9,4"
5247,720575940605811046,right,L4,692,-4,24,16,8,"-4,24"
5248,720575940637665136,right,L4,693,-3,25,15,10,"-3,25"
5249,720575940622463220,right,L4,694,4,3,-3,6,"4,3"
5250,720575940651951350,right,L4,695,-6,10,11,-1,"-6,10"
5251,720575940623732991,right,L4,696,-2,16,10,6,"-2,16"
5252,720575940635826539,right,L4,697,1,-22,-12,-10,"1,-22"
5253,720575940628568650,right,L4,698,6,-7,-10,3,"6,-7"
5254,720575940631364828,right,L4,699,-5,0,5,-5,"-5,0"
5255,720575940620042712,right,L4,700,5,15,2,13,"5,15"
5256,720575940619590104,right,L4,701,0,-4,-2,-2,"0,-4"
5257,720575940640498651,right,L4,702,-5,23,16,7,"-5,23"
5258,720575940631549125,right,L4,703,-3,1,3,-2,"-3,1"
5259,720575940629281795,right,L4,704,-7,8,11,-3,"-7,8"
5260,720575940654890145,right,L4,705,1,1,-1,2,"1,1"
5261,720575940624153880,right,L4,706,-7,-12,1,-13,"-7,-12"
5262,720575940623597592,right,L4,709,-2,-24,-10,-14,"-2,-24"
5263,720575940640158781,right,L4,710,4,-25,-17,-8,"4,-25"
5264,720575940635470443,right,L4,711,-1,19,10,9,"-1,19"
5265,720575940627154178,right,L4,712,-7,12,13,-1,"-7,12"
5266,720575940629899011,right,L4,713,-6,16,14,2,"-6,16"
5267,720575940615458060,right,L4,714,5,12,1,11,"5,12"
5268,720575940627739978,right,L4,715,4,10,1,9,"4,10"
5269,720575940628570442,right,L4,716,4,-6,-7,1,"4,-6"
5270,720575940614390782,right,L4,717,2,-22,-13,-9,"2,-22"
5271,720575940625066248,right,L4,719,1,27,12,15,"1,27"
5272,720575940637660382,right,L4,722,6,-15,-14,-1,"6,-15"
5273,720575940638738035,right,L4,723,-2,-11,-4,-7,"-2,-11"
5274,720575940632914719,right,L4,724,4,2,-3,5,"4,2"
5275,720575940614313709,right,L4,725,-3,-24,-9,-15,"-3,-24"
5276,720575940606067628,right,L4,726,2,-28,-16,-12,"2,-28"
5277,720575940616692274,right,L4,727,7,6,-4,10,"7,6"
5278,720575940626983882,right,L4,728,7,12,-1,13,"7,12"
5279,720575940621731009,right,L4,729,-3,29,17,12,"-3,29"
5280,720575940639384920,right,L4,731,-6,9,10,-1,"-6,9"
5281,720575940627713532,right,L4,732,-3,6,6,0,"-3,6"
5282,720575940653188854,right,L4,733,-5,-17,-4,-13,"-5,-17"
5283,720575940611716570,right,L4,734,2,0,-2,2,"2,0"
5284,720575940614391038,right,L4,735,1,-23,-13,-10,"1,-23"
5285,720575940626740068,right,L4,736,-8,1,8,-7,"-8,1"
5286,720575940655273889,right,L4,737,0,19,9,10,"0,19"
5287,720575940627718738,right,L4,738,-3,13,9,4,"-3,13"
5288,720575940617861561,right,L4,740,2,-8,-6,-2,"2,-8"
5289,720575940617613017,right,L4,741,-2,-14,-5,-9,"-2,-14"
5290,720575940623103843,right,L4,742,-4,11,9,2,"-4,11"
5291,720575940624709193,right,L4,743,6,-19,-16,-3,"6,-19"
5292,720575940624739819,right,L4,744,-4,25,16,9,"-4,25"
5293,720575940619290944,right,L4,745,0,13,6,7,"0,13"
5294,720575940630927222,right,L4,746,-3,3,4,-1,"-3,3"
5295,720575940617041553,right,L4,747,0,2,1,1,"0,2"
5296,720575940621866643,right,L4,749,-2,1,2,-1,"-2,1"
5297,720575940633829331,right,L4,750,4,-24,-16,-8,"4,-24"
5298,720575940618297428,right,L4,753,-3,24,15,9,"-3,24"
5299,720575940625682765,right,L4,754,-1,-13,-6,-7,"-1,-13"
5300,720575940627407000,right,L4,755,4,19,5,14,"4,19"
5301,720575940635287450,right,L4,756,5,20,5,15,"5,20"
5302,720575940613286117,right,L4,757,0,-6,-3,-3,"0,-6"
5303,720575940624578540,right,L4,758,5,-1,-6,5,"5,-1"
5304,720575940614120671,right,L4,759,7,14,0,14,"7,14"
5305,720575940621040244,right,L4,760,0,17,8,9,"0,17"
5306,720575940625464807,right,L4,761,-4,-18,-5,-13,"-4,-18"
5307,720575940612365937,right,L4,762,0,14,7,7,"0,14"
5308,720575940615206055,right,L4,763,-5,14,12,2,"-5,14"
5309,720575940637841520,right,L4,765,-3,9,7,2,"-3,9"
5310,720575940631575916,right,L4,766,2,-4,-4,0,"2,-4"
5311,720575940614342381,right,L4,768,3,5,-1,6,"3,5"
5312,720575940618439825,right,L4,769,4,-27,-18,-9,"4,-27"
5313,720575940635929695,right,L4,770,5,4,-3,7,"5,4"
5314,720575940624349578,right,L4,771,3,-27,-17,-10,"3,-27"
5315,720575940616178335,right,L4,772,1,12,5,7,"1,12"
5316,720575940630829879,right,L4,773,5,-19,-15,-4,"5,-19"
5317,720575940621961136,right,L4,774,-8,6,11,-5,"-8,6"
5318,720575940625718605,right,L4,775,5,22,6,16,"5,22"
5319,720575940623524451,right,L4,777,6,20,4,16,"6,20"
5320,720575940618243741,right,L4,778,4,25,8,17,"4,25"
5321,720575940617535803,right,L4,779,5,24,7,17,"5,24"
5322,720575940619662646,right,L4,780,-6,25,18,7,"-6,25"
5323,720575940630694082,right,L4,781,-5,26,18,8,"-5,26"
5324,720575940626964938,right,L4,783,-4,28,18,10,"-4,28"
5325,720575940645019428,right,L4,787,3,28,11,17,"3,28"
5326,720575940625234068,right,L4,789,-3,-27,-11,-16,"-3,-27"
5327,720575940632878929,right,L4,794,5,-26,-18,-8,"5,-26"
5328,720575940618311398,right,L4,796,4,26,9,17,"4,26"
5329,720575940615462038,right,L5,1,-6,13,12,1,"-6,13"
5330,720575940622621729,right,L5,2,-8,2,9,-7,"-8,2"
5331,720575940610072388,right,L5,3,6,-12,-12,0,"6,-12"
5332,720575940605224416,right,L5,4,-5,-21,-6,-15,"-5,-21"
5333,720575940622305553,right,L5,5,-1,16,9,7,"-1,16"
5334,720575940635239075,right,L5,6,-2,-4,0,-4,"-2,-4"
5335,720575940628774677,right,L5,7,-6,-6,3,-9,"-6,-6"
5336,720575940630647546,right,L5,8,-4,26,17,9,"-4,26"
5337,720575940628097864,right,L5,9,4,9,0,9,"4,9"
5338,720575940623928525,right,L5,10,5,-15,-13,-2,"5,-15"
5339,720575940660249985,right,L5,11,7,-14,-14,0,"7,-14"
5340,720575940638344282,right,L5,12,-7,9,11,-2,"-7,9"
5341,720575940655324577,right,L5,13,-1,-26,-12,-14,"-1,-26"
5342,720575940627492739,right,L5,14,0,-27,-14,-13,"0,-27"
5343,720575940614910882,right,L5,15,2,-3,-4,1,"2,-3"
5344,720575940626669842,right,L5,16,-2,-16,-6,-10,"-2,-16"
5345,720575940635721151,right,L5,17,1,-5,-4,-1,"1,-5"
5346,720575940627999816,right,L5,18,5,-16,-13,-3,"5,-16"
5347,720575940630965548,right,L5,19,-7,17,15,2,"-7,17"
5348,720575940617431360,right,L5,20,3,-11,-9,-2,"3,-11"
5349,720575940626042812,right,L5,21,-2,19,11,8,"-2,19"
5350,720575940631982679,right,L5,22,-1,3,2,1,"-1,3"
5351,720575940639898019,right,L5,23,-3,-16,-5,-11,"-3,-16"
5352,720575940635220131,right,L5,24,-1,-10,-4,-6,"-1,-10"
5353,720575940618265373,right,L5,25,-9,3,10,-7,"-9,3"
5354,720575940630977852,right,L5,26,1,-3,-3,0,"1,-3"
5355,720575940614793214,right,L5,27,0,-25,-13,-12,"0,-25"
5356,720575940639904931,right,L5,28,5,6,-2,8,"5,6"
5357,720575940629760419,right,L5,29,-1,-3,-1,-2,"-1,-3"
5358,720575940620665665,right,L5,30,6,16,2,14,"6,16"
5359,720575940630797305,right,L5,31,0,16,8,8,"0,16"
5360,720575940628662528,right,L5,32,0,12,6,6,"0,12"
5361,720575940630941016,right,L5,33,3,18,6,12,"3,18"
5362,720575940605332070,right,L5,34,6,18,3,15,"6,18"
5363,720575940618172902,right,L5,35,1,-24,-13,-11,"1,-24"
5364,720575940641708685,right,L5,36,6,8,-2,10,"6,8"
5365,720575940616017269,right,L5,37,1,5,1,4,"1,5"
5366,720575940622279629,right,L5,38,0,-2,-1,-1,"0,-2"
5367,720575940624953781,right,L5,39,0,20,10,10,"0,20"
5368,720575940616289364,right,L5,40,-2,-6,-1,-5,"-2,-6"
5369,720575940616313940,right,L5,41,-3,28,17,11,"-3,28"
5370,720575940620050961,right,L5,42,-1,14,8,6,"-1,14"
5371,720575940653461238,right,L5,43,-5,18,14,4,"-5,18"
5372,720575940624755092,right,L5,44,5,-10,-10,0,"5,-10"
5373,720575940635173027,right,L5,45,-5,-1,4,-5,"-5,-1"
5374,720575940605970604,right,L5,46,-5,15,12,3,"-5,15"
5375,720575940638745971,right,L5,47,-9,-1,8,-9,"-9,-1"
5376,720575940628560636,right,L5,48,-4,-22,-7,-15,"-4,-22"
5377,720575940618797120,right,L5,49,4,-4,-6,2,"4,-4"
5378,720575940620691794,right,L5,50,-2,21,12,9,"-2,21"
5379,720575940618655286,right,L5,51,0,-19,-10,-9,"0,-19"
5380,720575940627130122,right,L5,52,-1,-22,-10,-12,"-1,-22"
5381,720575940619463046,right,L5,53,5,14,2,12,"5,14"
5382,720575940633227148,right,L5,54,-4,3,5,-2,"-4,3"
5383,720575940644943816,right,L5,55,-4,-11,-2,-9,"-4,-11"
5384,720575940627427717,right,L5,56,1,-13,-8,-5,"1,-13"
5385,720575940627871253,right,L5,57,6,-11,-12,1,"6,-11"
5386,720575940614782119,right,L5,58,3,12,3,9,"3,12"
5387,720575940627012881,right,L5,59,-2,2,3,-1,"-2,2"
5388,720575940624812780,right,L5,60,-8,8,12,-4,"-8,8"
5389,720575940635177891,right,L5,61,-4,-4,2,-6,"-4,-4"
5390,720575940621577711,right,L5,62,0,-29,-15,-14,"0,-29"
5391,720575940635384159,right,L5,63,4,12,2,10,"4,12"
5392,720575940628183548,right,L5,64,4,-23,-16,-7,"4,-23"
5393,720575940627717448,right,L5,65,-1,28,15,13,"-1,28"
5394,720575940631468303,right,L5,66,2,15,5,10,"2,15"
5395,720575940628962759,right,L5,67,-2,-13,-5,-8,"-2,-13"
5396,720575940612844806,right,L5,68,3,16,5,11,"3,16"
5397,720575940652918774,right,L5,69,1,8,3,5,"1,8"
5398,720575940615808406,right,L5,70,-4,21,14,7,"-4,21"
5399,720575940635239587,right,L5,71,-2,-3,0,-3,"-2,-3"
5400,720575940619575872,right,L5,72,0,-28,-14,-14,"0,-28"
5401,720575940611157970,right,L5,73,2,2,-1,3,"2,2"
5402,720575940625135804,right,L5,74,-1,-9,-4,-5,"-1,-9"
5403,720575940626933706,right,L5,75,-6,14,13,1,"-6,14"
5404,720575940632737069,right,L5,76,-3,-4,1,-5,"-3,-4"
5405,720575940603923116,right,L5,77,2,-5,-5,0,"2,-5"
5406,720575940613004690,right,L5,78,2,20,8,12,"2,20"
5407,720575940630284844,right,L5,79,2,1,-2,3,"2,1"
5408,720575940626654410,right,L5,80,4,13,2,11,"4,13"
5409,720575940632065384,right,L5,81,6,-2,-7,5,"6,-2"
5410,720575940617719768,right,L5,82,-7,7,10,-3,"-7,7"
5411,720575940638623834,right,L5,83,2,-21,-13,-8,"2,-21"
5412,720575940639721806,right,L5,84,-2,12,8,4,"-2,12"
5413,720575940635758072,right,L5,85,4,-22,-15,-7,"4,-22"
5414,720575940647466884,right,L5,86,-5,-7,1,-8,"-5,-7"
5415,720575940614210978,right,L5,87,1,11,4,7,"1,11"
5416,720575940613576470,right,L5,89,1,-19,-11,-8,"1,-19"
5417,720575940621372436,right,L5,90,-4,5,6,-1,"-4,5"
5418,720575940643746612,right,L5,91,-1,6,4,2,"-1,6"
5419,720575940632208911,right,L5,92,0,9,4,5,"0,9"
5420,720575940628535976,right,L5,94,5,18,4,14,"5,18"
5421,720575940622248474,right,L5,95,4,-21,-15,-6,"4,-21"
5422,720575940607344306,right,L5,96,1,-10,-6,-4,"1,-10"
5423,720575940624192973,right,L5,97,-5,2,6,-4,"-5,2"
5424,720575940626613622,right,L5,98,-1,-12,-5,-7,"-1,-12"
5425,720575940620362876,right,L5,99,4,15,3,12,"4,15"
5426,720575940639028031,right,L5,100,2,-10,-7,-3,"2,-10"
5427,720575940639467829,right,L5,101,-7,6,10,-4,"-7,6"
5428,720575940632454703,right,L5,102,3,13,3,10,"3,13"
5429,720575940627048741,right,L5,103,7,9,-3,12,"7,9"
5430,720575940628108776,right,L5,104,-1,-27,-13,-14,"-1,-27"
5431,720575940638315753,right,L5,105,3,22,8,14,"3,22"
5432,720575940628807957,right,L5,106,-7,11,12,-1,"-7,11"
5433,720575940622593494,right,L5,107,8,-2,-9,7,"8,-2"
5434,720575940624391658,right,L5,108,-3,-12,-3,-9,"-3,-12"
5435,720575940606760284,right,L5,109,4,-5,-7,2,"4,-5"
5436,720575940627815676,right,L5,110,-7,0,7,-7,"-7,0"
5437,720575940647121972,right,L5,111,2,-24,-14,-10,"2,-24"
5438,720575940613202794,right,L5,112,-6,1,6,-5,"-6,1"
5439,720575940641785589,right,L5,113,-2,4,4,0,"-2,4"
5440,720575940628912188,right,L5,114,2,-13,-9,-4,"2,-13"
5441,720575940630743972,right,L5,115,-4,2,5,-3,"-4,2"
5442,720575940611266658,right,L5,116,-1,-8,-3,-5,"-1,-8"
5443,720575940623698372,right,L5,117,-8,-2,7,-9,"-8,-2"
5444,720575940627915780,right,L5,118,3,1,-3,4,"3,1"
5445,720575940630497231,right,L5,119,-2,6,5,1,"-2,6"
5446,720575940615207180,right,L5,120,-1,-1,0,-1,"-1,-1"
5447,720575940636776037,right,L5,121,-8,4,10,-6,"-8,4"
5448,720575940618434449,right,L5,122,-5,9,9,0,"-5,9"
5449,720575940635873904,right,L5,123,-8,10,13,-3,"-8,10"
5450,720575940633149357,right,L5,124,1,-7,-5,-2,"1,-7"
5451,720575940613094642,right,L5,125,5,9,-1,10,"5,9"
5452,720575940630875387,right,L5,126,3,11,2,9,"3,11"
5453,720575940620727489,right,L5,127,0,15,7,8,"0,15"
5454,720575940631102735,right,L5,128,3,-22,-14,-8,"3,-22"
5455,720575940631650066,right,L5,129,0,-13,-7,-6,"0,-13"
5456,720575940616790389,right,L5,130,2,12,4,8,"2,12"
5457,720575940625400248,right,L5,131,-6,20,16,4,"-6,20"
5458,720575940615476166,right,L5,132,2,4,0,4,"2,4"
5459,720575940613236147,right,L5,133,-3,20,13,7,"-3,20"
5460,720575940609611531,right,L5,134,-5,-18,-4,-14,"-5,-18"
5461,720575940608910345,right,L5,135,-3,-22,-8,-14,"-3,-22"
5462,720575940612053679,right,L5,136,0,3,1,2,"0,3"
5463,720575940648661380,right,L5,137,5,-7,-9,2,"5,-7"
5464,720575940629359515,right,L5,138,0,27,13,14,"0,27"
5465,720575940629928407,right,L5,139,1,-14,-8,-6,"1,-14"
5466,720575940629907578,right,L5,140,3,8,1,7,"3,8"
5467,720575940637898842,right,L5,141,5,-23,-17,-6,"5,-23"
5468,720575940631165541,right,L5,142,-2,-18,-7,-11,"-2,-18"
5469,720575940640211389,right,L5,143,-4,16,12,4,"-4,16"
5470,720575940621138414,right,L5,144,7,-11,-13,2,"7,-11"
5471,720575940624971353,right,L5,145,0,4,2,2,"0,4"
5472,720575940633073052,right,L5,146,1,-6,-4,-2,"1,-6"
5473,720575940639355837,right,L5,147,1,21,9,12,"1,21"
5474,720575940623559876,right,L5,148,-7,-11,1,-12,"-7,-11"
5475,720575940614865570,right,L5,149,6,-14,-13,-1,"6,-14"
5476,720575940616332338,right,L5,150,-8,5,10,-5,"-8,5"
5477,720575940642275725,right,L5,151,-3,-14,-4,-10,"-3,-14"
5478,720575940612173747,right,L5,152,3,-15,-11,-4,"3,-15"
5479,720575940618145565,right,L5,153,8,0,-8,8,"8,0"
5480,720575940621278166,right,L5,154,-8,0,8,-8,"-8,0"
5481,720575940637677790,right,L5,155,-8,13,14,-1,"-8,13"
5482,720575940621138342,right,L5,156,-9,1,9,-8,"-9,1"
5483,720575940629091146,right,L5,157,-1,-7,-3,-4,"-1,-7"
5484,720575940628630223,right,L5,158,3,-5,-6,1,"3,-5"
5485,720575940645725476,right,L5,159,7,7,-4,11,"7,7"
5486,720575940640767859,right,L5,160,-2,20,12,8,"-2,20"
5487,720575940606336958,right,L5,161,4,-14,-11,-3,"4,-14"
5488,720575940614259251,right,L5,162,-4,-2,3,-5,"-4,-2"
5489,720575940636614757,right,L5,163,-9,7,12,-5,"-9,7"
5490,720575940635212963,right,L5,164,-1,-2,0,-2,"-1,-2"
5491,720575940612207473,right,L5,165,4,16,4,12,"4,16"
5492,720575940618894917,right,L5,166,0,18,9,9,"0,18"
5493,720575940617722507,right,L5,167,0,-17,-9,-8,"0,-17"
5494,720575940617265566,right,L5,168,-1,17,9,8,"-1,17"
5495,720575940635604671,right,L5,169,0,-18,-9,-9,"0,-18"
5496,720575940626746567,right,L5,170,-5,1,5,-4,"-5,1"
5497,720575940620655275,right,L5,171,6,-20,-16,-4,"6,-20"
5498,720575940628072188,right,L5,172,1,22,10,12,"1,22"
5499,720575940641599440,right,L5,173,2,-25,-15,-10,"2,-25"
5500,720575940618046109,right,L5,174,4,-15,-12,-3,"4,-15"
5501,720575940604964576,right,L5,175,-6,-7,2,-9,"-6,-7"
5502,720575940620382411,right,L5,176,-2,13,8,5,"-2,13"
5503,720575940624185784,right,L5,177,-2,-1,1,-2,"-2,-1"
5504,720575940617838310,right,L5,178,2,11,3,8,"2,11"
5505,720575940639807859,right,L5,179,-5,-16,-3,-13,"-5,-16"
5506,720575940630675159,right,L5,180,2,-27,-16,-11,"2,-27"
5507,720575940610666030,right,L5,181,1,-4,-3,-1,"1,-4"
5508,720575940632791071,right,L5,182,7,-10,-12,2,"7,-10"
5509,720575940623549734,right,L5,183,-5,-15,-3,-12,"-5,-15"
5510,720575940627494666,right,L5,184,-6,-5,3,-8,"-6,-5"
5511,720575940612744618,right,L5,185,2,-11,-8,-3,"2,-11"
5512,720575940623023143,right,L5,186,-1,26,14,12,"-1,26"
5513,720575940620704588,right,L5,187,3,21,7,14,"3,21"
5514,720575940616792181,right,L5,188,-5,17,13,4,"-5,17"
5515,720575940623361672,right,L5,189,6,13,0,13,"6,13"
5516,720575940617729465,right,L5,190,-3,-5,0,-5,"-3,-5"
5517,720575940627649359,right,L5,191,-1,-11,-5,-6,"-1,-11"
5518,720575940660151425,right,L5,192,7,10,-2,12,"7,10"
5519,720575940617656532,right,L5,193,-5,4,7,-3,"-5,4"
5520,720575940634733151,right,L5,194,0,-5,-3,-2,"0,-5"
5521,720575940643315104,right,L5,195,-3,-1,2,-3,"-3,-1"
5522,720575940627882366,right,L5,196,-1,8,5,3,"-1,8"
5523,720575940622433050,right,L5,197,0,-20,-10,-10,"0,-20"
5524,720575940628063208,right,L5,198,6,2,-5,7,"6,2"
5525,720575940630196930,right,L5,199,0,-12,-6,-6,"0,-12"
5526,720575940633501644,right,L5,200,-5,12,11,1,"-5,12"
5527,720575940607280514,right,L5,201,-8,9,12,-3,"-8,9"
5528,720575940627653419,right,L5,202,-1,27,14,13,"-1,27"
5529,720575940616321878,right,L5,203,3,-1,-4,3,"3,-1"
5530,720575940646667811,right,L5,204,5,-2,-6,4,"5,-2"
5531,720575940644255904,right,L5,205,5,-6,-8,2,"5,-6"
5532,720575940620305867,right,L5,206,-3,5,5,0,"-3,5"
5533,720575940630790010,right,L5,208,5,-21,-16,-5,"5,-21"
5534,720575940614380199,right,L5,209,-3,-8,-1,-7,"-3,-8"
5535,720575940617542374,right,L5,210,-6,8,10,-2,"-6,8"
5536,720575940620688832,right,L5,211,-7,-1,6,-7,"-7,-1"
5537,720575940640125629,right,L5,212,2,-16,-10,-6,"2,-16"
5538,720575940605002720,right,L5,213,3,-4,-5,1,"3,-4"
5539,720575940621841279,right,L5,215,6,7,-3,10,"6,7"
5540,720575940627946517,right,L5,216,2,19,7,12,"2,19"
5541,720575940625769293,right,L5,217,6,15,1,14,"6,15"
5542,720575940632989011,right,L5,218,2,10,3,7,"2,10"
5543,720575940646012695,right,L5,219,6,-4,-8,4,"6,-4"
5544,720575940628541190,right,L5,220,2,-6,-5,-1,"2,-6"
5545,720575940634599137,right,L5,221,-7,3,8,-5,"-7,3"
5546,720575940622624332,right,L5,222,-3,26,16,10,"-3,26"
5547,720575940621548882,right,L5,223,-2,26,15,11,"-2,26"
5548,720575940626412176,right,L5,224,0,5,2,3,"0,5"
5549,720575940633147439,right,L5,225,2,-26,-15,-11,"2,-26"
5550,720575940648199812,right,L5,226,5,19,4,15,"5,19"
5551,720575940631997381,right,L5,227,-7,5,9,-4,"-7,5"
5552,720575940625109833,right,L5,228,-7,1,7,-6,"-7,1"
5553,720575940624955322,right,L5,230,2,9,2,7,"2,9"
5554,720575940624219575,right,L5,231,4,-12,-10,-2,"4,-12"
5555,720575940625699052,right,L5,232,-4,13,10,3,"-4,13"
5556,720575940605910886,right,L5,233,4,-13,-11,-2,"4,-13"
5557,720575940628663556,right,L5,234,1,3,0,3,"1,3"
5558,720575940604086496,right,L5,235,4,11,1,10,"4,11"
5559,720575940626986920,right,L5,236,-1,4,3,1,"-1,4"
5560,720575940637243237,right,L5,237,-2,27,15,12,"-2,27"
5561,720575940628192764,right,L5,238,-8,-3,6,-9,"-8,-3"
5562,720575940626318878,right,L5,239,-6,6,9,-3,"-6,6"
5563,720575940621443137,right,L5,240,-4,-3,2,-5,"-4,-3"
5564,720575940622175245,right,L5,241,2,-17,-11,-6,"2,-17"
5565,720575940618614853,right,L5,242,-4,6,7,-1,"-4,6"
5566,720575940636517239,right,L5,243,-1,-21,-10,-11,"-1,-21"
5567,720575940616464434,right,L5,244,-4,-12,-2,-10,"-4,-12"
5568,720575940627519763,right,L5,245,-5,-3,3,-6,"-5,-3"
5569,720575940619944241,right,L5,246,-4,15,11,4,"-4,15"
5570,720575940635144867,right,L5,247,-4,-15,-4,-11,"-4,-15"
5571,720575940630183927,right,L5,248,-6,0,6,-6,"-6,0"
5572,720575940632305036,right,L5,249,2,-12,-8,-4,"2,-12"
5573,720575940627478790,right,L5,250,-1,1,1,0,"-1,1"
5574,720575940610246513,right,L5,251,-1,-14,-6,-8,"-1,-14"
5575,720575940607446658,right,L5,252,3,23,8,15,"3,23"
5576,720575940623833066,right,L5,253,5,16,3,13,"5,16"
5577,720575940621235846,right,L5,254,3,-24,-15,-9,"3,-24"
5578,720575940612846489,right,L5,255,-6,-13,-1,-12,"-6,-13"
5579,720575940623521318,right,L5,256,5,-20,-15,-5,"5,-20"
5580,720575940632449583,right,L5,257,2,21,8,13,"2,21"
5581,720575940635146659,right,L5,258,-4,-17,-5,-12,"-4,-17"
5582,720575940624584712,right,L5,259,-7,-5,4,-9,"-7,-5"
5583,720575940633486955,right,L5,261,-1,13,7,6,"-1,13"
5584,720575940653343734,right,L5,262,1,-11,-7,-4,"1,-11"
5585,720575940624302538,right,L5,263,-3,4,5,-1,"-3,4"
5586,720575940617730745,right,L5,264,-1,-6,-2,-4,"-1,-6"
5587,720575940619354945,right,L5,265,-6,-1,5,-6,"-6,-1"
5588,720575940637023095,right,L5,266,-1,-25,-12,-13,"-1,-25"
5589,720575940625568748,right,L5,267,-6,2,7,-5,"-6,2"
5590,720575940624907337,right,L5,268,7,-6,-10,4,"7,-6"
5591,720575940613386989,right,L5,269,2,-19,-12,-7,"2,-19"
5592,720575940633207010,right,L5,270,1,-8,-5,-3,"1,-8"
5593,720575940622401549,right,L5,271,4,6,-1,7,"4,6"
5594,720575940641489141,right,L5,272,3,-2,-4,2,"3,-2"
5595,720575940634910489,right,L5,273,-6,23,17,6,"-6,23"
5596,720575940632130361,right,L5,275,-8,-1,7,-8,"-8,-1"
5597,720575940616131084,right,L5,276,2,3,-1,4,"2,3"
5598,720575940612655845,right,L5,277,7,-3,-9,6,"7,-3"
5599,720575940630165659,right,L5,278,-5,10,10,0,"-5,10"
5600,720575940630984443,right,L5,279,-4,8,8,0,"-4,8"
5601,720575940628809515,right,L5,280,-6,-14,-1,-13,"-6,-14"
5602,720575940638566878,right,L5,281,-9,2,10,-8,"-9,2"
5603,720575940620662866,right,L5,282,0,26,13,13,"0,26"
5604,720575940633844962,right,L5,283,-4,4,6,-2,"-4,4"
5605,720575940616767349,right,L5,284,0,25,12,13,"0,25"
5606,720575940623908871,right,L5,285,6,-18,-15,-3,"6,-18"
5607,720575940617886779,right,L5,286,0,-24,-12,-12,"0,-24"
5608,720575940621488225,right,L5,287,-5,13,11,2,"-5,13"
5609,720575940636351851,right,L5,288,-1,30,16,14,"-1,30"
5610,720575940643871540,right,L5,289,-1,11,6,5,"-1,11"
5611,720575940611010658,right,L5,290,5,-24,-17,-7,"5,-24"
5612,720575940627070360,right,L5,291,7,2,-6,8,"7,2"
5613,720575940627659133,right,L5,292,-4,18,13,5,"-4,18"
5614,720575940630061824,right,L5,293,4,-17,-13,-4,"4,-17"
5615,720575940635599511,right,L5,294,1,-20,-11,-9,"1,-20"
5616,720575940620883403,right,L5,295,-2,29,16,13,"-2,29"
5617,720575940620580613,right,L5,296,1,-18,-10,-8,"1,-18"
5618,720575940626029852,right,L5,297,7,-9,-12,3,"7,-9"
5619,720575940635727199,right,L5,298,-5,5,7,-2,"-5,5"
5620,720575940628600232,right,L5,299,-4,12,10,2,"-4,12"
5621,720575940617331345,right,L5,300,4,-18,-13,-5,"4,-18"
5622,720575940622815493,right,L5,301,-5,16,13,3,"-5,16"
5623,720575940618569541,right,L5,302,2,17,6,11,"2,17"
5624,720575940618371613,right,L5,303,-5,22,16,6,"-5,22"
5625,720575940617061051,right,L5,304,6,5,-4,9,"6,5"
5626,720575940625449108,right,L5,305,-7,4,9,-5,"-7,4"
5627,720575940628236175,right,L5,306,3,7,0,7,"3,7"
5628,720575940621116075,right,L5,307,5,-25,-18,-7,"5,-25"
5629,720575940621665670,right,L5,308,-5,8,9,-1,"-5,8"
5630,720575940615596427,right,L5,309,-6,12,12,0,"-6,12"
5631,720575940631641130,right,L5,310,2,22,9,13,"2,22"
5632,720575940632887891,right,L5,311,-7,15,14,1,"-7,15"
5633,720575940612752101,right,L5,312,4,-7,-8,1,"4,-7"
5634,720575940605698494,right,L5,313,7,3,-6,9,"7,3"
5635,720575940618590021,right,L5,314,-9,5,11,-6,"-9,5"
5636,720575940620971644,right,L5,315,-3,-6,0,-6,"-3,-6"
5637,720575940631270573,right,L5,316,5,-4,-7,3,"5,-4"
5638,720575940610676906,right,L5,317,-5,-4,3,-7,"-5,-4"
5639,720575940610724910,right,L5,318,4,-19,-14,-5,"4,-19"
5640,720575940626797712,right,L5,319,-2,5,4,1,"-2,5"
5641,720575940611178450,right,L5,320,-2,-5,-1,-4,"-2,-5"
5642,720575940618956317,right,L5,321,8,4,-6,10,"8,4"
5643,720575940612980082,right,L5,322,2,26,11,15,"2,26"
5644,720575940614435070,right,L5,323,-7,-13,0,-13,"-7,-13"
5645,720575940627088517,right,L5,324,3,24,9,15,"3,24"
5646,720575940606712497,right,L5,325,5,1,-5,6,"5,1"
5647,720575940622332540,right,L5,326,2,16,6,10,"2,16"
5648,720575940639663669,right,L5,328,5,-9,-10,1,"5,-9"
5649,720575940620666450,right,L5,329,0,24,12,12,"0,24"
5650,720575940617527297,right,L5,330,3,3,-2,5,"3,3"
5651,720575940628212234,right,L5,331,1,-15,-9,-6,"1,-15"
5652,720575940630803255,right,L5,332,4,-26,-17,-9,"4,-26"
5653,720575940629878583,right,L5,333,0,-21,-11,-10,"0,-21"
5654,720575940630203136,right,L5,334,1,-26,-14,-12,"1,-26"
5655,720575940625494093,right,L5,335,2,8,2,6,"2,8"
5656,720575940635737200,right,L5,336,0,23,11,12,"0,23"
5657,720575940610261187,right,L5,337,-5,-6,2,-8,"-5,-6"
5658,720575940609859192,right,L5,338,-1,0,1,-1,"-1,0"
5659,720575940620758187,right,L5,339,6,11,-1,12,"6,11"
5660,720575940635942042,right,L5,340,-4,17,12,5,"-4,17"
5661,720575940629749114,right,L5,341,6,-17,-15,-2,"6,-17"
5662,720575940648070521,right,L5,342,2,-15,-10,-5,"2,-15"
5663,720575940619884784,right,L5,343,-3,27,16,11,"-3,27"
5664,720575940619157627,right,L5,344,-2,-15,-6,-9,"-2,-15"
5665,720575940624184575,right,L5,345,3,-12,-9,-3,"3,-12"
5666,720575940617813222,right,L5,346,-7,-9,2,-11,"-7,-9"
5667,720575940622326049,right,L5,347,-5,-13,-2,-11,"-5,-13"
5668,720575940617830630,right,L5,348,3,14,4,10,"3,14"
5669,720575940626252746,right,L5,349,-5,-14,-2,-12,"-5,-14"
5670,720575940605389484,right,L5,350,1,15,6,9,"1,15"
5671,720575940628493574,right,L5,351,-1,-17,-8,-9,"-1,-17"
5672,720575940616196063,right,L5,352,-2,28,16,12,"-2,28"
5673,720575940629095171,right,L5,353,2,24,10,14,"2,24"
5674,720575940621401782,right,L5,354,-2,-26,-11,-15,"-2,-26"
5675,720575940619994571,right,L5,355,-7,-6,4,-10,"-7,-6"
5676,720575940631932687,right,L5,356,0,22,11,11,"0,22"
5677,720575940618572869,right,L5,357,4,17,4,13,"4,17"
5678,720575940623307084,right,L5,358,-3,17,11,6,"-3,17"
5679,720575940620972626,right,L5,359,2,23,9,14,"2,23"
5680,720575940621354734,right,L5,360,-5,19,14,5,"-5,19"
5681,720575940604584672,right,L5,361,0,-7,-4,-3,"0,-7"
5682,720575940618538565,right,L5,362,2,-20,-12,-8,"2,-20"
5683,720575940632465450,right,L5,363,7,-4,-9,5,"7,-4"
5684,720575940628285973,right,L5,364,4,4,-2,6,"4,4"
5685,720575940612386257,right,L5,365,4,7,-1,8,"4,7"
5686,720575940624286602,right,L5,366,-5,-20,-5,-15,"-5,-20"
5687,720575940640386176,right,L5,367,-6,-15,-2,-13,"-6,-15"
5688,720575940622448531,right,L5,368,-4,-20,-6,-14,"-4,-20"
5689,720575940616116054,right,L5,369,5,-5,-8,3,"5,-5"
5690,720575940621601414,right,L5,370,-3,21,13,8,"-3,21"
5691,720575940626275786,right,L5,371,6,-5,-9,4,"6,-5"
5692,720575940611784618,right,L5,372,1,-2,-2,0,"1,-2"
5693,720575940612648561,right,L5,373,1,-21,-12,-9,"1,-21"
5694,720575940635543726,right,L5,374,2,13,4,9,"2,13"
5695,720575940631825489,right,L5,375,-6,7,9,-2,"-6,7"
5696,720575940608565003,right,L5,376,-7,-10,2,-12,"-7,-10"
5697,720575940624894135,right,L5,377,0,7,3,4,"0,7"
5698,720575940621297317,right,L5,378,-3,18,12,6,"-3,18"
5699,720575940623166600,right,L5,379,3,-17,-12,-5,"3,-17"
5700,720575940624858375,right,L5,380,-1,29,15,14,"-1,29"
5701,720575940612112819,right,L5,381,-8,-9,3,-12,"-8,-9"
5702,720575940633465369,right,L5,382,3,-6,-6,0,"3,-6"
5703,720575940630564346,right,L5,383,-6,11,11,0,"-6,11"
5704,720575940636381432,right,L5,384,-6,-2,5,-7,"-6,-2"
5705,720575940620702746,right,L5,385,-3,-18,-6,-12,"-3,-18"
5706,720575940626299082,right,L5,386,-6,19,15,4,"-6,19"
5707,720575940631263247,right,L5,387,-1,-15,-7,-8,"-1,-15"
5708,720575940610744110,right,L5,388,3,19,6,13,"3,19"
5709,720575940618932939,right,L5,389,-6,-16,-2,-14,"-6,-16"
5710,720575940626299594,right,L5,390,-6,-9,1,-10,"-6,-9"
5711,720575940628421831,right,L5,391,4,-3,-6,3,"4,-3"
5712,720575940637689006,right,L5,392,-4,7,7,0,"-4,7"
5713,720575940625088952,right,L5,393,-1,22,12,10,"-1,22"
5714,720575940623422088,right,L5,394,-7,-8,3,-11,"-7,-8"
5715,720575940623784339,right,L5,395,0,-22,-11,-11,"0,-22"
5716,720575940622799178,right,L5,396,-1,10,6,4,"-1,10"
5717,720575940626477839,right,L5,397,-3,-19,-7,-12,"-3,-19"
5718,720575940632346695,right,L5,398,-3,22,14,8,"-3,22"
5719,720575940646928419,right,L5,399,-4,-24,-8,-16,"-4,-24"
5720,720575940615100979,right,L5,400,1,-29,-16,-13,"1,-29"
5721,720575940645526068,right,L5,401,-2,-19,-8,-11,"-2,-19"
5722,720575940631931407,right,L5,402,3,26,10,16,"3,26"
5723,720575940621538486,right,L5,403,-2,-12,-4,-8,"-2,-12"
5724,720575940615669109,right,L5,404,-1,20,11,9,"-1,20"
5725,720575940630537850,right,L5,405,3,10,2,8,"3,10"
5726,720575940630347831,right,L5,406,1,-25,-14,-11,"1,-25"
5727,720575940624513208,right,L5,407,-5,-10,0,-10,"-5,-10"
5728,720575940629097259,right,L5,408,-6,-4,4,-8,"-6,-4"
5729,720575940644453792,right,L5,409,0,-3,-2,-1,"0,-3"
5730,720575940617325090,right,L5,410,-2,-2,1,-3,"-2,-2"
5731,720575940614696927,right,L5,411,-5,-19,-5,-14,"-5,-19"
5732,720575940631368652,right,L5,412,-6,21,16,5,"-6,21"
5733,720575940630250540,right,L5,413,-2,-7,-2,-5,"-2,-7"
5734,720575940638453214,right,L5,414,4,21,6,15,"4,21"
5735,720575940631711628,right,L5,415,6,12,0,12,"6,12"
5736,720575940624352138,right,L5,416,3,-8,-7,-1,"3,-8"
5737,720575940627629114,right,L5,417,-6,-10,1,-11,"-6,-10"
5738,720575940643047460,right,L5,418,-2,15,9,6,"-2,15"
5739,720575940632590243,right,L5,419,-3,-11,-3,-8,"-3,-11"
5740,720575940616333535,right,L5,420,6,-3,-8,5,"6,-3"
5741,720575940643779380,right,L5,421,-1,12,7,5,"-1,12"
5742,720575940605940000,right,L5,422,-7,-4,5,-9,"-7,-4"
5743,720575940629064859,right,L5,423,3,-18,-12,-6,"3,-18"
5744,720575940620379015,right,L5,424,-3,-2,2,-4,"-3,-2"
5745,720575940630910040,right,L5,425,3,20,7,13,"3,20"
5746,720575940637723614,right,L5,426,-3,0,3,-3,"-3,0"
5747,720575940612818611,right,L5,427,5,-18,-14,-4,"5,-18"
5748,720575940623074791,right,L5,428,-2,23,13,10,"-2,23"
5749,720575940636992686,right,L5,429,-2,14,9,5,"-2,14"
5750,720575940635185315,right,L5,430,-3,-7,-1,-6,"-3,-7"
5751,720575940639357117,right,L5,431,-2,-10,-3,-7,"-2,-10"
5752,720575940607327106,right,L5,432,-5,7,8,-1,"-5,7"
5753,720575940629632759,right,L5,433,0,-8,-4,-4,"0,-8"
5754,720575940625862602,right,L5,434,-3,7,6,1,"-3,7"
5755,720575940617800422,right,L5,435,5,-17,-14,-3,"5,-17"
5756,720575940628890640,right,L5,436,0,-15,-8,-7,"0,-15"
5757,720575940609566328,right,L5,437,-3,12,9,3,"-3,12"
5758,720575940611342712,right,L5,438,2,27,11,16,"2,27"
5759,720575940625016807,right,L5,439,-3,-9,-2,-7,"-3,-9"
5760,720575940645104919,right,L5,440,1,23,10,13,"1,23"
5761,720575940620119632,right,L5,441,3,-16,-11,-5,"3,-16"
5762,720575940637595790,right,L5,442,-5,25,17,8,"-5,25"
5763,720575940624600584,right,L5,443,-6,4,8,-4,"-6,4"
5764,720575940636110564,right,L5,444,4,-10,-9,-1,"4,-10"
5765,720575940614830376,right,L5,445,-2,8,6,2,"-2,8"
5766,720575940630410972,right,L5,446,2,-14,-9,-5,"2,-14"
5767,720575940621257596,right,L5,447,-1,2,2,0,"-1,2"
5768,720575940630505722,right,L5,448,0,30,15,15,"0,30"
5769,720575940632368199,right,L5,449,6,-16,-14,-2,"6,-16"
5770,720575940628993296,right,L5,450,2,-9,-7,-2,"2,-9"
5771,720575940625069500,right,L5,451,4,20,6,14,"4,20"
5772,720575940622211916,right,L5,452,1,-9,-6,-3,"1,-9"
5773,720575940623023399,right,L5,453,3,25,9,16,"3,25"
5774,720575940620881134,right,L5,454,5,-12,-11,-1,"5,-12"
5775,720575940605640160,right,L5,455,7,-7,-11,4,"7,-7"
5776,720575940626248837,right,L5,456,0,21,10,11,"0,21"
5777,720575940621616111,right,L5,457,-2,17,10,7,"-2,17"
5778,720575940636734053,right,L5,458,5,0,-5,5,"5,0"
5779,720575940631235896,right,L5,459,5,-3,-7,4,"5,-3"
5780,720575940615953862,right,L5,460,-3,-20,-7,-13,"-3,-20"
5781,720575940604599654,right,L5,461,7,-5,-10,5,"7,-5"
5782,720575940622995443,right,L5,462,-1,18,10,8,"-1,18"
5783,720575940643646664,right,L5,463,5,17,3,14,"5,17"
5784,720575940631485711,right,L5,464,4,0,-4,4,"4,0"
5785,720575940611165390,right,L5,465,3,0,-3,3,"3,0"
5786,720575940621854540,right,L5,466,1,14,6,8,"1,14"
5787,720575940616293087,right,L5,467,-2,-20,-8,-12,"-2,-20"
5788,720575940610844678,right,L5,468,-3,11,8,3,"-3,11"
5789,720575940623451272,right,L5,469,-7,13,13,0,"-7,13"
5790,720575940623983504,right,L5,470,4,-9,-9,0,"4,-9"
5791,720575940627838280,right,L5,471,3,-26,-16,-10,"3,-26"
5792,720575940632234157,right,L5,472,1,25,11,14,"1,25"
5793,720575940623249944,right,L5,473,-4,23,15,8,"-4,23"
5794,720575940623037820,right,L5,474,-3,-17,-6,-11,"-3,-17"
5795,720575940626859568,right,L5,475,-4,-1,3,-4,"-4,-1"
5796,720575940632698413,right,L5,476,-1,15,8,7,"-1,15"
5797,720575940630828759,right,L5,477,-3,2,4,-2,"-3,2"
5798,720575940618514846,right,L5,478,-7,16,15,1,"-7,16"
5799,720575940638259290,right,L5,479,-2,10,7,3,"-2,10"
5800,720575940617518548,right,L5,480,3,-19,-13,-6,"3,-19"
5801,720575940633221018,right,L5,481,4,-8,-8,0,"4,-8"
5802,720575940623723858,right,L5,482,1,17,7,10,"1,17"
5803,720575940622705416,right,L5,483,2,-7,-6,-1,"2,-7"
5804,720575940630781175,right,L5,484,3,-9,-8,-1,"3,-9"
5805,720575940635174307,right,L5,485,-3,-3,1,-4,"-3,-3"
5806,720575940638479081,right,L5,486,0,1,0,1,"0,1"
5807,720575940637700068,right,L5,487,1,-1,-2,1,"1,-1"
5808,720575940613577642,right,L5,488,7,5,-5,10,"7,5"
5809,720575940626014478,right,L5,489,-3,10,8,2,"-3,10"
5810,720575940630378327,right,L5,490,-5,6,8,-2,"-5,6"
5811,720575940640137048,right,L5,491,7,-1,-8,7,"7,-1"
5812,720575940632489064,right,L5,492,-7,-2,6,-8,"-7,-2"
5813,720575940622392560,right,L5,493,-3,23,14,9,"-3,23"
5814,720575940625249831,right,L5,494,0,29,14,15,"0,29"
5815,720575940627712275,right,L5,495,4,5,-2,7,"4,5"
5816,720575940632587857,right,L5,496,7,8,-3,11,"7,8"
5817,720575940630285051,right,L5,497,6,1,-6,7,"6,1"
5818,720575940642416269,right,L5,498,6,10,-1,11,"6,10"
5819,720575940617501755,right,L5,499,5,10,0,10,"5,10"
5820,720575940613442978,right,L5,500,7,-8,-11,3,"7,-8"
5821,720575940634538175,right,L5,501,1,2,0,2,"1,2"
5822,720575940630720450,right,L5,502,5,8,-1,9,"5,8"
5823,720575940619699382,right,L5,503,3,17,5,12,"3,17"
5824,720575940612548886,right,L5,504,-2,9,6,3,"-2,9"
5825,720575940608206770,right,L5,505,6,-22,-17,-5,"6,-22"
5826,720575940613872680,right,L5,506,1,-12,-7,-5,"1,-12"
5827,720575940626691258,right,L5,507,-5,-12,-1,-11,"-5,-12"
5828,720575940618161620,right,L5,508,-5,11,10,1,"-5,11"
5829,720575940631068972,right,L5,509,-4,10,9,1,"-4,10"
5830,720575940625166504,right,L5,510,-2,11,7,4,"-2,11"
5831,720575940628843526,right,L5,511,5,-11,-11,0,"5,-11"
5832,720575940605142118,right,L5,512,6,0,-6,6,"6,0"
5833,720575940623369084,right,L5,513,-4,-13,-3,-10,"-4,-13"
5834,720575940625101244,right,L5,514,-4,-10,-1,-9,"-4,-10"
5835,720575940612658602,right,L5,515,-8,-7,4,-11,"-8,-7"
5836,720575940639453262,right,L5,516,7,-18,-16,-2,"7,-18"
5837,720575940630227303,right,L5,517,6,3,-5,8,"6,3"
5838,720575940615958971,right,L5,518,-4,22,15,7,"-4,22"
5839,720575940635396238,right,L5,519,-5,-5,2,-7,"-5,-5"
5840,720575940629691386,right,L5,520,-2,-22,-9,-13,"-2,-22"
5841,720575940632756900,right,L5,521,6,-9,-11,2,"6,-9"
5842,720575940612883710,right,L5,522,-4,0,4,-4,"-4,0"
5843,720575940607080931,right,L5,523,2,14,5,9,"2,14"
5844,720575940636492663,right,L5,524,4,-20,-14,-6,"4,-20"
5845,720575940608863241,right,L5,525,-1,-20,-9,-11,"-1,-20"
5846,720575940615729932,right,L5,526,0,-10,-5,-5,"0,-10"
5847,720575940618808491,right,L5,527,-4,-8,0,-8,"-4,-8"
5848,720575940610692142,right,L5,528,2,7,1,6,"2,7"
5849,720575940611961523,right,L5,529,2,-2,-3,1,"2,-2"
5850,720575940620939696,right,L5,530,-3,-13,-4,-9,"-3,-13"
5851,720575940629783555,right,L5,531,1,0,-1,1,"1,0"
5852,720575940624578795,right,L5,532,-8,7,11,-4,"-8,7"
5853,720575940630735863,right,L5,533,0,-16,-8,-8,"0,-16"
5854,720575940615253354,right,L5,534,3,2,-2,4,"3,2"
5855,720575940637845732,right,L5,535,8,-4,-10,6,"8,-4"
5856,720575940619986352,right,L5,536,3,4,-1,5,"3,4"
5857,720575940637576158,right,L5,537,0,-23,-12,-11,"0,-23"
5858,720575940631109420,right,L5,538,-4,1,4,-3,"-4,1"
5859,720575940623206024,right,L5,539,-6,15,13,2,"-6,15"
5860,720575940638095326,right,L5,540,-2,-9,-3,-6,"-2,-9"
5861,720575940622703600,right,L5,541,-4,14,11,3,"-4,14"
5862,720575940633180973,right,L5,542,6,-13,-13,0,"6,-13"
5863,720575940617015365,right,L5,543,-1,-4,-1,-3,"-1,-4"
5864,720575940624072967,right,L5,544,3,-13,-10,-3,"3,-13"
5865,720575940626819091,right,L5,545,5,11,0,11,"5,11"
5866,720575940618793664,right,L5,546,3,6,0,6,"3,6"
5867,720575940629699322,right,L5,547,-1,21,11,10,"-1,21"
5868,720575940631552825,right,L5,548,1,-16,-9,-7,"1,-16"
5869,720575940627983336,right,L5,549,0,-9,-5,-4,"0,-9"
5870,720575940609714222,right,L5,550,-2,3,3,0,"-2,3"
5871,720575940614226915,right,L5,551,-4,-9,-1,-8,"-4,-9"
5872,720575940633236141,right,L5,552,4,-1,-5,4,"4,-1"
5873,720575940629609065,right,L5,553,-3,16,11,5,"-3,16"
5874,720575940615964722,right,L5,554,-9,-3,7,-10,"-9,-3"
5875,720575940630160027,right,L5,555,-4,9,8,1,"-4,9"
5876,720575940626907383,right,L5,556,0,10,5,5,"0,10"
5877,720575940633583129,right,L5,557,6,-10,-11,1,"6,-10"
5878,720575940648651140,right,L5,558,-4,-21,-7,-14,"-4,-21"
5879,720575940632987437,right,L5,559,-6,22,17,5,"-6,22"
5880,720575940620506827,right,L5,560,-7,14,14,0,"-7,14"
5881,720575940632000274,right,L5,561,5,7,-2,9,"5,7"
5882,720575940610739173,right,L5,562,-5,-2,4,-6,"-5,-2"
5883,720575940624976883,right,L5,563,5,-13,-12,-1,"5,-13"
5884,720575940623948983,right,L5,564,3,-23,-15,-8,"3,-23"
5885,720575940609638923,right,L5,565,0,-26,-13,-13,"0,-26"
5886,720575940619212198,right,L5,566,5,-8,-9,1,"5,-8"
5887,720575940644033646,right,L5,567,-2,22,13,9,"-2,22"
5888,720575940638265310,right,L5,568,-6,-8,2,-10,"-6,-8"
5889,720575940631749061,right,L5,569,6,6,-3,9,"6,6"
5890,720575940624750484,right,L5,570,2,25,10,15,"2,25"
5891,720575940615427495,right,L5,571,0,-14,-7,-7,"0,-14"
5892,720575940621143405,right,L5,572,-8,3,9,-6,"-8,3"
5893,720575940628880578,right,L5,573,4,14,3,11,"4,14"
5894,720575940616976443,right,L5,574,-6,5,8,-3,"-6,5"
5895,720575940613201381,right,L5,575,6,9,-2,11,"6,9"
5896,720575940623090726,right,L5,576,0,28,14,14,"0,28"
5897,720575940611214290,right,L5,577,5,-14,-12,-2,"5,-14"
5898,720575940623314445,right,L5,578,4,-11,-10,-1,"4,-11"
5899,720575940632782028,right,L5,579,-3,-10,-2,-8,"-3,-10"
5900,720575940652738806,right,L5,580,-2,-23,-10,-13,"-2,-23"
5901,720575940604958688,right,L5,581,3,9,1,8,"3,9"
5902,720575940617724601,right,L5,582,-1,23,12,11,"-1,23"
5903,720575940620516544,right,L5,583,3,-25,-16,-9,"3,-25"
5904,720575940630847628,right,L5,584,4,23,7,16,"4,23"
5905,720575940613591533,right,L5,585,-1,-23,-11,-12,"-1,-23"
5906,720575940650009977,right,L5,586,2,18,7,11,"2,18"
5907,720575940630909016,right,L5,587,4,22,7,15,"4,22"
5908,720575940648653700,right,L5,588,1,4,1,3,"1,4"
5909,720575940628789303,right,L5,589,-1,-5,-2,-3,"-1,-5"
5910,720575940625053939,right,L5,590,1,9,3,6,"1,9"
5911,720575940622241050,right,L5,591,3,-3,-5,2,"3,-3"
5912,720575940605857638,right,L5,593,3,-14,-10,-4,"3,-14"
5913,720575940630499833,right,L5,594,7,-16,-15,-1,"7,-16"
5914,720575940615619231,right,L5,595,7,-12,-13,1,"7,-12"
5915,720575940628475816,right,L5,596,-4,-16,-4,-12,"-4,-16"
5916,720575940631194821,right,L5,597,4,1,-4,5,"4,1"
5917,720575940638794037,right,L5,598,2,-18,-11,-7,"2,-18"
5918,720575940616665181,right,L5,599,-1,9,5,4,"-1,9"
5919,720575940630778103,right,L5,600,3,-10,-8,-2,"3,-10"
5920,720575940641438453,right,L5,601,1,16,7,9,"1,16"
5921,720575940628570630,right,L5,602,4,-2,-5,3,"4,-2"
5922,720575940615262570,right,L5,603,-3,-23,-9,-14,"-3,-23"
5923,720575940614125608,right,L5,604,-6,-17,-3,-14,"-6,-17"
5924,720575940628030724,right,L5,605,3,15,4,11,"3,15"
5925,720575940608337522,right,L5,606,-1,-19,-9,-10,"-1,-19"
5926,720575940621022034,right,L5,607,1,18,8,10,"1,18"
5927,720575940608632547,right,L5,608,1,10,4,6,"1,10"
5928,720575940621744961,right,L5,609,-2,0,2,-2,"-2,0"
5929,720575940620608647,right,L5,610,2,-23,-14,-9,"2,-23"
5930,720575940607757257,right,L5,611,-1,-18,-8,-10,"-1,-18"
5931,720575940623163817,right,L5,612,-3,-26,-10,-16,"-3,-26"
5932,720575940638214975,right,L5,613,-8,-4,6,-10,"-8,-4"
5933,720575940635171747,right,L5,614,-2,-8,-2,-6,"-2,-8"
5934,720575940623422344,right,L5,615,-7,-7,3,-10,"-7,-7"
5935,720575940638487774,right,L5,616,-3,15,10,5,"-3,15"
5936,720575940620127573,right,L5,617,-2,-17,-7,-10,"-2,-17"
5937,720575940615684498,right,L5,618,-1,24,13,11,"-1,24"
5938,720575940620407943,right,L5,619,-4,-19,-6,-13,"-4,-19"
5939,720575940639980195,right,L5,620,7,1,-7,8,"7,1"
5940,720575940632731417,right,L5,621,1,24,11,13,"1,24"
5941,720575940622494725,right,L5,622,-5,20,15,5,"-5,20"
5942,720575940632547409,right,L5,623,1,13,5,8,"1,13"
5943,720575940626584506,right,L5,624,1,-17,-10,-7,"1,-17"
5944,720575940620827730,right,L5,625,-2,24,14,10,"-2,24"
5945,720575940623380616,right,L5,626,-5,-8,1,-9,"-5,-8"
5946,720575940626399821,right,L5,627,0,-1,-1,0,"0,-1"
5947,720575940628325735,right,L5,628,0,0,0,0,"0,0"
5948,720575940628656427,right,L5,629,4,24,8,16,"4,24"
5949,720575940624475786,right,L5,630,4,8,0,8,"4,8"
5950,720575940620666962,right,L5,631,1,26,12,14,"1,26"
5951,720575940634032796,right,L5,632,3,-20,-13,-7,"3,-20"
5952,720575940629079811,right,L5,633,-1,-24,-11,-13,"-1,-24"
5953,720575940622456700,right,L5,634,-3,-15,-5,-10,"-3,-15"
5954,720575940630242048,right,L5,635,6,-6,-9,3,"6,-6"
5955,720575940614340502,right,L5,636,0,6,3,3,"0,6"
5956,720575940613833586,right,L5,637,3,-21,-14,-7,"3,-21"
5957,720575940609685717,right,L5,638,-1,7,4,3,"-1,7"
5958,720575940623361238,right,L5,639,-4,19,13,6,"-4,19"
5959,720575940613516310,right,L5,640,-1,-16,-7,-9,"-1,-16"
5960,720575940625196327,right,L5,641,-8,-5,5,-10,"-8,-5"
5961,720575940624796233,right,L5,642,-5,-11,-1,-10,"-5,-11"
5962,720575940616859963,right,L5,643,6,14,1,13,"6,14"
5963,720575940632804665,right,L5,644,-6,18,15,3,"-6,18"
5964,720575940611225698,right,L5,645,-4,27,17,10,"-4,27"
5965,720575940631725655,right,L5,646,6,17,2,15,"6,17"
5966,720575940624597995,right,L5,647,-4,-7,0,-7,"-4,-7"
5967,720575940617468043,right,L5,648,1,7,2,5,"1,7"
5968,720575940621790685,right,L5,649,-1,5,3,2,"-1,5"
5969,720575940627910419,right,L5,650,-3,-25,-10,-15,"-3,-25"
5970,720575940633533132,right,L5,651,-4,-5,1,-6,"-4,-5"
5971,720575940629884798,right,L5,652,-6,-11,0,-11,"-6,-11"
5972,720575940636247732,right,L5,653,-6,-12,0,-12,"-6,-12"
5973,720575940643860276,right,L5,654,-3,8,7,1,"-3,8"
5974,720575940621629044,right,L5,655,6,-1,-7,6,"6,-1"
5975,720575940645187351,right,L5,656,0,-11,-6,-5,"0,-11"
5976,720575940615395478,right,L5,657,-2,-25,-11,-14,"-2,-25"
5977,720575940640966096,right,L5,658,1,20,9,11,"1,20"
5978,720575940630905849,right,L5,659,-4,-6,1,-7,"-4,-6"
5979,720575940632524074,right,L5,660,2,28,12,16,"2,28"
5980,720575940619212613,right,L5,661,-3,14,10,4,"-3,14"
5981,720575940637727834,right,L5,662,2,-1,-3,2,"2,-1"
5982,720575940615695071,right,L5,663,0,8,4,4,"0,8"
5983,720575940620095623,right,L5,664,1,-27,-15,-12,"1,-27"
5984,720575940613037590,right,L5,665,7,-2,-8,6,"7,-2"
5985,720575940624523243,right,L5,666,7,-13,-14,1,"7,-13"
5986,720575940605919712,right,L5,667,1,-28,-15,-13,"1,-28"
5987,720575940622673996,right,L5,668,1,19,8,11,"1,19"
5988,720575940644122990,right,L5,669,4,-16,-12,-4,"4,-16"
5989,720575940629857579,right,L5,670,5,5,-3,8,"5,5"
5990,720575940628675144,right,L5,671,-4,-23,-8,-15,"-4,-23"
5991,720575940629519403,right,L5,672,-8,11,13,-2,"-8,11"
5992,720575940632731935,right,L5,673,2,5,0,5,"2,5"
5993,720575940629097744,right,L5,674,-4,-14,-3,-11,"-4,-14"
5994,720575940622267539,right,L5,675,-7,19,16,3,"-7,19"
5995,720575940621109613,right,L5,676,-3,-21,-8,-13,"-3,-21"
5996,720575940621805238,right,L5,677,0,11,5,6,"0,11"
5997,720575940624997619,right,L5,678,3,-7,-7,0,"3,-7"
5998,720575940640671805,right,L5,679,4,18,5,13,"4,18"
5999,720575940604947680,right,L5,680,-1,25,13,12,"-1,25"
6000,720575940614952594,right,L5,681,-2,-21,-9,-12,"-2,-21"
6001,720575940630406364,right,L5,682,6,-8,-10,2,"6,-8"
6002,720575940612243313,right,L5,683,2,6,1,5,"2,6"
6003,720575940638537816,right,L5,685,-5,-9,0,-9,"-5,-9"
6004,720575940631452923,right,L5,686,5,-22,-16,-6,"5,-22"
6005,720575940660348801,right,L5,687,-6,-3,4,-7,"-6,-3"
6006,720575940618100308,right,L5,688,-7,10,12,-2,"-7,10"
6007,720575940615711391,right,L5,689,-2,18,11,7,"-2,18"
6008,720575940616817013,right,L5,690,-7,-3,5,-8,"-7,-3"
6009,720575940630379735,right,L5,691,-9,4,11,-7,"-9,4"
6010,720575940623652301,right,L5,692,-4,24,16,8,"-4,24"
6011,720575940628640471,right,L5,693,-3,25,15,10,"-3,25"
6012,720575940628382607,right,L5,695,-6,10,11,-1,"-6,10"
6013,720575940631555090,right,L5,696,-2,16,10,6,"-2,16"
6014,720575940618250821,right,L5,697,1,-22,-12,-10,"1,-22"
6015,720575940616331586,right,L5,698,6,-7,-10,3,"6,-7"
6016,720575940633377484,right,L5,699,-5,0,5,-5,"-5,0"
6017,720575940630154041,right,L5,700,5,15,2,13,"5,15"
6018,720575940607202178,right,L5,701,0,-4,-2,-2,"0,-4"
6019,720575940608913673,right,L5,702,-5,23,16,7,"-5,23"
6020,720575940630886135,right,L5,703,-3,1,3,-2,"-3,1"
6021,720575940624795831,right,L5,704,-7,8,11,-3,"-7,8"
6022,720575940626485129,right,L5,705,1,1,-1,2,"1,1"
6023,720575940638594020,right,L5,706,-7,-12,1,-13,"-7,-12"
6024,720575940619240862,right,L5,707,-2,25,14,11,"-2,25"
6025,720575940638154608,right,L5,708,-4,-25,-9,-16,"-4,-25"
6026,720575940628265575,right,L5,709,-2,-24,-10,-14,"-2,-24"
6027,720575940628791095,right,L5,710,4,-25,-17,-8,"4,-25"
6028,720575940628423623,right,L5,711,-1,19,10,9,"-1,19"
6029,720575940622549324,right,L5,712,-7,12,13,-1,"-7,12"
6030,720575940624103914,right,L5,713,-6,16,14,2,"-6,16"
6031,720575940625534285,right,L5,714,5,12,1,11,"5,12"
6032,720575940606706366,right,L5,715,4,10,1,9,"4,10"
6033,720575940619166518,right,L5,716,4,-6,-7,1,"4,-6"
6034,720575940632451944,right,L5,717,2,-22,-13,-9,"2,-22"
6035,720575940626142757,right,L5,718,-5,24,17,7,"-5,24"
6036,720575940623134744,right,L5,719,1,27,12,15,"1,27"
6037,720575940624126157,right,L5,720,-5,21,15,6,"-5,21"
6038,720575940637773278,right,L5,721,5,13,1,12,"5,13"
6039,720575940630893817,right,L5,722,6,-15,-14,-1,"6,-15"
6040,720575940618285392,right,L5,723,-2,-11,-4,-7,"-2,-11"
6041,720575940641484021,right,L5,724,4,2,-3,5,"4,2"
6042,720575940627376958,right,L5,725,-3,-24,-9,-15,"-3,-24"
6043,720575940618458769,right,L5,726,2,-28,-16,-12,"2,-28"
6044,720575940616951669,right,L5,728,7,12,-1,13,"7,12"
6045,720575940635180395,right,L5,729,-3,29,17,12,"-3,29"
6046,720575940625013255,right,L5,730,7,0,-7,7,"7,0"
6047,720575940648102020,right,L5,731,-6,9,10,-1,"-6,9"
6048,720575940625056231,right,L5,732,-3,6,6,0,"-3,6"
6049,720575940612731541,right,L5,733,-5,-17,-4,-13,"-5,-17"
6050,720575940614315315,right,L5,734,2,0,-2,2,"2,0"
6051,720575940624376503,right,L5,735,1,-23,-13,-10,"1,-23"
6052,720575940627561554,right,L5,736,-8,1,8,-7,"-8,1"
6053,720575940612036245,right,L5,737,0,19,9,10,"0,19"
6054,720575940625751102,right,L5,738,-3,13,9,4,"-3,13"
6055,720575940611700942,right,L5,739,-7,2,8,-6,"-7,2"
6056,720575940632796217,right,L5,740,2,-8,-6,-2,"2,-8"
6057,720575940635203747,right,L5,741,-2,-14,-5,-9,"-2,-14"
6058,720575940611441966,right,L5,742,-4,11,9,2,"-4,11"
6059,720575940621873833,right,L5,743,6,-19,-16,-3,"6,-19"
6060,720575940637686414,right,L5,744,-4,25,16,9,"-4,25"
6061,720575940620909761,right,L5,745,0,13,6,7,"0,13"
6062,720575940637465701,right,L5,746,-3,3,4,-1,"-3,3"
6063,720575940614016150,right,L5,747,0,2,1,1,"0,2"
6064,720575940610137557,right,L5,748,-4,20,14,6,"-4,20"
6065,720575940624593738,right,L5,749,-2,1,2,-1,"-2,1"
6066,720575940632881491,right,L5,750,4,-24,-16,-8,"4,-24"
6067,720575940626952325,right,L5,751,1,6,2,4,"1,6"
6068,720575940621695983,right,L5,752,-2,7,5,2,"-2,7"
6069,720575940616797813,right,L5,753,-3,24,15,9,"-3,24"
6070,720575940621775877,right,L5,754,-1,-13,-6,-7,"-1,-13"
6071,720575940630926680,right,L5,755,4,19,5,14,"4,19"
6072,720575940630807607,right,L5,756,5,20,5,15,"5,20"
6073,720575940619993803,right,L5,757,0,-6,-3,-3,"0,-6"
6074,720575940641536245,right,L5,758,5,-1,-6,5,"5,-1"
6075,720575940618673472,right,L5,759,7,14,0,14,"7,14"
6076,720575940626092080,right,L5,760,0,17,8,9,"0,17"
6077,720575940640062296,right,L5,761,-4,-18,-5,-13,"-4,-18"
6078,720575940627537930,right,L5,762,0,14,7,7,"0,14"
6079,720575940637363342,right,L5,764,-8,-6,5,-11,"-8,-6"
6080,720575940626849641,right,L5,765,-3,9,7,2,"-3,9"
6081,720575940646704419,right,L5,766,2,-4,-4,0,"2,-4"
6082,720575940613378531,right,L5,768,3,5,-1,6,"3,5"
6083,720575940620648112,right,L5,770,5,4,-3,7,"5,4"
6084,720575940621673862,right,L5,771,3,-27,-17,-10,"3,-27"
6085,720575940614606061,right,L5,772,1,12,5,7,"1,12"
6086,720575940626690588,right,L5,773,5,-19,-15,-4,"5,-19"
6087,720575940611386842,right,L5,774,-8,6,11,-5,"-8,6"
6088,720575940628095048,right,L5,775,5,22,6,16,"5,22"
6089,720575940624035268,right,L5,776,5,21,5,16,"5,21"
6090,720575940629505835,right,L5,777,6,20,4,16,"6,20"
6091,720575940627985162,right,L5,778,4,25,8,17,"4,25"
6092,720575940642222811,right,L5,779,5,24,7,17,"5,24"
6093,720575940631838807,right,L5,780,-6,25,18,7,"-6,25"
6094,720575940631989063,right,L5,781,-5,26,18,8,"-5,26"
6095,720575940635697087,right,L5,783,-4,28,18,10,"-4,28"
6096,720575940615141039,right,L5,784,-4,29,18,11,"-4,29"
6097,720575940622025382,right,L5,785,-3,30,18,12,"-3,30"
6098,720575940608267650,right,L5,786,-2,30,17,13,"-2,30"
6099,720575940636216568,right,L5,790,-2,-27,-12,-15,"-2,-27"
6100,720575940623917411,right,L5,791,-1,-28,-13,-15,"-1,-28"
6101,720575940620220581,right,L5,792,8,2,-7,9,"8,2"
6102,720575940618584091,right,L5,793,8,-6,-11,5,"8,-6"
6103,720575940622242053,right,L5,794,5,-26,-18,-8,"5,-26"
6104,720575940618890910,right,L5,795,6,-21,-17,-4,"6,-21"
6105,720575940618840221,right,L5,796,4,26,9,17,"4,26"
6106,720575940634524441,right,Mi4,1,-6,13,12,1,"-6,13"
6107,720575940636731247,right,Mi4,2,-8,2,9,-7,"-8,2"
6108,720575940610068270,right,Mi4,3,6,-12,-12,0,"6,-12"
6109,720575940623038135,right,Mi4,4,-5,-21,-6,-15,"-5,-21"
6110,720575940623102307,right,Mi4,5,-1,16,9,7,"-1,16"
6111,720575940622223088,right,Mi4,6,-2,-4,0,-4,"-2,-4"
6112,720575940632738385,right,Mi4,7,-6,-6,3,-9,"-6,-6"
6113,720575940643981728,right,Mi4,8,-4,26,17,9,"-4,26"
6114,720575940612088725,right,Mi4,9,4,9,0,9,"4,9"
6115,720575940620265432,right,Mi4,10,5,-15,-13,-2,"5,-15"
6116,720575940612862230,right,Mi4,11,7,-14,-14,0,"7,-14"
6117,720575940615700369,right,Mi4,12,-7,9,11,-2,"-7,9"
6118,720575940613553381,right,Mi4,13,-1,-26,-12,-14,"-1,-26"
6119,720575940617871956,right,Mi4,14,0,-27,-14,-13,"0,-27"
6120,720575940625524794,right,Mi4,15,2,-3,-4,1,"2,-3"
6121,720575940626461801,right,Mi4,16,-2,-16,-6,-10,"-2,-16"
6122,720575940638419363,right,Mi4,17,1,-5,-4,-1,"1,-5"
6123,720575940619022529,right,Mi4,18,5,-16,-13,-3,"5,-16"
6124,720575940629552215,right,Mi4,19,-7,17,15,2,"-7,17"
6125,720575940618519526,right,Mi4,20,3,-11,-9,-2,"3,-11"
6126,720575940613649125,right,Mi4,21,-2,19,11,8,"-2,19"
6127,720575940611535257,right,Mi4,22,-1,3,2,1,"-1,3"
6128,720575940619744728,right,Mi4,23,-3,-16,-5,-11,"-3,-16"
6129,720575940618990689,right,Mi4,24,-1,-10,-4,-6,"-1,-10"
6130,720575940612182312,right,Mi4,25,-9,3,10,-7,"-9,3"
6131,720575940630770550,right,Mi4,26,1,-3,-3,0,"1,-3"
6132,720575940624376573,right,Mi4,27,0,-25,-13,-12,"0,-25"
6133,720575940625097998,right,Mi4,28,5,6,-2,8,"5,6"
6134,720575940617739933,right,Mi4,29,-1,-3,-1,-2,"-1,-3"
6135,720575940628575765,right,Mi4,30,6,16,2,14,"6,16"
6136,720575940644239560,right,Mi4,31,0,16,8,8,"0,16"
6137,720575940618558804,right,Mi4,32,0,12,6,6,"0,12"
6138,720575940630003834,right,Mi4,33,3,18,6,12,"3,18"
6139,720575940617336294,right,Mi4,34,6,18,3,15,"6,18"
6140,720575940630077946,right,Mi4,35,1,-24,-13,-11,"1,-24"
6141,720575940634893975,right,Mi4,36,6,8,-2,10,"6,8"
6142,720575940624524071,right,Mi4,37,1,5,1,4,"1,5"
6143,720575940614630722,right,Mi4,38,0,-2,-1,-1,"0,-2"
6144,720575940636202095,right,Mi4,39,0,20,10,10,"0,20"
6145,720575940618036258,right,Mi4,40,-2,-6,-1,-5,"-2,-6"
6146,720575940605349804,right,Mi4,41,-3,28,17,11,"-3,28"
6147,720575940614750530,right,Mi4,42,-1,14,8,6,"-1,14"
6148,720575940620016251,right,Mi4,43,-5,18,14,4,"-5,18"
6149,720575940627081474,right,Mi4,44,5,-10,-10,0,"5,-10"
6150,720575940627592018,right,Mi4,45,-5,-1,4,-5,"-5,-1"
6151,720575940637908131,right,Mi4,46,-5,15,12,3,"-5,15"
6152,720575940623360492,right,Mi4,47,-9,-1,8,-9,"-9,-1"
6153,720575940630622713,right,Mi4,48,-4,-22,-7,-15,"-4,-22"
6154,720575940624711658,right,Mi4,49,4,-4,-6,2,"4,-4"
6155,720575940621937904,right,Mi4,50,-2,21,12,9,"-2,21"
6156,720575940623104280,right,Mi4,51,0,-19,-10,-9,"0,-19"
6157,720575940639075817,right,Mi4,52,-1,-22,-10,-12,"-1,-22"
6158,720575940624200887,right,Mi4,53,5,14,2,12,"5,14"
6159,720575940622061061,right,Mi4,54,-4,3,5,-2,"-4,3"
6160,720575940632897873,right,Mi4,55,-4,-11,-2,-9,"-4,-11"
6161,720575940627783817,right,Mi4,56,1,-13,-8,-5,"1,-13"
6162,720575940617102348,right,Mi4,57,6,-11,-12,1,"6,-11"
6163,720575940605893408,right,Mi4,58,3,12,3,9,"3,12"
6164,720575940627011076,right,Mi4,59,-2,2,3,-1,"-2,2"
6165,720575940621508649,right,Mi4,60,-8,8,12,-4,"-8,8"
6166,720575940632596511,right,Mi4,61,-4,-4,2,-6,"-4,-4"
6167,720575940634685375,right,Mi4,62,0,-29,-15,-14,"0,-29"
6168,720575940624907924,right,Mi4,63,4,12,2,10,"4,12"
6169,720575940660397441,right,Mi4,64,4,-23,-16,-7,"4,-23"
6170,720575940627356682,right,Mi4,65,-1,28,15,13,"-1,28"
6171,720575940618090141,right,Mi4,66,2,15,5,10,"2,15"
6172,720575940615156107,right,Mi4,67,-2,-13,-5,-8,"-2,-13"
6173,720575940623125859,right,Mi4,68,3,16,5,11,"3,16"
6174,720575940620113969,right,Mi4,69,1,8,3,5,"1,8"
6175,720575940635141530,right,Mi4,70,-4,21,14,7,"-4,21"
6176,720575940624141960,right,Mi4,71,-2,-3,0,-3,"-2,-3"
6177,720575940635663467,right,Mi4,72,0,-28,-14,-14,"0,-28"
6178,720575940620822352,right,Mi4,73,2,2,-1,3,"2,2"
6179,720575940624877838,right,Mi4,74,-1,-9,-4,-5,"-1,-9"
6180,720575940624354348,right,Mi4,75,-6,14,13,1,"-6,14"
6181,720575940613027301,right,Mi4,76,-3,-4,1,-5,"-3,-4"
6182,720575940615819388,right,Mi4,77,2,-5,-5,0,"2,-5"
6183,720575940622464636,right,Mi4,78,2,20,8,12,"2,20"
6184,720575940628006056,right,Mi4,79,2,1,-2,3,"2,1"
6185,720575940621104716,right,Mi4,80,4,13,2,11,"4,13"
6186,720575940630442199,right,Mi4,81,6,-2,-7,5,"6,-2"
6187,720575940627054595,right,Mi4,82,-7,7,10,-3,"-7,7"
6188,720575940607179138,right,Mi4,83,2,-21,-13,-8,"2,-21"
6189,720575940624247479,right,Mi4,84,-2,12,8,4,"-2,12"
6190,720575940621509046,right,Mi4,85,4,-22,-15,-7,"4,-22"
6191,720575940627499530,right,Mi4,86,-5,-7,1,-8,"-5,-7"
6192,720575940628295428,right,Mi4,87,1,11,4,7,"1,11"
6193,720575940622310938,right,Mi4,89,1,-19,-11,-8,"1,-19"
6194,720575940628813800,right,Mi4,90,-4,5,6,-1,"-4,5"
6195,720575940624190759,right,Mi4,91,-1,6,4,2,"-1,6"
6196,720575940622311126,right,Mi4,93,-6,3,7,-4,"-6,3"
6197,720575940623039368,right,Mi4,94,5,18,4,14,"5,18"
6198,720575940612160113,right,Mi4,95,4,-21,-15,-6,"4,-21"
6199,720575940622296692,right,Mi4,96,1,-10,-6,-4,"1,-10"
6200,720575940628510459,right,Mi4,97,-5,2,6,-4,"-5,2"
6201,720575940624846375,right,Mi4,98,-1,-12,-5,-7,"-1,-12"
6202,720575940623184929,right,Mi4,99,4,15,3,12,"4,15"
6203,720575940623787619,right,Mi4,100,2,-10,-7,-3,"2,-10"
6204,720575940618576704,right,Mi4,101,-7,6,10,-4,"-7,6"
6205,720575940632895059,right,Mi4,102,3,13,3,10,"3,13"
6206,720575940609319772,right,Mi4,103,7,9,-3,12,"7,9"
6207,720575940614882666,right,Mi4,104,-1,-27,-13,-14,"-1,-27"
6208,720575940624593643,right,Mi4,105,3,22,8,14,"3,22"
6209,720575940628056320,right,Mi4,106,-7,11,12,-1,"-7,11"
6210,720575940623602410,right,Mi4,107,8,-2,-9,7,"8,-2"
6211,720575940641859291,right,Mi4,108,-3,-12,-3,-9,"-3,-12"
6212,720575940616568645,right,Mi4,109,4,-5,-7,2,"4,-5"
6213,720575940627167567,right,Mi4,110,-7,0,7,-7,"-7,0"
6214,720575940639854243,right,Mi4,111,2,-24,-14,-10,"2,-24"
6215,720575940619574192,right,Mi4,112,-6,1,6,-5,"-6,1"
6216,720575940620314352,right,Mi4,113,-2,4,4,0,"-2,4"
6217,720575940634356660,right,Mi4,114,2,-13,-9,-4,"2,-13"
6218,720575940624187831,right,Mi4,115,-4,2,5,-3,"-4,2"
6219,720575940605106110,right,Mi4,116,-1,-8,-3,-5,"-1,-8"
6220,720575940619632566,right,Mi4,117,-8,-2,7,-9,"-8,-2"
6221,720575940618086710,right,Mi4,118,3,1,-3,4,"3,1"
6222,720575940626168348,right,Mi4,119,-2,6,5,1,"-2,6"
6223,720575940628016400,right,Mi4,120,-1,-1,0,-1,"-1,-1"
6224,720575940625258136,right,Mi4,121,-8,4,10,-6,"-8,4"
6225,720575940619893887,right,Mi4,122,-5,9,9,0,"-5,9"
6226,720575940633272983,right,Mi4,123,-8,10,13,-3,"-8,10"
6227,720575940631149655,right,Mi4,124,1,-7,-5,-2,"1,-7"
6228,720575940610888198,right,Mi4,125,5,9,-1,10,"5,9"
6229,720575940622332954,right,Mi4,126,3,11,2,9,"3,11"
6230,720575940616845941,right,Mi4,127,0,15,7,8,"0,15"
6231,720575940635190623,right,Mi4,128,3,-22,-14,-8,"3,-22"
6232,720575940630486265,right,Mi4,129,0,-13,-7,-6,"0,-13"
6233,720575940635140709,right,Mi4,131,-6,20,16,4,"-6,20"
6234,720575940642495373,right,Mi4,132,2,4,0,4,"2,4"
6235,720575940635694772,right,Mi4,133,-3,20,13,7,"-3,20"
6236,720575940624729236,right,Mi4,134,-5,-18,-4,-14,"-5,-18"
6237,720575940610711189,right,Mi4,135,-3,-22,-8,-14,"-3,-22"
6238,720575940626623690,right,Mi4,136,0,3,1,2,"0,3"
6239,720575940622218785,right,Mi4,137,5,-7,-9,2,"5,-7"
6240,720575940617722257,right,Mi4,138,0,27,13,14,"0,27"
6241,720575940626661950,right,Mi4,139,1,-14,-8,-6,"1,-14"
6242,720575940636327598,right,Mi4,140,3,8,1,7,"3,8"
6243,720575940617465273,right,Mi4,141,5,-23,-17,-6,"5,-23"
6244,720575940621800630,right,Mi4,142,-2,-18,-7,-11,"-2,-18"
6245,720575940661041025,right,Mi4,143,-4,16,12,4,"-4,16"
6246,720575940636761518,right,Mi4,144,7,-11,-13,2,"7,-11"
6247,720575940616588486,right,Mi4,145,0,4,2,2,"0,4"
6248,720575940623585463,right,Mi4,146,1,-6,-4,-2,"1,-6"
6249,720575940624252671,right,Mi4,147,1,21,9,12,"1,21"
6250,720575940632075724,right,Mi4,148,-7,-11,1,-12,"-7,-11"
6251,720575940617101106,right,Mi4,149,6,-14,-13,-1,"6,-14"
6252,720575940631056865,right,Mi4,150,-8,5,10,-5,"-8,5"
6253,720575940644090568,right,Mi4,151,-3,-14,-4,-10,"-3,-14"
6254,720575940611275491,right,Mi4,152,3,-15,-11,-4,"3,-15"
6255,720575940626783228,right,Mi4,153,8,0,-8,8,"8,0"
6256,720575940629822531,right,Mi4,154,-8,0,8,-8,"-8,0"
6257,720575940633557355,right,Mi4,156,-9,1,9,-8,"-9,1"
6258,720575940639798400,right,Mi4,157,-1,-7,-3,-4,"-1,-7"
6259,720575940614912402,right,Mi4,158,3,-5,-6,1,"3,-5"
6260,720575940615111018,right,Mi4,159,7,7,-4,11,"7,7"
6261,720575940635684276,right,Mi4,160,-2,20,12,8,"-2,20"
6262,720575940620378247,right,Mi4,161,4,-14,-11,-3,"4,-14"
6263,720575940620365505,right,Mi4,162,-4,-2,3,-5,"-4,-2"
6264,720575940611410915,right,Mi4,163,-9,7,12,-5,"-9,7"
6265,720575940619263568,right,Mi4,164,-1,-2,0,-2,"-1,-2"
6266,720575940621900502,right,Mi4,165,4,16,4,12,"4,16"
6267,720575940622870781,right,Mi4,166,0,18,9,9,"0,18"
6268,720575940627336548,right,Mi4,167,0,-17,-9,-8,"0,-17"
6269,720575940624544915,right,Mi4,168,-1,17,9,8,"-1,17"
6270,720575940622177379,right,Mi4,169,0,-18,-9,-9,"0,-18"
6271,720575940639987584,right,Mi4,170,-5,1,5,-4,"-5,1"
6272,720575940620532529,right,Mi4,171,6,-20,-16,-4,"6,-20"
6273,720575940638244068,right,Mi4,172,1,22,10,12,"1,22"
6274,720575940617870420,right,Mi4,173,2,-25,-15,-10,"2,-25"
6275,720575940614779229,right,Mi4,174,4,-15,-12,-3,"4,-15"
6276,720575940631604055,right,Mi4,175,-6,-7,2,-9,"-6,-7"
6277,720575940616130246,right,Mi4,176,-2,13,8,5,"-2,13"
6278,720575940633978007,right,Mi4,177,-2,-1,1,-2,"-2,-1"
6279,720575940617127307,right,Mi4,178,2,11,3,8,"2,11"
6280,720575940616913547,right,Mi4,179,-5,-16,-3,-13,"-5,-16"
6281,720575940637635294,right,Mi4,180,2,-27,-16,-11,"2,-27"
6282,720575940618477497,right,Mi4,181,1,-4,-3,-1,"1,-4"
6283,720575940616202589,right,Mi4,182,7,-10,-12,2,"7,-10"
6284,720575940635661466,right,Mi4,183,-5,-15,-3,-12,"-5,-15"
6285,720575940615783234,right,Mi4,184,-6,-5,3,-8,"-6,-5"
6286,720575940607509170,right,Mi4,185,2,-11,-8,-3,"2,-11"
6287,720575940622737117,right,Mi4,186,-1,26,14,12,"-1,26"
6288,720575940626863512,right,Mi4,187,3,21,7,14,"3,21"
6289,720575940627550280,right,Mi4,188,-5,17,13,4,"-5,17"
6290,720575940615749698,right,Mi4,189,6,13,0,13,"6,13"
6291,720575940638136902,right,Mi4,190,-3,-5,0,-5,"-3,-5"
6292,720575940605490790,right,Mi4,191,-1,-11,-5,-6,"-1,-11"
6293,720575940617127398,right,Mi4,193,-5,4,7,-3,"-5,4"
6294,720575940645611031,right,Mi4,194,0,-5,-3,-2,"0,-5"
6295,720575940650177145,right,Mi4,195,-3,-1,2,-3,"-3,-1"
6296,720575940644263959,right,Mi4,196,-1,8,5,3,"-1,8"
6297,720575940611097554,right,Mi4,197,0,-20,-10,-10,"0,-20"
6298,720575940625419412,right,Mi4,198,6,2,-5,7,"6,2"
6299,720575940645153303,right,Mi4,199,0,-12,-6,-6,"0,-12"
6300,720575940631676115,right,Mi4,200,-5,12,11,1,"-5,12"
6301,720575940629839738,right,Mi4,201,-8,9,12,-3,"-8,9"
6302,720575940633030611,right,Mi4,202,-1,27,14,13,"-1,27"
6303,720575940614265651,right,Mi4,203,3,-1,-4,3,"3,-1"
6304,720575940614614183,right,Mi4,204,5,-2,-6,4,"5,-2"
6305,720575940602943968,right,Mi4,205,5,-6,-8,2,"5,-6"
6306,720575940614410449,right,Mi4,206,-3,5,5,0,"-3,5"
6307,720575940625647800,right,Mi4,207,1,29,13,16,"1,29"
6308,720575940627936967,right,Mi4,208,5,-21,-16,-5,"5,-21"
6309,720575940616546278,right,Mi4,209,-3,-8,-1,-7,"-3,-8"
6310,720575940638170019,right,Mi4,210,-6,8,10,-2,"-6,8"
6311,720575940619426507,right,Mi4,211,-7,-1,6,-7,"-7,-1"
6312,720575940625378279,right,Mi4,212,2,-16,-10,-6,"2,-16"
6313,720575940613784223,right,Mi4,213,3,-4,-5,1,"3,-4"
6314,720575940620473876,right,Mi4,214,-5,3,6,-3,"-5,3"
6315,720575940628015379,right,Mi4,215,6,7,-3,10,"6,7"
6316,720575940618640965,right,Mi4,216,2,19,7,12,"2,19"
6317,720575940628889872,right,Mi4,217,6,15,1,14,"6,15"
6318,720575940614345169,right,Mi4,218,2,10,3,7,"2,10"
6319,720575940638155742,right,Mi4,219,6,-4,-8,4,"6,-4"
6320,720575940637498202,right,Mi4,220,2,-6,-5,-1,"2,-6"
6321,720575940619425739,right,Mi4,221,-7,3,8,-5,"-7,3"
6322,720575940621095361,right,Mi4,222,-3,26,16,10,"-3,26"
6323,720575940630888185,right,Mi4,223,-2,26,15,11,"-2,26"
6324,720575940647127348,right,Mi4,224,0,5,2,3,"0,5"
6325,720575940631021372,right,Mi4,225,2,-26,-15,-11,"2,-26"
6326,720575940620862993,right,Mi4,226,5,19,4,15,"5,19"
6327,720575940638517732,right,Mi4,227,-7,5,9,-4,"-7,5"
6328,720575940621752411,right,Mi4,228,-7,1,7,-6,"-7,1"
6329,720575940621195540,right,Mi4,229,5,2,-4,6,"5,2"
6330,720575940615801798,right,Mi4,230,2,9,2,7,"2,9"
6331,720575940629210076,right,Mi4,231,4,-12,-10,-2,"4,-12"
6332,720575940623697165,right,Mi4,232,-4,13,10,3,"-4,13"
6333,720575940623460339,right,Mi4,233,4,-13,-11,-2,"4,-13"
6334,720575940623635848,right,Mi4,235,4,11,1,10,"4,11"
6335,720575940621252779,right,Mi4,236,-1,4,3,1,"-1,4"
6336,720575940606978761,right,Mi4,237,-2,27,15,12,"-2,27"
6337,720575940641252048,right,Mi4,238,-8,-3,6,-9,"-8,-3"
6338,720575940613662530,right,Mi4,239,-6,6,9,-3,"-6,6"
6339,720575940621269998,right,Mi4,240,-4,-3,2,-5,"-4,-3"
6340,720575940614058280,right,Mi4,241,2,-17,-11,-6,"2,-17"
6341,720575940615758709,right,Mi4,242,-4,6,7,-1,"-4,6"
6342,720575940630780155,right,Mi4,243,-1,-21,-10,-11,"-1,-21"
6343,720575940623294925,right,Mi4,244,-4,-12,-2,-10,"-4,-12"
6344,720575940628537862,right,Mi4,245,-5,-3,3,-6,"-5,-3"
6345,720575940621511441,right,Mi4,246,-4,15,11,4,"-4,15"
6346,720575940624197045,right,Mi4,247,-4,-15,-4,-11,"-4,-15"
6347,720575940635737336,right,Mi4,248,-6,0,6,-6,"-6,0"
6348,720575940623309261,right,Mi4,249,2,-12,-8,-4,"2,-12"
6349,720575940620435024,right,Mi4,250,-1,1,1,0,"-1,1"
6350,720575940629939756,right,Mi4,251,-1,-14,-6,-8,"-1,-14"
6351,720575940617405755,right,Mi4,252,3,23,8,15,"3,23"
6352,720575940635146431,right,Mi4,253,5,16,3,13,"5,16"
6353,720575940611844787,right,Mi4,254,3,-24,-15,-9,"3,-24"
6354,720575940627501445,right,Mi4,255,-6,-13,-1,-12,"-6,-13"
6355,720575940617620993,right,Mi4,256,5,-20,-15,-5,"5,-20"
6356,720575940623174803,right,Mi4,257,2,21,8,13,"2,21"
6357,720575940613267367,right,Mi4,258,-4,-17,-5,-12,"-4,-17"
6358,720575940616352578,right,Mi4,259,-7,-5,4,-9,"-7,-5"
6359,720575940623112547,right,Mi4,260,-3,19,12,7,"-3,19"
6360,720575940616421307,right,Mi4,261,-1,13,7,6,"-1,13"
6361,720575940619173430,right,Mi4,262,1,-11,-7,-4,"1,-11"
6362,720575940613382678,right,Mi4,263,-3,4,5,-1,"-3,4"
6363,720575940628158184,right,Mi4,264,-1,-6,-2,-4,"-1,-6"
6364,720575940615810909,right,Mi4,265,-6,-1,5,-6,"-6,-1"
6365,720575940628977168,right,Mi4,266,-1,-25,-12,-13,"-1,-25"
6366,720575940630369989,right,Mi4,267,-6,2,7,-5,"-6,2"
6367,720575940623330062,right,Mi4,268,7,-6,-10,4,"7,-6"
6368,720575940624074436,right,Mi4,269,2,-19,-12,-7,"2,-19"
6369,720575940623580307,right,Mi4,270,1,-8,-5,-3,"1,-8"
6370,720575940628103428,right,Mi4,272,3,-2,-4,2,"3,-2"
6371,720575940607270018,right,Mi4,273,-6,23,17,6,"-6,23"
6372,720575940626479562,right,Mi4,274,6,4,-4,8,"6,4"
6373,720575940633695736,right,Mi4,275,-8,-1,7,-8,"-8,-1"
6374,720575940630659840,right,Mi4,276,2,3,-1,4,"2,3"
6375,720575940623437606,right,Mi4,277,7,-3,-9,6,"7,-3"
6376,720575940619772513,right,Mi4,278,-5,10,10,0,"-5,10"
6377,720575940618066978,right,Mi4,279,-4,8,8,0,"-4,8"
6378,720575940638834246,right,Mi4,280,-6,-14,-1,-13,"-6,-14"
6379,720575940628090156,right,Mi4,281,-9,2,10,-8,"-9,2"
6380,720575940636964975,right,Mi4,282,0,26,13,13,"0,26"
6381,720575940608910037,right,Mi4,283,-4,4,6,-2,"-4,4"
6382,720575940616952150,right,Mi4,284,0,25,12,13,"0,25"
6383,720575940639866275,right,Mi4,285,6,-18,-15,-3,"6,-18"
6384,720575940638121188,right,Mi4,286,0,-24,-12,-12,"0,-24"
6385,720575940619133489,right,Mi4,287,-5,13,11,2,"-5,13"
6386,720575940620774383,right,Mi4,288,-1,30,16,14,"-1,30"
6387,720575940652750838,right,Mi4,289,-1,11,6,5,"-1,11"
6388,720575940625847271,right,Mi4,290,5,-24,-17,-7,"5,-24"
6389,720575940617706937,right,Mi4,291,7,2,-6,8,"7,2"
6390,720575940642979876,right,Mi4,292,-4,18,13,5,"-4,18"
6391,720575940633215405,right,Mi4,293,4,-17,-13,-4,"4,-17"
6392,720575940622313249,right,Mi4,294,1,-20,-11,-9,"1,-20"
6393,720575940622201121,right,Mi4,295,-2,29,16,13,"-2,29"
6394,720575940645009444,right,Mi4,296,1,-18,-10,-8,"1,-18"
6395,720575940626846986,right,Mi4,297,7,-9,-12,3,"7,-9"
6396,720575940619767661,right,Mi4,298,-5,5,7,-2,"-5,5"
6397,720575940630247106,right,Mi4,299,-4,12,10,2,"-4,12"
6398,720575940627172248,right,Mi4,300,4,-18,-13,-5,"4,-18"
6399,720575940639800910,right,Mi4,301,-5,16,13,3,"-5,16"
6400,720575940620519333,right,Mi4,302,2,17,6,11,"2,17"
6401,720575940626369086,right,Mi4,303,-5,22,16,6,"-5,22"
6402,720575940621797756,right,Mi4,304,6,5,-4,9,"6,5"
6403,720575940610520014,right,Mi4,305,-7,4,9,-5,"-7,4"
6404,720575940636509326,right,Mi4,307,5,-25,-18,-7,"5,-25"
6405,720575940620074887,right,Mi4,308,-5,8,9,-1,"-5,8"
6406,720575940622337259,right,Mi4,309,-6,12,12,0,"-6,12"
6407,720575940623863531,right,Mi4,310,2,22,9,13,"2,22"
6408,720575940628966359,right,Mi4,311,-7,15,14,1,"-7,15"
6409,720575940620413609,right,Mi4,312,4,-7,-8,1,"4,-7"
6410,720575940635583584,right,Mi4,313,7,3,-6,9,"7,3"
6411,720575940640847704,right,Mi4,314,-9,5,11,-6,"-9,5"
6412,720575940643304352,right,Mi4,315,-3,-6,0,-6,"-3,-6"
6413,720575940623215529,right,Mi4,316,5,-4,-7,3,"5,-4"
6414,720575940627945384,right,Mi4,317,-5,-4,3,-7,"-5,-4"
6415,720575940618253083,right,Mi4,318,4,-19,-14,-5,"4,-19"
6416,720575940617101213,right,Mi4,319,-2,5,4,1,"-2,5"
6417,720575940629319579,right,Mi4,320,-2,-5,-1,-4,"-2,-5"
6418,720575940623144481,right,Mi4,321,8,4,-6,10,"8,4"
6419,720575940629471238,right,Mi4,322,2,26,11,15,"2,26"
6420,720575940621458378,right,Mi4,323,-7,-13,0,-13,"-7,-13"
6421,720575940630329088,right,Mi4,324,3,24,9,15,"3,24"
6422,720575940623304141,right,Mi4,325,5,1,-5,6,"5,1"
6423,720575940623421951,right,Mi4,326,2,16,6,10,"2,16"
6424,720575940624168959,right,Mi4,327,5,3,-4,7,"5,3"
6425,720575940623327495,right,Mi4,328,5,-9,-10,1,"5,-9"
6426,720575940641663952,right,Mi4,329,0,24,12,12,"0,24"
6427,720575940615343510,right,Mi4,330,3,3,-2,5,"3,3"
6428,720575940627966077,right,Mi4,331,1,-15,-9,-6,"1,-15"
6429,720575940630205054,right,Mi4,332,4,-26,-17,-9,"4,-26"
6430,720575940640347709,right,Mi4,333,0,-21,-11,-10,"0,-21"
6431,720575940626238666,right,Mi4,334,1,-26,-14,-12,"1,-26"
6432,720575940621314543,right,Mi4,335,2,8,2,6,"2,8"
6433,720575940623829738,right,Mi4,336,0,23,11,12,"0,23"
6434,720575940622305825,right,Mi4,337,-5,-6,2,-8,"-5,-6"
6435,720575940639110051,right,Mi4,338,-1,0,1,-1,"-1,0"
6436,720575940622685398,right,Mi4,339,6,11,-1,12,"6,11"
6437,720575940643986592,right,Mi4,340,-4,17,12,5,"-4,17"
6438,720575940611059922,right,Mi4,341,6,-17,-15,-2,"6,-17"
6439,720575940627225866,right,Mi4,342,2,-15,-10,-5,"2,-15"
6440,720575940627563653,right,Mi4,343,-3,27,16,11,"-3,27"
6441,720575940629731075,right,Mi4,344,-2,-15,-6,-9,"-2,-15"
6442,720575940632393291,right,Mi4,345,3,-12,-9,-3,"3,-12"
6443,720575940619773606,right,Mi4,346,-7,-9,2,-11,"-7,-9"
6444,720575940630877433,right,Mi4,347,-5,-13,-2,-11,"-5,-13"
6445,720575940626779013,right,Mi4,348,3,14,4,10,"3,14"
6446,720575940641388789,right,Mi4,349,-5,-14,-2,-12,"-5,-14"
6447,720575940632442951,right,Mi4,350,1,15,6,9,"1,15"
6448,720575940636747639,right,Mi4,351,-1,-17,-8,-9,"-1,-17"
6449,720575940632045891,right,Mi4,352,-2,28,16,12,"-2,28"
6450,720575940631618809,right,Mi4,353,2,24,10,14,"2,24"
6451,720575940638620905,right,Mi4,354,-2,-26,-11,-15,"-2,-26"
6452,720575940620712838,right,Mi4,355,-7,-6,4,-10,"-7,-6"
6453,720575940630220844,right,Mi4,356,0,22,11,11,"0,22"
6454,720575940635148468,right,Mi4,357,4,17,4,13,"4,17"
6455,720575940613979176,right,Mi4,358,-3,17,11,6,"-3,17"
6456,720575940631139435,right,Mi4,359,2,23,9,14,"2,23"
6457,720575940629029392,right,Mi4,360,-5,19,14,5,"-5,19"
6458,720575940621786401,right,Mi4,361,0,-7,-4,-3,"0,-7"
6459,720575940643988128,right,Mi4,362,2,-20,-12,-8,"2,-20"
6460,720575940636442725,right,Mi4,363,7,-4,-9,5,"7,-4"
6461,720575940638888245,right,Mi4,364,4,4,-2,6,"4,4"
6462,720575940615062191,right,Mi4,365,4,7,-1,8,"4,7"
6463,720575940605842878,right,Mi4,366,-5,-20,-5,-15,"-5,-20"
6464,720575940627773096,right,Mi4,367,-6,-15,-2,-13,"-6,-15"
6465,720575940635040887,right,Mi4,368,-4,-20,-6,-14,"-4,-20"
6466,720575940612333521,right,Mi4,369,5,-5,-8,3,"5,-5"
6467,720575940611114981,right,Mi4,370,-3,21,13,8,"-3,21"
6468,720575940606913154,right,Mi4,371,6,-5,-9,4,"6,-5"
6469,720575940628459281,right,Mi4,372,1,-2,-2,0,"1,-2"
6470,720575940627654202,right,Mi4,373,1,-21,-12,-9,"1,-21"
6471,720575940631541445,right,Mi4,374,2,13,4,9,"2,13"
6472,720575940630595103,right,Mi4,375,-6,7,9,-2,"-6,7"
6473,720575940610108484,right,Mi4,376,-7,-10,2,-12,"-7,-10"
6474,720575940623396607,right,Mi4,377,0,7,3,4,"0,7"
6475,720575940626360828,right,Mi4,378,-3,18,12,6,"-3,18"
6476,720575940654872737,right,Mi4,379,3,-17,-12,-5,"3,-17"
6477,720575940619741505,right,Mi4,380,-1,29,15,14,"-1,29"
6478,720575940621740404,right,Mi4,381,-8,-9,3,-12,"-8,-9"
6479,720575940612815346,right,Mi4,382,3,-6,-6,0,"3,-6"
6480,720575940625155884,right,Mi4,383,-6,11,11,0,"-6,11"
6481,720575940626375230,right,Mi4,384,-6,-2,5,-7,"-6,-2"
6482,720575940629765758,right,Mi4,385,-3,-18,-6,-12,"-3,-18"
6483,720575940645983511,right,Mi4,386,-6,19,15,4,"-6,19"
6484,720575940626347108,right,Mi4,387,-1,-15,-7,-8,"-1,-15"
6485,720575940610072644,right,Mi4,388,3,19,6,13,"3,19"
6486,720575940633542431,right,Mi4,389,-6,-16,-2,-14,"-6,-16"
6487,720575940625099364,right,Mi4,390,-6,-9,1,-10,"-6,-9"
6488,720575940610071108,right,Mi4,392,-4,7,7,0,"-4,7"
6489,720575940621837192,right,Mi4,393,-1,22,12,10,"-1,22"
6490,720575940638261311,right,Mi4,394,-7,-8,3,-11,"-7,-8"
6491,720575940627358474,right,Mi4,395,0,-22,-11,-11,"0,-22"
6492,720575940636370021,right,Mi4,396,-1,10,6,4,"-1,10"
6493,720575940629028337,right,Mi4,397,-3,-19,-7,-12,"-3,-19"
6494,720575940625079027,right,Mi4,398,-3,22,14,8,"-3,22"
6495,720575940641899483,right,Mi4,399,-4,-24,-8,-16,"-4,-24"
6496,720575940627344996,right,Mi4,401,-2,-19,-8,-11,"-2,-19"
6497,720575940632532428,right,Mi4,402,3,26,10,16,"3,26"
6498,720575940631572536,right,Mi4,403,-2,-12,-4,-8,"-2,-12"
6499,720575940616462523,right,Mi4,404,-1,20,11,9,"-1,20"
6500,720575940624249269,right,Mi4,405,3,10,2,8,"3,10"
6501,720575940610551506,right,Mi4,407,-5,-10,0,-10,"-5,-10"
6502,720575940639400893,right,Mi4,408,-6,-4,4,-8,"-6,-4"
6503,720575940622777880,right,Mi4,409,0,-3,-2,-1,"0,-3"
6504,720575940615559766,right,Mi4,410,-2,-2,1,-3,"-2,-2"
6505,720575940622684374,right,Mi4,411,-5,-19,-5,-14,"-5,-19"
6506,720575940624075824,right,Mi4,412,-6,21,16,5,"-6,21"
6507,720575940649871737,right,Mi4,413,-2,-7,-2,-5,"-2,-7"
6508,720575940606069937,right,Mi4,414,4,21,6,15,"4,21"
6509,720575940622122710,right,Mi4,415,6,12,0,12,"6,12"
6510,720575940637596649,right,Mi4,416,3,-8,-7,-1,"3,-8"
6511,720575940622837245,right,Mi4,417,-6,-10,1,-11,"-6,-10"
6512,720575940625573197,right,Mi4,418,-2,15,9,6,"-2,15"
6513,720575940640394867,right,Mi4,419,-3,-11,-3,-8,"-3,-11"
6514,720575940607476174,right,Mi4,420,6,-3,-8,5,"6,-3"
6515,720575940629241799,right,Mi4,422,-7,-4,5,-9,"-7,-4"
6516,720575940632045741,right,Mi4,423,3,-18,-12,-6,"3,-18"
6517,720575940632348995,right,Mi4,424,-3,-2,2,-4,"-3,-2"
6518,720575940605005280,right,Mi4,425,3,20,7,13,"3,20"
6519,720575940628015620,right,Mi4,426,-3,0,3,-3,"-3,0"
6520,720575940613085554,right,Mi4,427,5,-18,-14,-4,"5,-18"
6521,720575940636594533,right,Mi4,428,-2,23,13,10,"-2,23"
6522,720575940614885010,right,Mi4,429,-2,14,9,5,"-2,14"
6523,720575940612191345,right,Mi4,430,-3,-7,-1,-6,"-3,-7"
6524,720575940634626018,right,Mi4,431,-2,-10,-3,-7,"-2,-10"
6525,720575940616395963,right,Mi4,432,-5,7,8,-1,"-5,7"
6526,720575940641162203,right,Mi4,433,0,-8,-4,-4,"0,-8"
6527,720575940634233881,right,Mi4,434,-3,7,6,1,"-3,7"
6528,720575940626873718,right,Mi4,435,5,-17,-14,-3,"5,-17"
6529,720575940631598031,right,Mi4,436,0,-15,-8,-7,"0,-15"
6530,720575940612984725,right,Mi4,437,-3,12,9,3,"-3,12"
6531,720575940614618274,right,Mi4,438,2,27,11,16,"2,27"
6532,720575940628769385,right,Mi4,439,-3,-9,-2,-7,"-3,-9"
6533,720575940614905506,right,Mi4,440,1,23,10,13,"1,23"
6534,720575940629293628,right,Mi4,441,3,-16,-11,-5,"3,-16"
6535,720575940619988557,right,Mi4,442,-5,25,17,8,"-5,25"
6536,720575940618925739,right,Mi4,443,-6,4,8,-4,"-6,4"
6537,720575940620743706,right,Mi4,444,4,-10,-9,-1,"4,-10"
6538,720575940647233844,right,Mi4,445,-2,8,6,2,"-2,8"
6539,720575940626175162,right,Mi4,446,2,-14,-9,-5,"2,-14"
6540,720575940620492404,right,Mi4,447,-1,2,2,0,"-1,2"
6541,720575940622789409,right,Mi4,448,0,30,15,15,"0,30"
6542,720575940624485264,right,Mi4,449,6,-16,-14,-2,"6,-16"
6543,720575940612489565,right,Mi4,450,2,-9,-7,-2,"2,-9"
6544,720575940627758869,right,Mi4,451,4,20,6,14,"4,20"
6545,720575940616449074,right,Mi4,452,1,-9,-6,-3,"1,-9"
6546,720575940627219742,right,Mi4,453,3,25,9,16,"3,25"
6547,720575940615949791,right,Mi4,454,5,-12,-11,-1,"5,-12"
6548,720575940620701574,right,Mi4,455,7,-7,-11,4,"7,-7"
6549,720575940605809794,right,Mi4,456,0,21,10,11,"0,21"
6550,720575940620730817,right,Mi4,457,-2,17,10,7,"-2,17"
6551,720575940622805469,right,Mi4,458,5,0,-5,5,"5,0"
6552,720575940634644961,right,Mi4,459,5,-3,-7,4,"5,-3"
6553,720575940646092910,right,Mi4,460,-3,-20,-7,-13,"-3,-20"
6554,720575940641967349,right,Mi4,461,7,-5,-10,5,"7,-5"
6555,720575940618224667,right,Mi4,462,-1,18,10,8,"-1,18"
6556,720575940620347595,right,Mi4,463,5,17,3,14,"5,17"
6557,720575940623629094,right,Mi4,464,4,0,-4,4,"4,0"
6558,720575940630839656,right,Mi4,465,3,0,-3,3,"3,0"
6559,720575940630218178,right,Mi4,466,1,14,6,8,"1,14"
6560,720575940639604558,right,Mi4,467,-2,-20,-8,-12,"-2,-20"
6561,720575940621356626,right,Mi4,468,-3,11,8,3,"-3,11"
6562,720575940632696542,right,Mi4,469,-7,13,13,0,"-7,13"
6563,720575940624700088,right,Mi4,470,4,-9,-9,0,"4,-9"
6564,720575940623892685,right,Mi4,471,3,-26,-16,-10,"3,-26"
6565,720575940635330411,right,Mi4,472,1,25,11,14,"1,25"
6566,720575940624116407,right,Mi4,473,-4,23,15,8,"-4,23"
6567,720575940632534609,right,Mi4,474,-3,-17,-6,-11,"-3,-17"
6568,720575940605328928,right,Mi4,475,-4,-1,3,-4,"-4,-1"
6569,720575940616891148,right,Mi4,476,-1,15,8,7,"-1,15"
6570,720575940622166000,right,Mi4,477,-3,2,4,-2,"-3,2"
6571,720575940621111629,right,Mi4,478,-7,16,15,1,"-7,16"
6572,720575940623628582,right,Mi4,479,-2,10,7,3,"-2,10"
6573,720575940632084072,right,Mi4,480,3,-19,-13,-6,"3,-19"
6574,720575940608009750,right,Mi4,481,4,-8,-8,0,"4,-8"
6575,720575940628378311,right,Mi4,482,1,17,7,10,"1,17"
6576,720575940622666504,right,Mi4,483,2,-7,-6,-1,"2,-7"
6577,720575940623277069,right,Mi4,484,3,-9,-8,-1,"3,-9"
6578,720575940626092071,right,Mi4,485,-3,-3,1,-4,"-3,-3"
6579,720575940624170189,right,Mi4,486,0,1,0,1,"0,1"
6580,720575940621292826,right,Mi4,487,1,-1,-2,1,"1,-1"
6581,720575940630109440,right,Mi4,488,7,5,-5,10,"7,5"
6582,720575940636893582,right,Mi4,489,-3,10,8,2,"-3,10"
6583,720575940613952479,right,Mi4,490,-5,6,8,-2,"-5,6"
6584,720575940638771263,right,Mi4,491,7,-1,-8,7,"7,-1"
6585,720575940624254632,right,Mi4,492,-7,-2,6,-8,"-7,-2"
6586,720575940633696851,right,Mi4,493,-3,23,14,9,"-3,23"
6587,720575940628067836,right,Mi4,494,0,29,14,15,"0,29"
6588,720575940622048425,right,Mi4,497,6,1,-6,7,"6,1"
6589,720575940613059862,right,Mi4,498,6,10,-1,11,"6,10"
6590,720575940630625474,right,Mi4,499,5,10,0,10,"5,10"
6591,720575940605912254,right,Mi4,500,7,-8,-11,3,"7,-8"
6592,720575940615613842,right,Mi4,501,1,2,0,2,"1,2"
6593,720575940620896289,right,Mi4,503,3,17,5,12,"3,17"
6594,720575940613663658,right,Mi4,504,-2,9,6,3,"-2,9"
6595,720575940619397189,right,Mi4,505,6,-22,-17,-5,"6,-22"
6596,720575940629389827,right,Mi4,506,1,-12,-7,-5,"1,-12"
6597,720575940626292773,right,Mi4,507,-5,-12,-1,-11,"-5,-12"
6598,720575940627034457,right,Mi4,508,-5,11,10,1,"-5,11"
6599,720575940620708448,right,Mi4,509,-4,10,9,1,"-4,10"
6600,720575940627421468,right,Mi4,510,-2,11,7,4,"-2,11"
6601,720575940632922927,right,Mi4,511,5,-11,-11,0,"5,-11"
6602,720575940639649606,right,Mi4,512,6,0,-6,6,"6,0"
6603,720575940652658166,right,Mi4,513,-4,-13,-3,-10,"-4,-13"
6604,720575940648420473,right,Mi4,514,-4,-10,-1,-9,"-4,-10"
6605,720575940620972141,right,Mi4,515,-8,-7,4,-11,"-8,-7"
6606,720575940623602666,right,Mi4,516,7,-18,-16,-2,"7,-18"
6607,720575940619294526,right,Mi4,518,-4,22,15,7,"-4,22"
6608,720575940633830113,right,Mi4,519,-5,-5,2,-7,"-5,-5"
6609,720575940640205656,right,Mi4,520,-2,-22,-9,-13,"-2,-22"
6610,720575940637856996,right,Mi4,521,6,-9,-11,2,"6,-9"
6611,720575940620791430,right,Mi4,522,-4,0,4,-4,"-4,0"
6612,720575940655201953,right,Mi4,523,2,14,5,9,"2,14"
6613,720575940608639602,right,Mi4,524,4,-20,-14,-6,"4,-20"
6614,720575940613880031,right,Mi4,525,-1,-20,-9,-11,"-1,-20"
6615,720575940604941024,right,Mi4,526,0,-10,-5,-5,"0,-10"
6616,720575940615758041,right,Mi4,527,-4,-8,0,-8,"-4,-8"
6617,720575940621673200,right,Mi4,528,2,7,1,6,"2,7"
6618,720575940632805919,right,Mi4,529,2,-2,-3,1,"2,-2"
6619,720575940620237648,right,Mi4,530,-3,-13,-4,-9,"-3,-13"
6620,720575940635628951,right,Mi4,531,1,0,-1,1,"1,0"
6621,720575940622223487,right,Mi4,532,-8,7,11,-4,"-8,7"
6622,720575940633017927,right,Mi4,533,0,-16,-8,-8,"0,-16"
6623,720575940614780158,right,Mi4,534,3,2,-2,4,"3,2"
6624,720575940630198016,right,Mi4,535,8,-4,-10,6,"8,-4"
6625,720575940618397723,right,Mi4,536,3,4,-1,5,"3,4"
6626,720575940619040513,right,Mi4,537,0,-23,-12,-11,"0,-23"
6627,720575940618593510,right,Mi4,538,-4,1,4,-3,"-4,1"
6628,720575940610656153,right,Mi4,539,-6,15,13,2,"-6,15"
6629,720575940628815857,right,Mi4,540,-2,-9,-3,-6,"-2,-9"
6630,720575940645608983,right,Mi4,541,-4,14,11,3,"-4,14"
6631,720575940620594014,right,Mi4,542,6,-13,-13,0,"6,-13"
6632,720575940627842280,right,Mi4,543,-1,-4,-1,-3,"-1,-4"
6633,720575940618250779,right,Mi4,544,3,-13,-10,-3,"3,-13"
6634,720575940612858646,right,Mi4,545,5,11,0,11,"5,11"
6635,720575940611475810,right,Mi4,546,3,6,0,6,"3,6"
6636,720575940620258901,right,Mi4,547,-1,21,11,10,"-1,21"
6637,720575940635309675,right,Mi4,548,1,-16,-9,-7,"1,-16"
6638,720575940623654069,right,Mi4,549,0,-9,-5,-4,"0,-9"
6639,720575940604209580,right,Mi4,550,-2,3,3,0,"-2,3"
6640,720575940627131923,right,Mi4,551,-4,-9,-1,-8,"-4,-9"
6641,720575940617927641,right,Mi4,552,4,-1,-5,4,"4,-1"
6642,720575940619218481,right,Mi4,553,-3,16,11,5,"-3,16"
6643,720575940625089661,right,Mi4,554,-9,-3,7,-10,"-9,-3"
6644,720575940620736171,right,Mi4,555,-4,9,8,1,"-4,9"
6645,720575940621071342,right,Mi4,556,0,10,5,5,"0,10"
6646,720575940627974174,right,Mi4,557,6,-10,-11,1,"6,-10"
6647,720575940618212057,right,Mi4,558,-4,-21,-7,-14,"-4,-21"
6648,720575940614022290,right,Mi4,559,-6,22,17,5,"-6,22"
6649,720575940613865183,right,Mi4,560,-7,14,14,0,"-7,14"
6650,720575940623130718,right,Mi4,561,5,7,-2,9,"5,7"
6651,720575940622334121,right,Mi4,562,-5,-2,4,-6,"-5,-2"
6652,720575940624245652,right,Mi4,563,5,-13,-12,-1,"5,-13"
6653,720575940630703647,right,Mi4,564,3,-23,-15,-8,"3,-23"
6654,720575940616869318,right,Mi4,565,0,-26,-13,-13,"0,-26"
6655,720575940627281033,right,Mi4,566,5,-8,-9,1,"5,-8"
6656,720575940614407889,right,Mi4,567,-2,22,13,9,"-2,22"
6657,720575940607286146,right,Mi4,568,-6,-8,2,-10,"-6,-8"
6658,720575940635468735,right,Mi4,569,6,6,-3,9,"6,6"
6659,720575940638253790,right,Mi4,570,2,25,10,15,"2,25"
6660,720575940627633738,right,Mi4,571,0,-14,-7,-7,"0,-14"
6661,720575940615215958,right,Mi4,572,-8,3,9,-6,"-8,3"
6662,720575940621341405,right,Mi4,573,4,14,3,11,"4,14"
6663,720575940613140466,right,Mi4,574,-6,5,8,-3,"-6,5"
6664,720575940626185244,right,Mi4,576,0,28,14,14,"0,28"
6665,720575940616128780,right,Mi4,577,5,-14,-12,-2,"5,-14"
6666,720575940612130491,right,Mi4,578,4,-11,-10,-1,"4,-11"
6667,720575940618576197,right,Mi4,579,-3,-10,-2,-8,"-3,-10"
6668,720575940618129691,right,Mi4,580,-2,-23,-10,-13,"-2,-23"
6669,720575940638597949,right,Mi4,581,3,9,1,8,"3,9"
6670,720575940622691708,right,Mi4,582,-1,23,12,11,"-1,23"
6671,720575940630411564,right,Mi4,583,3,-25,-16,-9,"3,-25"
6672,720575940625284284,right,Mi4,584,4,23,7,16,"4,23"
6673,720575940628612625,right,Mi4,585,-1,-23,-11,-12,"-1,-23"
6674,720575940640876752,right,Mi4,586,2,18,7,11,"2,18"
6675,720575940627128394,right,Mi4,587,4,22,7,15,"4,22"
6676,720575940605251756,right,Mi4,588,1,4,1,3,"1,4"
6677,720575940631026629,right,Mi4,589,-1,-5,-2,-3,"-1,-5"
6678,720575940609977301,right,Mi4,590,1,9,3,6,"1,9"
6679,720575940613839986,right,Mi4,591,3,-3,-5,2,"3,-3"
6680,720575940616450940,right,Mi4,593,3,-14,-10,-4,"3,-14"
6681,720575940607177494,right,Mi4,594,7,-16,-15,-1,"7,-16"
6682,720575940623438121,right,Mi4,595,7,-12,-13,1,"7,-12"
6683,720575940619349371,right,Mi4,596,-4,-16,-4,-12,"-4,-16"
6684,720575940629005059,right,Mi4,597,4,1,-4,5,"4,1"
6685,720575940607382146,right,Mi4,598,2,-18,-11,-7,"2,-18"
6686,720575940621412336,right,Mi4,599,-1,9,5,4,"-1,9"
6687,720575940612986390,right,Mi4,600,3,-10,-8,-2,"3,-10"
6688,720575940624486729,right,Mi4,601,1,16,7,9,"1,16"
6689,720575940633864417,right,Mi4,602,4,-2,-5,3,"4,-2"
6690,720575940623078755,right,Mi4,603,-3,-23,-9,-14,"-3,-23"
6691,720575940645390190,right,Mi4,604,-6,-17,-3,-14,"-6,-17"
6692,720575940619694016,right,Mi4,605,3,15,4,11,"3,15"
6693,720575940627388488,right,Mi4,606,-1,-19,-9,-10,"-1,-19"
6694,720575940632691231,right,Mi4,607,1,18,8,10,"1,18"
6695,720575940620947695,right,Mi4,608,1,10,4,6,"1,10"
6696,720575940633929628,right,Mi4,609,-2,0,2,-2,"-2,0"
6697,720575940616505973,right,Mi4,610,2,-23,-14,-9,"2,-23"
6698,720575940619239582,right,Mi4,611,-1,-18,-8,-10,"-1,-18"
6699,720575940642611419,right,Mi4,612,-3,-26,-10,-16,"-3,-26"
6700,720575940633050285,right,Mi4,613,-8,-4,6,-10,"-8,-4"
6701,720575940617253718,right,Mi4,614,-2,-8,-2,-6,"-2,-8"
6702,720575940623133976,right,Mi4,615,-7,-7,3,-10,"-7,-7"
6703,720575940631180973,right,Mi4,616,-3,15,10,5,"-3,15"
6704,720575940644374051,right,Mi4,617,-2,-17,-7,-10,"-2,-17"
6705,720575940639831411,right,Mi4,618,-1,24,13,11,"-1,24"
6706,720575940624002707,right,Mi4,619,-4,-19,-6,-13,"-4,-19"
6707,720575940640032163,right,Mi4,620,7,1,-7,8,"7,1"
6708,720575940623091299,right,Mi4,621,1,24,11,13,"1,24"
6709,720575940636299327,right,Mi4,622,-5,20,15,5,"-5,20"
6710,720575940623692179,right,Mi4,623,1,13,5,8,"1,13"
6711,720575940609499349,right,Mi4,624,1,-17,-10,-7,"1,-17"
6712,720575940607781129,right,Mi4,625,-2,24,14,10,"-2,24"
6713,720575940610196804,right,Mi4,626,-5,-8,1,-9,"-5,-8"
6714,720575940640557275,right,Mi4,627,0,-1,-1,0,"0,-1"
6715,720575940638454325,right,Mi4,628,0,0,0,0,"0,0"
6716,720575940617729885,right,Mi4,629,4,24,8,16,"4,24"
6717,720575940624891284,right,Mi4,631,1,26,12,14,"1,26"
6718,720575940635302836,right,Mi4,632,3,-20,-13,-7,"3,-20"
6719,720575940620593835,right,Mi4,633,-1,-24,-11,-13,"-1,-24"
6720,720575940640153405,right,Mi4,634,-3,-15,-5,-10,"-3,-15"
6721,720575940631230275,right,Mi4,635,6,-6,-9,3,"6,-6"
6722,720575940617384678,right,Mi4,636,0,6,3,3,"0,6"
6723,720575940639902579,right,Mi4,637,3,-21,-14,-7,"3,-21"
6724,720575940635673951,right,Mi4,639,-4,19,13,6,"-4,19"
6725,720575940624233218,right,Mi4,640,-1,-16,-7,-9,"-1,-16"
6726,720575940631499595,right,Mi4,641,-8,-5,5,-10,"-8,-5"
6727,720575940639536718,right,Mi4,642,-5,-11,-1,-10,"-5,-11"
6728,720575940623056161,right,Mi4,643,6,14,1,13,"6,14"
6729,720575940632388252,right,Mi4,644,-6,18,15,3,"-6,18"
6730,720575940637387376,right,Mi4,645,-4,27,17,10,"-4,27"
6731,720575940626349815,right,Mi4,646,6,17,2,15,"6,17"
6732,720575940627936787,right,Mi4,647,-4,-7,0,-7,"-4,-7"
6733,720575940613047794,right,Mi4,648,1,7,2,5,"1,7"
6734,720575940635617391,right,Mi4,650,-3,-25,-10,-15,"-3,-25"
6735,720575940613137389,right,Mi4,651,-4,-5,1,-6,"-4,-5"
6736,720575940646624291,right,Mi4,652,-6,-11,0,-11,"-6,-11"
6737,720575940614405757,right,Mi4,653,-6,-12,0,-12,"-6,-12"
6738,720575940652675318,right,Mi4,654,-3,8,7,1,"-3,8"
6739,720575940620063902,right,Mi4,655,6,-1,-7,6,"6,-1"
6740,720575940611642517,right,Mi4,656,0,-11,-6,-5,"0,-11"
6741,720575940630406522,right,Mi4,657,-2,-25,-11,-14,"-2,-25"
6742,720575940622116961,right,Mi4,658,1,20,9,11,"1,20"
6743,720575940626926090,right,Mi4,659,-4,-6,1,-7,"-4,-6"
6744,720575940619981214,right,Mi4,660,2,28,12,16,"2,28"
6745,720575940631231033,right,Mi4,661,-3,14,10,4,"-3,14"
6746,720575940620439233,right,Mi4,662,2,-1,-3,2,"2,-1"
6747,720575940628338961,right,Mi4,663,0,8,4,4,"0,8"
6748,720575940628966699,right,Mi4,664,1,-27,-15,-12,"1,-27"
6749,720575940631841361,right,Mi4,665,7,-2,-8,6,"7,-2"
6750,720575940615529084,right,Mi4,666,7,-13,-14,1,"7,-13"
6751,720575940626491138,right,Mi4,667,1,-28,-15,-13,"1,-28"
6752,720575940627254409,right,Mi4,668,1,19,8,11,"1,19"
6753,720575940629936444,right,Mi4,669,4,-16,-12,-4,"4,-16"
6754,720575940616069682,right,Mi4,671,-4,-23,-8,-15,"-4,-23"
6755,720575940624493100,right,Mi4,672,-8,11,13,-2,"-8,11"
6756,720575940625422538,right,Mi4,673,2,5,0,5,"2,5"
6757,720575940634473628,right,Mi4,674,-4,-14,-3,-11,"-4,-14"
6758,720575940643216407,right,Mi4,675,-7,19,16,3,"-7,19"
6759,720575940615244690,right,Mi4,676,-3,-21,-8,-13,"-3,-21"
6760,720575940614716979,right,Mi4,677,0,11,5,6,"0,11"
6761,720575940624213685,right,Mi4,678,3,-7,-7,0,"3,-7"
6762,720575940620373009,right,Mi4,679,4,18,5,13,"4,18"
6763,720575940625690099,right,Mi4,680,-1,25,13,12,"-1,25"
6764,720575940634997911,right,Mi4,681,-2,-21,-9,-12,"-2,-21"
6765,720575940632436072,right,Mi4,682,6,-8,-10,2,"6,-8"
6766,720575940614309416,right,Mi4,683,2,6,1,5,"2,6"
6767,720575940619573876,right,Mi4,684,-6,17,14,3,"-6,17"
6768,720575940609912587,right,Mi4,685,-5,-9,0,-9,"-5,-9"
6769,720575940617455931,right,Mi4,686,5,-22,-16,-6,"5,-22"
6770,720575940612686053,right,Mi4,687,-6,-3,4,-7,"-6,-3"
6771,720575940615013974,right,Mi4,688,-7,10,12,-2,"-7,10"
6772,720575940608555868,right,Mi4,689,-2,18,11,7,"-2,18"
6773,720575940620595904,right,Mi4,690,-7,-3,5,-8,"-7,-3"
6774,720575940624523824,right,Mi4,691,-9,4,11,-7,"-9,4"
6775,720575940636982446,right,Mi4,692,-4,24,16,8,"-4,24"
6776,720575940616078278,right,Mi4,693,-3,25,15,10,"-3,25"
6777,720575940609755342,right,Mi4,695,-6,10,11,-1,"-6,10"
6778,720575940632682009,right,Mi4,696,-2,16,10,6,"-2,16"
6779,720575940619103030,right,Mi4,697,1,-22,-12,-10,"1,-22"
6780,720575940623327751,right,Mi4,698,6,-7,-10,3,"6,-7"
6781,720575940615839389,right,Mi4,699,-5,0,5,-5,"-5,0"
6782,720575940615713586,right,Mi4,700,5,15,2,13,"5,15"
6783,720575940624319752,right,Mi4,701,0,-4,-2,-2,"0,-4"
6784,720575940620597012,right,Mi4,702,-5,23,16,7,"-5,23"
6785,720575940624542541,right,Mi4,703,-3,1,3,-2,"-3,1"
6786,720575940632069657,right,Mi4,704,-7,8,11,-3,"-7,8"
6787,720575940637152820,right,Mi4,705,1,1,-1,2,"1,1"
6788,720575940628377487,right,Mi4,707,-2,25,14,11,"-2,25"
6789,720575940615710406,right,Mi4,708,-4,-25,-9,-16,"-4,-25"
6790,720575940622722525,right,Mi4,709,-2,-24,-10,-14,"-2,-24"
6791,720575940605378476,right,Mi4,710,4,-25,-17,-8,"4,-25"
6792,720575940618091009,right,Mi4,711,-1,19,10,9,"-1,19"
6793,720575940631222585,right,Mi4,712,-7,12,13,-1,"-7,12"
6794,720575940611091173,right,Mi4,713,-6,16,14,2,"-6,16"
6795,720575940619794648,right,Mi4,714,5,12,1,11,"5,12"
6796,720575940627510794,right,Mi4,715,4,10,1,9,"4,10"
6797,720575940622644556,right,Mi4,716,4,-6,-7,1,"4,-6"
6798,720575940632347463,right,Mi4,717,2,-22,-13,-9,"2,-22"
6799,720575940624751630,right,Mi4,718,-5,24,17,7,"-5,24"
6800,720575940616093964,right,Mi4,719,1,27,12,15,"1,27"
6801,720575940645131287,right,Mi4,720,-5,21,15,6,"-5,21"
6802,720575940634637247,right,Mi4,721,5,13,1,12,"5,13"
6803,720575940614653182,right,Mi4,722,6,-15,-14,-1,"6,-15"
6804,720575940617224633,right,Mi4,723,-2,-11,-4,-7,"-2,-11"
6805,720575940640662899,right,Mi4,724,4,2,-3,5,"4,2"
6806,720575940620636225,right,Mi4,725,-3,-24,-9,-15,"-3,-24"
6807,720575940633170503,right,Mi4,726,2,-28,-16,-12,"2,-28"
6808,720575940628047229,right,Mi4,727,7,6,-4,10,"7,6"
6809,720575940644851479,right,Mi4,728,7,12,-1,13,"7,12"
6810,720575940616327998,right,Mi4,729,-3,29,17,12,"-3,29"
6811,720575940614783138,right,Mi4,730,7,0,-7,7,"7,0"
6812,720575940634629857,right,Mi4,731,-6,9,10,-1,"-6,9"
6813,720575940620384341,right,Mi4,732,-3,6,6,0,"-3,6"
6814,720575940618071124,right,Mi4,733,-5,-17,-4,-13,"-5,-17"
6815,720575940613640258,right,Mi4,734,2,0,-2,2,"2,0"
6816,720575940629098027,right,Mi4,735,1,-23,-13,-10,"1,-23"
6817,720575940610905202,right,Mi4,736,-8,1,8,-7,"-8,1"
6818,720575940633342303,right,Mi4,737,0,19,9,10,"0,19"
6819,720575940626050826,right,Mi4,738,-3,13,9,4,"-3,13"
6820,720575940613522661,right,Mi4,739,-7,2,8,-6,"-7,2"
6821,720575940607606294,right,Mi4,740,2,-8,-6,-2,"2,-8"
6822,720575940617836006,right,Mi4,741,-2,-14,-5,-9,"-2,-14"
6823,720575940641484277,right,Mi4,742,-4,11,9,2,"-4,11"
6824,720575940620856417,right,Mi4,743,6,-19,-16,-3,"6,-19"
6825,720575940628600326,right,Mi4,744,-4,25,16,9,"-4,25"
6826,720575940631690794,right,Mi4,745,0,13,6,7,"0,13"
6827,720575940619854715,right,Mi4,746,-3,3,4,-1,"-3,3"
6828,720575940659418241,right,Mi4,747,0,2,1,1,"0,2"
6829,720575940616382014,right,Mi4,748,-4,20,14,6,"-4,20"
6830,720575940621807062,right,Mi4,749,-2,1,2,-1,"-2,1"
6831,720575940638411497,right,Mi4,750,4,-24,-16,-8,"4,-24"
6832,720575940610107716,right,Mi4,751,1,6,2,4,"1,6"
6833,720575940623048413,right,Mi4,752,-2,7,5,2,"-2,7"
6834,720575940607304066,right,Mi4,753,-3,24,15,9,"-3,24"
6835,720575940634726648,right,Mi4,754,-1,-13,-6,-7,"-1,-13"
6836,720575940640365629,right,Mi4,755,4,19,5,14,"4,19"
6837,720575940615392578,right,Mi4,756,5,20,5,15,"5,20"
6838,720575940624976142,right,Mi4,757,0,-6,-3,-3,"0,-6"
6839,720575940611656891,right,Mi4,758,5,-1,-6,5,"5,-1"
6840,720575940647390596,right,Mi4,759,7,14,0,14,"7,14"
6841,720575940632063289,right,Mi4,760,0,17,8,9,"0,17"
6842,720575940620032971,right,Mi4,761,-4,-18,-5,-13,"-4,-18"
6843,720575940620927983,right,Mi4,762,0,14,7,7,"0,14"
6844,720575940614312379,right,Mi4,763,-5,14,12,2,"-5,14"
6845,720575940627174135,right,Mi4,765,-3,9,7,2,"-3,9"
6846,720575940632415458,right,Mi4,766,2,-4,-4,0,"2,-4"
6847,720575940618126107,right,Mi4,767,1,28,13,15,"1,28"
6848,720575940621697729,right,Mi4,769,4,-27,-18,-9,"4,-27"
6849,720575940622132464,right,Mi4,771,3,-27,-17,-10,"3,-27"
6850,720575940621240302,right,Mi4,772,1,12,5,7,"1,12"
6851,720575940612457139,right,Mi4,773,5,-19,-15,-4,"5,-19"
6852,720575940620225313,right,Mi4,774,-8,6,11,-5,"-8,6"
6853,720575940626836349,right,Mi4,775,5,22,6,16,"5,22"
6854,720575940613425810,right,Mi4,776,5,21,5,16,"5,21"
6855,720575940618663547,right,Mi4,777,6,20,4,16,"6,20"
6856,720575940633537188,right,Mi4,778,4,25,8,17,"4,25"
6857,720575940620076923,right,Mi4,779,5,24,7,17,"5,24"
6858,720575940618683469,right,Mi4,780,-6,25,18,7,"-6,25"
6859,720575940607613653,right,Mi4,781,-5,26,18,8,"-5,26"
6860,720575940634090209,right,Mi4,783,-4,28,18,10,"-4,28"
6861,720575940622393257,right,Mi4,785,-3,30,18,12,"-3,30"
6862,720575940638157284,right,Mi4,786,-2,30,17,13,"-2,30"
6863,720575940638722394,right,Mi4,788,3,27,10,17,"3,27"
6864,720575940621059169,right,Mi4,790,-2,-27,-12,-15,"-2,-27"
6865,720575940608318850,right,Mi4,791,-1,-28,-13,-15,"-1,-28"
6866,720575940625031431,right,Mi4,792,8,2,-7,9,"8,2"
6867,720575940620516288,right,Mi4,793,8,-6,-11,5,"8,-6"
6868,720575940634719087,right,Mi4,794,5,-26,-18,-8,"5,-26"
6869,720575940638905414,right,Mi4,795,6,-21,-17,-4,"6,-21"
6870,720575940632738897,right,Mi9,1,-6,13,12,1,"-6,13"
6871,720575940624632578,right,Mi9,2,-8,2,9,-7,"-8,2"
6872,720575940629641978,right,Mi9,3,6,-12,-12,0,"6,-12"
6873,720575940627281513,right,Mi9,4,-5,-21,-6,-15,"-5,-21"
6874,720575940608188338,right,Mi9,5,-1,16,9,7,"-1,16"
6875,720575940622800788,right,Mi9,6,-2,-4,0,-4,"-2,-4"
6876,720575940621700080,right,Mi9,7,-6,-6,3,-9,"-6,-6"
6877,720575940626565890,right,Mi9,8,-4,26,17,9,"-4,26"
6878,720575940624161719,right,Mi9,9,4,9,0,9,"4,9"
6879,720575940626798966,right,Mi9,10,5,-15,-13,-2,"5,-15"
6880,720575940620775407,right,Mi9,11,7,-14,-14,0,"7,-14"
6881,720575940627146554,right,Mi9,12,-7,9,11,-2,"-7,9"
6882,720575940628615529,right,Mi9,13,-1,-26,-12,-14,"-1,-26"
6883,720575940639894947,right,Mi9,14,0,-27,-14,-13,"0,-27"
6884,720575940627177334,right,Mi9,15,2,-3,-4,1,"2,-3"
6885,720575940628881145,right,Mi9,16,-2,-16,-6,-10,"-2,-16"
6886,720575940612443926,right,Mi9,17,1,-5,-4,-1,"1,-5"
6887,720575940619699316,right,Mi9,18,5,-16,-13,-3,"5,-16"
6888,720575940603295200,right,Mi9,19,-7,17,15,2,"-7,17"
6889,720575940630421303,right,Mi9,20,3,-11,-9,-2,"3,-11"
6890,720575940635112729,right,Mi9,21,-2,19,11,8,"-2,19"
6891,720575940627482374,right,Mi9,22,-1,3,2,1,"-1,3"
6892,720575940637375600,right,Mi9,23,-3,-16,-5,-11,"-3,-16"
6893,720575940609270027,right,Mi9,24,-1,-10,-4,-6,"-1,-10"
6894,720575940622067494,right,Mi9,25,-9,3,10,-7,"-9,3"
6895,720575940631185401,right,Mi9,26,1,-3,-3,0,"1,-3"
6896,720575940627585929,right,Mi9,27,0,-25,-13,-12,"0,-25"
6897,720575940630420162,right,Mi9,28,5,6,-2,8,"5,6"
6898,720575940613986479,right,Mi9,29,-1,-3,-1,-2,"-1,-3"
6899,720575940624933905,right,Mi9,30,6,16,2,14,"6,16"
6900,720575940628930407,right,Mi9,32,0,12,6,6,"0,12"
6901,720575940633869794,right,Mi9,33,3,18,6,12,"3,18"
6902,720575940638981198,right,Mi9,34,6,18,3,15,"6,18"
6903,720575940634828569,right,Mi9,35,1,-24,-13,-11,"1,-24"
6904,720575940628545643,right,Mi9,36,6,8,-2,10,"6,8"
6905,720575940633584076,right,Mi9,37,1,5,1,4,"1,5"
6906,720575940630901835,right,Mi9,38,0,-2,-1,-1,"0,-2"
6907,720575940620652882,right,Mi9,39,0,20,10,10,"0,20"
6908,720575940620759322,right,Mi9,40,-2,-6,-1,-5,"-2,-6"
6909,720575940619299311,right,Mi9,41,-3,28,17,11,"-3,28"
6910,720575940624287211,right,Mi9,42,-1,14,8,6,"-1,14"
6911,720575940633235551,right,Mi9,43,-5,18,14,4,"-5,18"
6912,720575940625637868,right,Mi9,44,5,-10,-10,0,"5,-10"
6913,720575940623316749,right,Mi9,45,-5,-1,4,-5,"-5,-1"
6914,720575940610807650,right,Mi9,46,-5,15,12,3,"-5,15"
6915,720575940644269728,right,Mi9,47,-9,-1,8,-9,"-9,-1"
6916,720575940630026199,right,Mi9,48,-4,-22,-7,-15,"-4,-22"
6917,720575940627913237,right,Mi9,49,4,-4,-6,2,"4,-4"
6918,720575940629694970,right,Mi9,50,-2,21,12,9,"-2,21"
6919,720575940609608201,right,Mi9,51,0,-19,-10,-9,"0,-19"
6920,720575940617505510,right,Mi9,52,-1,-22,-10,-12,"-1,-22"
6921,720575940633903661,right,Mi9,53,5,14,2,12,"5,14"
6922,720575940611741390,right,Mi9,54,-4,3,5,-2,"-4,3"
6923,720575940618204573,right,Mi9,55,-4,-11,-2,-9,"-4,-11"
6924,720575940626199994,right,Mi9,56,1,-13,-8,-5,"1,-13"
6925,720575940629726039,right,Mi9,57,6,-11,-12,1,"6,-11"
6926,720575940644211912,right,Mi9,58,3,12,3,9,"3,12"
6927,720575940625418426,right,Mi9,59,-2,2,3,-1,"-2,2"
6928,720575940630010425,right,Mi9,60,-8,8,12,-4,"-8,8"
6929,720575940622089310,right,Mi9,61,-4,-4,2,-6,"-4,-4"
6930,720575940625471223,right,Mi9,63,4,12,2,10,"4,12"
6931,720575940618273600,right,Mi9,64,4,-23,-16,-7,"4,-23"
6932,720575940615740940,right,Mi9,65,-1,28,15,13,"-1,28"
6933,720575940635082091,right,Mi9,66,2,15,5,10,"2,15"
6934,720575940629080731,right,Mi9,67,-2,-13,-5,-8,"-2,-13"
6935,720575940627289993,right,Mi9,68,3,16,5,11,"3,16"
6936,720575940637618862,right,Mi9,69,1,8,3,5,"1,8"
6937,720575940615775647,right,Mi9,70,-4,21,14,7,"-4,21"
6938,720575940627536259,right,Mi9,71,-2,-3,0,-3,"-2,-3"
6939,720575940622791885,right,Mi9,72,0,-28,-14,-14,"0,-28"
6940,720575940620326896,right,Mi9,73,2,2,-1,3,"2,2"
6941,720575940612403626,right,Mi9,74,-1,-9,-4,-5,"-1,-9"
6942,720575940623644942,right,Mi9,75,-6,14,13,1,"-6,14"
6943,720575940632131921,right,Mi9,76,-3,-4,1,-5,"-3,-4"
6944,720575940654545825,right,Mi9,77,2,-5,-5,0,"2,-5"
6945,720575940633724863,right,Mi9,78,2,20,8,12,"2,20"
6946,720575940634331128,right,Mi9,79,2,1,-2,3,"2,1"
6947,720575940619149366,right,Mi9,80,4,13,2,11,"4,13"
6948,720575940612188017,right,Mi9,81,6,-2,-7,5,"6,-2"
6949,720575940616511686,right,Mi9,82,-7,7,10,-3,"-7,7"
6950,720575940608951509,right,Mi9,83,2,-21,-13,-8,"2,-21"
6951,720575940630144812,right,Mi9,84,-2,12,8,4,"-2,12"
6952,720575940607621980,right,Mi9,85,4,-22,-15,-7,"4,-22"
6953,720575940638158989,right,Mi9,86,-5,-7,1,-8,"-5,-7"
6954,720575940623464524,right,Mi9,87,1,11,4,7,"1,11"
6955,720575940629061847,right,Mi9,89,1,-19,-11,-8,"1,-19"
6956,720575940626765412,right,Mi9,90,-4,5,6,-1,"-4,5"
6957,720575940635171263,right,Mi9,91,-1,6,4,2,"-1,6"
6958,720575940626678060,right,Mi9,93,-6,3,7,-4,"-6,3"
6959,720575940628230396,right,Mi9,94,5,18,4,14,"5,18"
6960,720575940628372167,right,Mi9,95,4,-21,-15,-6,"4,-21"
6961,720575940621335899,right,Mi9,96,1,-10,-6,-4,"1,-10"
6962,720575940614784117,right,Mi9,97,-5,2,6,-4,"-5,2"
6963,720575940608731403,right,Mi9,98,-1,-12,-5,-7,"-1,-12"
6964,720575940613036822,right,Mi9,99,4,15,3,12,"4,15"
6965,720575940617733817,right,Mi9,100,2,-10,-7,-3,"2,-10"
6966,720575940627246380,right,Mi9,101,-7,6,10,-4,"-7,6"
6967,720575940608827913,right,Mi9,102,3,13,3,10,"3,13"
6968,720575940629171185,right,Mi9,103,7,9,-3,12,"7,9"
6969,720575940634781536,right,Mi9,104,-1,-27,-13,-14,"-1,-27"
6970,720575940625552280,right,Mi9,105,3,22,8,14,"3,22"
6971,720575940623400684,right,Mi9,106,-7,11,12,-1,"-7,11"
6972,720575940617378388,right,Mi9,107,8,-2,-9,7,"8,-2"
6973,720575940622017008,right,Mi9,108,-3,-12,-3,-9,"-3,-12"
6974,720575940633084717,right,Mi9,109,4,-5,-7,2,"4,-5"
6975,720575940622720169,right,Mi9,110,-7,0,7,-7,"-7,0"
6976,720575940632245807,right,Mi9,111,2,-24,-14,-10,"2,-24"
6977,720575940629423415,right,Mi9,112,-6,1,6,-5,"-6,1"
6978,720575940631800120,right,Mi9,113,-2,4,4,0,"-2,4"
6979,720575940632421663,right,Mi9,114,2,-13,-9,-4,"2,-13"
6980,720575940604692070,right,Mi9,115,-4,2,5,-3,"-4,2"
6981,720575940621712152,right,Mi9,116,-1,-8,-3,-5,"-1,-8"
6982,720575940620049064,right,Mi9,117,-8,-2,7,-9,"-8,-2"
6983,720575940624215221,right,Mi9,118,3,1,-3,4,"3,1"
6984,720575940639047487,right,Mi9,119,-2,6,5,1,"-2,6"
6985,720575940645997620,right,Mi9,120,-1,-1,0,-1,"-1,-1"
6986,720575940619152811,right,Mi9,121,-8,4,10,-6,"-8,4"
6987,720575940608039090,right,Mi9,122,-5,9,9,0,"-5,9"
6988,720575940626089260,right,Mi9,123,-8,10,13,-3,"-8,10"
6989,720575940621127700,right,Mi9,124,1,-7,-5,-2,"1,-7"
6990,720575940618150813,right,Mi9,125,5,9,-1,10,"5,9"
6991,720575940622718166,right,Mi9,126,3,11,2,9,"3,11"
6992,720575940620017937,right,Mi9,127,0,15,7,8,"0,15"
6993,720575940636436472,right,Mi9,128,3,-22,-14,-8,"3,-22"
6994,720575940638331364,right,Mi9,129,0,-13,-7,-6,"0,-13"
6995,720575940614177320,right,Mi9,130,2,12,4,8,"2,12"
6996,720575940655097505,right,Mi9,131,-6,20,16,4,"-6,20"
6997,720575940616930902,right,Mi9,133,-3,20,13,7,"-3,20"
6998,720575940632092300,right,Mi9,134,-5,-18,-4,-14,"-5,-18"
6999,720575940644817006,right,Mi9,135,-3,-22,-8,-14,"-3,-22"
7000,720575940633052836,right,Mi9,136,0,3,1,2,"0,3"
7001,720575940614607558,right,Mi9,137,5,-7,-9,2,"5,-7"
7002,720575940616926779,right,Mi9,138,0,27,13,14,"0,27"
7003,720575940638349534,right,Mi9,139,1,-14,-8,-6,"1,-14"
7004,720575940616436509,right,Mi9,140,3,8,1,7,"3,8"
7005,720575940622488090,right,Mi9,141,5,-23,-17,-6,"5,-23"
7006,720575940627190035,right,Mi9,142,-2,-18,-7,-11,"-2,-18"
7007,720575940620833106,right,Mi9,143,-4,16,12,4,"-4,16"
7008,720575940612483826,right,Mi9,144,7,-11,-13,2,"7,-11"
7009,720575940621760422,right,Mi9,145,0,4,2,2,"0,4"
7010,720575940610904878,right,Mi9,146,1,-6,-4,-2,"1,-6"
7011,720575940614907538,right,Mi9,147,1,21,9,12,"1,21"
7012,720575940614682258,right,Mi9,148,-7,-11,1,-12,"-7,-11"
7013,720575940615291772,right,Mi9,149,6,-14,-13,-1,"6,-14"
7014,720575940611659377,right,Mi9,150,-8,5,10,-5,"-8,5"
7015,720575940609235298,right,Mi9,151,-3,-14,-4,-10,"-3,-14"
7016,720575940640353920,right,Mi9,152,3,-15,-11,-4,"3,-15"
7017,720575940638975054,right,Mi9,153,8,0,-8,8,"8,0"
7018,720575940645097251,right,Mi9,154,-8,0,8,-8,"-8,0"
7019,720575940632987347,right,Mi9,155,-8,13,14,-1,"-8,13"
7020,720575940619576998,right,Mi9,156,-9,1,9,-8,"-9,1"
7021,720575940612675225,right,Mi9,157,-1,-7,-3,-4,"-1,-7"
7022,720575940624401034,right,Mi9,158,3,-5,-6,1,"3,-5"
7023,720575940617399769,right,Mi9,159,7,7,-4,11,"7,7"
7024,720575940639423541,right,Mi9,160,-2,20,12,8,"-2,20"
7025,720575940623105767,right,Mi9,161,4,-14,-11,-3,"4,-14"
7026,720575940621988961,right,Mi9,162,-4,-2,3,-5,"-4,-2"
7027,720575940624811139,right,Mi9,163,-9,7,12,-5,"-9,7"
7028,720575940618999350,right,Mi9,164,-1,-2,0,-2,"-1,-2"
7029,720575940610680746,right,Mi9,165,4,16,4,12,"4,16"
7030,720575940646325614,right,Mi9,166,0,18,9,9,"0,18"
7031,720575940635946095,right,Mi9,167,0,-17,-9,-8,"0,-17"
7032,720575940627429397,right,Mi9,168,-1,17,9,8,"-1,17"
7033,720575940630298471,right,Mi9,169,0,-18,-9,-9,"0,-18"
7034,720575940612951154,right,Mi9,170,-5,1,5,-4,"-5,1"
7035,720575940628235249,right,Mi9,171,6,-20,-16,-4,"6,-20"
7036,720575940623606724,right,Mi9,172,1,22,10,12,"1,22"
7037,720575940632410642,right,Mi9,173,2,-25,-15,-10,"2,-25"
7038,720575940620105301,right,Mi9,174,4,-15,-12,-3,"4,-15"
7039,720575940614983611,right,Mi9,175,-6,-7,2,-9,"-6,-7"
7040,720575940613225750,right,Mi9,176,-2,13,8,5,"-2,13"
7041,720575940607218780,right,Mi9,177,-2,-1,1,-2,"-2,-1"
7042,720575940628021576,right,Mi9,178,2,11,3,8,"2,11"
7043,720575940629841274,right,Mi9,179,-5,-16,-3,-13,"-5,-16"
7044,720575940628865028,right,Mi9,180,2,-27,-16,-11,"2,-27"
7045,720575940632344618,right,Mi9,181,1,-4,-3,-1,"1,-4"
7046,720575940615457660,right,Mi9,182,7,-10,-12,2,"7,-10"
7047,720575940614932626,right,Mi9,183,-5,-15,-3,-12,"-5,-15"
7048,720575940620368775,right,Mi9,184,-6,-5,3,-8,"-6,-5"
7049,720575940614008360,right,Mi9,185,2,-11,-8,-3,"2,-11"
7050,720575940615981886,right,Mi9,186,-1,26,14,12,"-1,26"
7051,720575940621337153,right,Mi9,187,3,21,7,14,"3,21"
7052,720575940617422646,right,Mi9,188,-5,17,13,4,"-5,17"
7053,720575940614675454,right,Mi9,189,6,13,0,13,"6,13"
7054,720575940621622908,right,Mi9,190,-3,-5,0,-5,"-3,-5"
7055,720575940625826960,right,Mi9,191,-1,-11,-5,-6,"-1,-11"
7056,720575940627243308,right,Mi9,193,-5,4,7,-3,"-5,4"
7057,720575940631381263,right,Mi9,194,0,-5,-3,-2,"0,-5"
7058,720575940631392825,right,Mi9,195,-3,-1,2,-3,"-3,-1"
7059,720575940625394320,right,Mi9,196,-1,8,5,3,"-1,8"
7060,720575940646693428,right,Mi9,197,0,-20,-10,-10,"0,-20"
7061,720575940636347790,right,Mi9,198,6,2,-5,7,"6,2"
7062,720575940612437234,right,Mi9,199,0,-12,-6,-6,"0,-12"
7063,720575940630797911,right,Mi9,200,-5,12,11,1,"-5,12"
7064,720575940620613103,right,Mi9,201,-8,9,12,-3,"-8,9"
7065,720575940630258806,right,Mi9,202,-1,27,14,13,"-1,27"
7066,720575940634878350,right,Mi9,203,3,-1,-4,3,"3,-1"
7067,720575940614609831,right,Mi9,204,5,-2,-6,4,"5,-2"
7068,720575940620851695,right,Mi9,205,5,-6,-8,2,"5,-6"
7069,720575940644583204,right,Mi9,206,-3,5,5,0,"-3,5"
7070,720575940633251665,right,Mi9,207,1,29,13,16,"1,29"
7071,720575940622379990,right,Mi9,208,5,-21,-16,-5,"5,-21"
7072,720575940632254545,right,Mi9,209,-3,-8,-1,-7,"-3,-8"
7073,720575940626998316,right,Mi9,210,-6,8,10,-2,"-6,8"
7074,720575940635980890,right,Mi9,211,-7,-1,6,-7,"-7,-1"
7075,720575940622644300,right,Mi9,212,2,-16,-10,-6,"2,-16"
7076,720575940620063947,right,Mi9,213,3,-4,-5,1,"3,-4"
7077,720575940634243609,right,Mi9,214,-5,3,6,-3,"-5,3"
7078,720575940611627474,right,Mi9,215,6,7,-3,10,"6,7"
7079,720575940627065930,right,Mi9,216,2,19,7,12,"2,19"
7080,720575940609390805,right,Mi9,217,6,15,1,14,"6,15"
7081,720575940605959358,right,Mi9,218,2,10,3,7,"2,10"
7082,720575940627175286,right,Mi9,219,6,-4,-8,4,"6,-4"
7083,720575940607523350,right,Mi9,220,2,-6,-5,-1,"2,-6"
7084,720575940609042012,right,Mi9,221,-7,3,8,-5,"-7,3"
7085,720575940620115029,right,Mi9,222,-3,26,16,10,"-3,26"
7086,720575940617998804,right,Mi9,223,-2,26,15,11,"-2,26"
7087,720575940630894700,right,Mi9,224,0,5,2,3,"0,5"
7088,720575940622110332,right,Mi9,225,2,-26,-15,-11,"2,-26"
7089,720575940624706452,right,Mi9,226,5,19,4,15,"5,19"
7090,720575940631620318,right,Mi9,227,-7,5,9,-4,"-7,5"
7091,720575940620569582,right,Mi9,228,-7,1,7,-6,"-7,1"
7092,720575940634013779,right,Mi9,229,5,2,-4,6,"5,2"
7093,720575940628671488,right,Mi9,231,4,-12,-10,-2,"4,-12"
7094,720575940659972737,right,Mi9,232,-4,13,10,3,"-4,13"
7095,720575940614717438,right,Mi9,233,4,-13,-11,-2,"4,-13"
7096,720575940616124895,right,Mi9,234,1,3,0,3,"1,3"
7097,720575940637789662,right,Mi9,235,4,11,1,10,"4,11"
7098,720575940606363778,right,Mi9,236,-1,4,3,1,"-1,4"
7099,720575940614829986,right,Mi9,237,-2,27,15,12,"-2,27"
7100,720575940619895679,right,Mi9,238,-8,-3,6,-9,"-8,-3"
7101,720575940618697967,right,Mi9,239,-6,6,9,-3,"-6,6"
7102,720575940615223146,right,Mi9,240,-4,-3,2,-5,"-4,-3"
7103,720575940630142991,right,Mi9,241,2,-17,-11,-6,"2,-17"
7104,720575940628730128,right,Mi9,242,-4,6,7,-1,"-4,6"
7105,720575940630932475,right,Mi9,243,-1,-21,-10,-11,"-1,-21"
7106,720575940632103480,right,Mi9,244,-4,-12,-2,-10,"-4,-12"
7107,720575940633131162,right,Mi9,245,-5,-3,3,-6,"-5,-3"
7108,720575940607294473,right,Mi9,246,-4,15,11,4,"-4,15"
7109,720575940627731801,right,Mi9,247,-4,-15,-4,-11,"-4,-15"
7110,720575940637342534,right,Mi9,248,-6,0,6,-6,"-6,0"
7111,720575940626710300,right,Mi9,249,2,-12,-8,-4,"2,-12"
7112,720575940626484026,right,Mi9,250,-1,1,1,0,"-1,1"
7113,720575940605952945,right,Mi9,251,-1,-14,-6,-8,"-1,-14"
7114,720575940644087496,right,Mi9,252,3,23,8,15,"3,23"
7115,720575940620728256,right,Mi9,253,5,16,3,13,"5,16"
7116,720575940632729647,right,Mi9,254,3,-24,-15,-9,"3,-24"
7117,720575940605806624,right,Mi9,255,-6,-13,-1,-12,"-6,-13"
7118,720575940631112663,right,Mi9,256,5,-20,-15,-5,"5,-20"
7119,720575940618894494,right,Mi9,257,2,21,8,13,"2,21"
7120,720575940624914155,right,Mi9,258,-4,-17,-5,-12,"-4,-17"
7121,720575940629057040,right,Mi9,259,-7,-5,4,-9,"-7,-5"
7122,720575940632771385,right,Mi9,260,-3,19,12,7,"-3,19"
7123,720575940607908700,right,Mi9,261,-1,13,7,6,"-1,13"
7124,720575940640121216,right,Mi9,262,1,-11,-7,-4,"1,-11"
7125,720575940616131340,right,Mi9,263,-3,4,5,-1,"-3,4"
7126,720575940622457164,right,Mi9,264,-1,-6,-2,-4,"-1,-6"
7127,720575940639549312,right,Mi9,265,-6,-1,5,-6,"-6,-1"
7128,720575940633706660,right,Mi9,266,-1,-25,-12,-13,"-1,-25"
7129,720575940613923379,right,Mi9,267,-6,2,7,-5,"-6,2"
7130,720575940619302127,right,Mi9,268,7,-6,-10,4,"7,-6"
7131,720575940623102600,right,Mi9,269,2,-19,-12,-7,"2,-19"
7132,720575940641164507,right,Mi9,270,1,-8,-5,-3,"1,-8"
7133,720575940624159415,right,Mi9,272,3,-2,-4,2,"3,-2"
7134,720575940612695525,right,Mi9,273,-6,23,17,6,"-6,23"
7135,720575940626075580,right,Mi9,274,6,4,-4,8,"6,4"
7136,720575940610725934,right,Mi9,275,-8,-1,7,-8,"-8,-1"
7137,720575940612740069,right,Mi9,277,7,-3,-9,6,"7,-3"
7138,720575940632700364,right,Mi9,278,-5,10,10,0,"-5,10"
7139,720575940640367925,right,Mi9,279,-4,8,8,0,"-4,8"
7140,720575940634607968,right,Mi9,280,-6,-14,-1,-13,"-6,-14"
7141,720575940627179675,right,Mi9,281,-9,2,10,-8,"-9,2"
7142,720575940630795148,right,Mi9,282,0,26,13,13,"0,26"
7143,720575940622228318,right,Mi9,283,-4,4,6,-2,"-4,4"
7144,720575940623157016,right,Mi9,284,0,25,12,13,"0,25"
7145,720575940616958806,right,Mi9,285,6,-18,-15,-3,"6,-18"
7146,720575940624930485,right,Mi9,286,0,-24,-12,-12,"0,-24"
7147,720575940642889613,right,Mi9,287,-5,13,11,2,"-5,13"
7148,720575940631083471,right,Mi9,288,-1,30,16,14,"-1,30"
7149,720575940614138543,right,Mi9,290,5,-24,-17,-7,"5,-24"
7150,720575940620151489,right,Mi9,291,7,2,-6,8,"7,2"
7151,720575940645110039,right,Mi9,292,-4,18,13,5,"-4,18"
7152,720575940626511132,right,Mi9,293,4,-17,-13,-4,"4,-17"
7153,720575940640430720,right,Mi9,294,1,-20,-11,-9,"1,-20"
7154,720575940606578208,right,Mi9,295,-2,29,16,13,"-2,29"
7155,720575940625267092,right,Mi9,296,1,-18,-10,-8,"1,-18"
7156,720575940632236956,right,Mi9,297,7,-9,-12,3,"7,-9"
7157,720575940607858889,right,Mi9,298,-5,5,7,-2,"-5,5"
7158,720575940616255500,right,Mi9,299,-4,12,10,2,"-4,12"
7159,720575940624782316,right,Mi9,300,4,-18,-13,-5,"4,-18"
7160,720575940612917362,right,Mi9,301,-5,16,13,3,"-5,16"
7161,720575940610881912,right,Mi9,302,2,17,6,11,"2,17"
7162,720575940639901501,right,Mi9,303,-5,22,16,6,"-5,22"
7163,720575940623750986,right,Mi9,304,6,5,-4,9,"6,5"
7164,720575940626606522,right,Mi9,305,-7,4,9,-5,"-7,4"
7165,720575940630060119,right,Mi9,306,3,7,0,7,"3,7"
7166,720575940624139288,right,Mi9,307,5,-25,-18,-7,"5,-25"
7167,720575940614052136,right,Mi9,308,-5,8,9,-1,"-5,8"
7168,720575940631023980,right,Mi9,309,-6,12,12,0,"-6,12"
7169,720575940628432583,right,Mi9,310,2,22,9,13,"2,22"
7170,720575940630877689,right,Mi9,311,-7,15,14,1,"-7,15"
7171,720575940610085582,right,Mi9,312,4,-7,-8,1,"4,-7"
7172,720575940628180298,right,Mi9,313,7,3,-6,9,"7,3"
7173,720575940626384134,right,Mi9,314,-9,5,11,-6,"-9,5"
7174,720575940631796537,right,Mi9,315,-3,-6,0,-6,"-3,-6"
7175,720575940623898760,right,Mi9,316,5,-4,-7,3,"5,-4"
7176,720575940626993426,right,Mi9,317,-5,-4,3,-7,"-5,-4"
7177,720575940613838317,right,Mi9,318,4,-19,-14,-5,"4,-19"
7178,720575940616864571,right,Mi9,319,-2,5,4,1,"-2,5"
7179,720575940628301830,right,Mi9,320,-2,-5,-1,-4,"-2,-5"
7180,720575940628790544,right,Mi9,321,8,4,-6,10,"8,4"
7181,720575940623261976,right,Mi9,322,2,26,11,15,"2,26"
7182,720575940628814083,right,Mi9,323,-7,-13,0,-13,"-7,-13"
7183,720575940612894613,right,Mi9,324,3,24,9,15,"3,24"
7184,720575940630920332,right,Mi9,325,5,1,-5,6,"5,1"
7185,720575940617732537,right,Mi9,326,2,16,6,10,"2,16"
7186,720575940618889029,right,Mi9,327,5,3,-4,7,"5,3"
7187,720575940628363228,right,Mi9,328,5,-9,-10,1,"5,-9"
7188,720575940630813890,right,Mi9,329,0,24,12,12,"0,24"
7189,720575940606430310,right,Mi9,331,1,-15,-9,-6,"1,-15"
7190,720575940638154473,right,Mi9,332,4,-26,-17,-9,"4,-26"
7191,720575940636051563,right,Mi9,333,0,-21,-11,-10,"0,-21"
7192,720575940624547051,right,Mi9,334,1,-26,-14,-12,"1,-26"
7193,720575940604891680,right,Mi9,336,0,23,11,12,"0,23"
7194,720575940637483661,right,Mi9,337,-5,-6,2,-8,"-5,-6"
7195,720575940603472608,right,Mi9,338,-1,0,1,-1,"-1,0"
7196,720575940642464397,right,Mi9,340,-4,17,12,5,"-4,17"
7197,720575940627247930,right,Mi9,341,6,-17,-15,-2,"6,-17"
7198,720575940600782252,right,Mi9,342,2,-15,-10,-5,"2,-15"
7199,720575940631257964,right,Mi9,343,-3,27,16,11,"-3,27"
7200,720575940610049433,right,Mi9,344,-2,-15,-6,-9,"-2,-15"
7201,720575940632661388,right,Mi9,345,3,-12,-9,-3,"3,-12"
7202,720575940622713814,right,Mi9,346,-7,-9,2,-11,"-7,-9"
7203,720575940629301442,right,Mi9,347,-5,-13,-2,-11,"-5,-13"
7204,720575940625739085,right,Mi9,348,3,14,4,10,"3,14"
7205,720575940637569933,right,Mi9,349,-5,-14,-2,-12,"-5,-14"
7206,720575940608337842,right,Mi9,350,1,15,6,9,"1,15"
7207,720575940640120142,right,Mi9,351,-1,-17,-8,-9,"-1,-17"
7208,720575940631440441,right,Mi9,352,-2,28,16,12,"-2,28"
7209,720575940618071953,right,Mi9,353,2,24,10,14,"2,24"
7210,720575940617251723,right,Mi9,354,-2,-26,-11,-15,"-2,-26"
7211,720575940616824859,right,Mi9,355,-7,-6,4,-10,"-7,-6"
7212,720575940629036331,right,Mi9,356,0,22,11,11,"0,22"
7213,720575940610968838,right,Mi9,357,4,17,4,13,"4,17"
7214,720575940631250639,right,Mi9,358,-3,17,11,6,"-3,17"
7215,720575940620636177,right,Mi9,359,2,23,9,14,"2,23"
7216,720575940613981480,right,Mi9,360,-5,19,14,5,"-5,19"
7217,720575940619569880,right,Mi9,361,0,-7,-4,-3,"0,-7"
7218,720575940610713134,right,Mi9,362,2,-20,-12,-8,"2,-20"
7219,720575940629811582,right,Mi9,363,7,-4,-9,5,"7,-4"
7220,720575940634578201,right,Mi9,364,4,4,-2,6,"4,4"
7221,720575940633409107,right,Mi9,366,-5,-20,-5,-15,"-5,-20"
7222,720575940627131005,right,Mi9,367,-6,-15,-2,-13,"-6,-15"
7223,720575940627174277,right,Mi9,368,-4,-20,-6,-14,"-4,-20"
7224,720575940615758809,right,Mi9,369,5,-5,-8,3,"5,-5"
7225,720575940620673670,right,Mi9,370,-3,21,13,8,"-3,21"
7226,720575940631840587,right,Mi9,371,6,-5,-9,4,"6,-5"
7227,720575940629271056,right,Mi9,372,1,-2,-2,0,"1,-2"
7228,720575940619153462,right,Mi9,373,1,-21,-12,-9,"1,-21"
7229,720575940609900612,right,Mi9,374,2,13,4,9,"2,13"
7230,720575940617258452,right,Mi9,375,-6,7,9,-2,"-6,7"
7231,720575940639929944,right,Mi9,376,-7,-10,2,-12,"-7,-10"
7232,720575940628582385,right,Mi9,377,0,7,3,4,"0,7"
7233,720575940629819547,right,Mi9,378,-3,18,12,6,"-3,18"
7234,720575940655819937,right,Mi9,379,3,-17,-12,-5,"3,-17"
7235,720575940625215420,right,Mi9,380,-1,29,15,14,"-1,29"
7236,720575940621451466,right,Mi9,381,-8,-9,3,-12,"-8,-9"
7237,720575940617209980,right,Mi9,382,3,-6,-6,0,"3,-6"
7238,720575940638574936,right,Mi9,383,-6,11,11,0,"-6,11"
7239,720575940633443103,right,Mi9,384,-6,-2,5,-7,"-6,-2"
7240,720575940611478734,right,Mi9,385,-3,-18,-6,-12,"-3,-18"
7241,720575940635001566,right,Mi9,386,-6,19,15,4,"-6,19"
7242,720575940625636903,right,Mi9,387,-1,-15,-7,-8,"-1,-15"
7243,720575940614743080,right,Mi9,388,3,19,6,13,"3,19"
7244,720575940617186777,right,Mi9,389,-6,-16,-2,-14,"-6,-16"
7245,720575940630542295,right,Mi9,390,-6,-9,1,-10,"-6,-9"
7246,720575940639879229,right,Mi9,391,4,-3,-6,3,"4,-3"
7247,720575940627804945,right,Mi9,392,-4,7,7,0,"-4,7"
7248,720575940630828150,right,Mi9,393,-1,22,12,10,"-1,22"
7249,720575940626402125,right,Mi9,394,-7,-8,3,-11,"-7,-8"
7250,720575940614906774,right,Mi9,395,0,-22,-11,-11,"0,-22"
7251,720575940613876787,right,Mi9,396,-1,10,6,4,"-1,10"
7252,720575940631159660,right,Mi9,397,-3,-19,-7,-12,"-3,-19"
7253,720575940610291268,right,Mi9,398,-3,22,14,8,"-3,22"
7254,720575940620570027,right,Mi9,399,-4,-24,-8,-16,"-4,-24"
7255,720575940630681026,right,Mi9,400,1,-29,-16,-13,"1,-29"
7256,720575940608302172,right,Mi9,401,-2,-19,-8,-11,"-2,-19"
7257,720575940606663014,right,Mi9,402,3,26,10,16,"3,26"
7258,720575940631569464,right,Mi9,403,-2,-12,-4,-8,"-2,-12"
7259,720575940632159289,right,Mi9,404,-1,20,11,9,"-1,20"
7260,720575940607354754,right,Mi9,405,3,10,2,8,"3,10"
7261,720575940630874107,right,Mi9,406,1,-25,-14,-11,"1,-25"
7262,720575940629331817,right,Mi9,407,-5,-10,0,-10,"-5,-10"
7263,720575940622977123,right,Mi9,408,-6,-4,4,-8,"-6,-4"
7264,720575940629427260,right,Mi9,409,0,-3,-2,-1,"0,-3"
7265,720575940633262817,right,Mi9,410,-2,-2,1,-3,"-2,-2"
7266,720575940605851838,right,Mi9,411,-5,-19,-5,-14,"-5,-19"
7267,720575940620090957,right,Mi9,412,-6,21,16,5,"-6,21"
7268,720575940623653256,right,Mi9,413,-2,-7,-2,-5,"-2,-7"
7269,720575940620555781,right,Mi9,414,4,21,6,15,"4,21"
7270,720575940628276674,right,Mi9,415,6,12,0,12,"6,12"
7271,720575940608026390,right,Mi9,416,3,-8,-7,-1,"3,-8"
7272,720575940636468855,right,Mi9,417,-6,-10,1,-11,"-6,-10"
7273,720575940614505937,right,Mi9,418,-2,15,9,6,"-2,15"
7274,720575940621290923,right,Mi9,419,-3,-11,-3,-8,"-3,-11"
7275,720575940627176310,right,Mi9,420,6,-3,-8,5,"6,-3"
7276,720575940624671363,right,Mi9,421,-1,12,7,5,"-1,12"
7277,720575940621247329,right,Mi9,422,-7,-4,5,-9,"-7,-4"
7278,720575940626901348,right,Mi9,423,3,-18,-12,-6,"3,-18"
7279,720575940627406867,right,Mi9,424,-3,-2,2,-4,"-3,-2"
7280,720575940629868226,right,Mi9,425,3,20,7,13,"3,20"
7281,720575940619363544,right,Mi9,426,-3,0,3,-3,"-3,0"
7282,720575940611725006,right,Mi9,427,5,-18,-14,-4,"5,-18"
7283,720575940614116575,right,Mi9,428,-2,23,13,10,"-2,23"
7284,720575940618128129,right,Mi9,429,-2,14,9,5,"-2,14"
7285,720575940619565214,right,Mi9,430,-3,-7,-1,-6,"-3,-7"
7286,720575940610662264,right,Mi9,431,-2,-10,-3,-7,"-2,-10"
7287,720575940629101840,right,Mi9,432,-5,7,8,-1,"-5,7"
7288,720575940619765414,right,Mi9,433,0,-8,-4,-4,"0,-8"
7289,720575940624623911,right,Mi9,434,-3,7,6,1,"-3,7"
7290,720575940616906508,right,Mi9,435,5,-17,-14,-3,"5,-17"
7291,720575940626453762,right,Mi9,436,0,-15,-8,-7,"0,-15"
7292,720575940629183311,right,Mi9,437,-3,12,9,3,"-3,12"
7293,720575940619567774,right,Mi9,438,2,27,11,16,"2,27"
7294,720575940626140730,right,Mi9,439,-3,-9,-2,-7,"-3,-9"
7295,720575940630941691,right,Mi9,440,1,23,10,13,"1,23"
7296,720575940601598892,right,Mi9,441,3,-16,-11,-5,"3,-16"
7297,720575940633726862,right,Mi9,442,-5,25,17,8,"-5,25"
7298,720575940618862400,right,Mi9,443,-6,4,8,-4,"-6,4"
7299,720575940612078267,right,Mi9,444,4,-10,-9,-1,"4,-10"
7300,720575940650618870,right,Mi9,445,-2,8,6,2,"-2,8"
7301,720575940622780853,right,Mi9,446,2,-14,-9,-5,"2,-14"
7302,720575940632823009,right,Mi9,447,-1,2,2,0,"-1,2"
7303,720575940629683279,right,Mi9,448,0,30,15,15,"0,30"
7304,720575940621149805,right,Mi9,449,6,-16,-14,-2,"6,-16"
7305,720575940620703659,right,Mi9,450,2,-9,-7,-2,"2,-9"
7306,720575940623618598,right,Mi9,451,4,20,6,14,"4,20"
7307,720575940613117554,right,Mi9,452,1,-9,-6,-3,"1,-9"
7308,720575940624417771,right,Mi9,453,3,25,9,16,"3,25"
7309,720575940648575364,right,Mi9,454,5,-12,-11,-1,"5,-12"
7310,720575940615688258,right,Mi9,455,7,-7,-11,4,"7,-7"
7311,720575940622329491,right,Mi9,456,0,21,10,11,"0,21"
7312,720575940637351598,right,Mi9,457,-2,17,10,7,"-2,17"
7313,720575940629587791,right,Mi9,458,5,0,-5,5,"5,0"
7314,720575940627174262,right,Mi9,459,5,-3,-7,4,"5,-3"
7315,720575940624443319,right,Mi9,460,-3,-20,-7,-13,"-3,-20"
7316,720575940642082523,right,Mi9,461,7,-5,-10,5,"7,-5"
7317,720575940624171528,right,Mi9,462,-1,18,10,8,"-1,18"
7318,720575940638959167,right,Mi9,463,5,17,3,14,"5,17"
7319,720575940637292901,right,Mi9,464,4,0,-4,4,"4,0"
7320,720575940623522857,right,Mi9,465,3,0,-3,3,"3,0"
7321,720575940615145366,right,Mi9,466,1,14,6,8,"1,14"
7322,720575940623058712,right,Mi9,467,-2,-20,-8,-12,"-2,-20"
7323,720575940633255379,right,Mi9,468,-3,11,8,3,"-3,11"
7324,720575940616475393,right,Mi9,469,-7,13,13,0,"-7,13"
7325,720575940618398155,right,Mi9,470,4,-9,-9,0,"4,-9"
7326,720575940624754156,right,Mi9,471,3,-26,-16,-10,"3,-26"
7327,720575940617731377,right,Mi9,473,-4,23,15,8,"-4,23"
7328,720575940635423386,right,Mi9,474,-3,-17,-6,-11,"-3,-17"
7329,720575940614930107,right,Mi9,475,-4,-1,3,-4,"-4,-1"
7330,720575940619766033,right,Mi9,476,-1,15,8,7,"-1,15"
7331,720575940626543747,right,Mi9,477,-3,2,4,-2,"-3,2"
7332,720575940633704287,right,Mi9,478,-7,16,15,1,"-7,16"
7333,720575940641730189,right,Mi9,479,-2,10,7,3,"-2,10"
7334,720575940626184067,right,Mi9,480,3,-19,-13,-6,"3,-19"
7335,720575940608002326,right,Mi9,481,4,-8,-8,0,"4,-8"
7336,720575940625010407,right,Mi9,482,1,17,7,10,"1,17"
7337,720575940634636895,right,Mi9,483,2,-7,-6,-1,"2,-7"
7338,720575940623461000,right,Mi9,484,3,-9,-8,-1,"3,-9"
7339,720575940619293819,right,Mi9,485,-3,-3,1,-4,"-3,-3"
7340,720575940614310627,right,Mi9,486,0,1,0,1,"0,1"
7341,720575940652015862,right,Mi9,487,1,-1,-2,1,"1,-1"
7342,720575940643823924,right,Mi9,488,7,5,-5,10,"7,5"
7343,720575940621526710,right,Mi9,489,-3,10,8,2,"-3,10"
7344,720575940610203460,right,Mi9,490,-5,6,8,-2,"-5,6"
7345,720575940635202711,right,Mi9,491,7,-1,-8,7,"7,-1"
7346,720575940627903994,right,Mi9,492,-7,-2,6,-8,"-7,-2"
7347,720575940640307827,right,Mi9,493,-3,23,14,9,"-3,23"
7348,720575940617821657,right,Mi9,494,0,29,14,15,"0,29"
7349,720575940608344789,right,Mi9,496,7,8,-3,11,"7,8"
7350,720575940628557211,right,Mi9,497,6,1,-6,7,"6,1"
7351,720575940612761842,right,Mi9,498,6,10,-1,11,"6,10"
7352,720575940630180711,right,Mi9,499,5,10,0,10,"5,10"
7353,720575940611706830,right,Mi9,500,7,-8,-11,3,"7,-8"
7354,720575940604698633,right,Mi9,501,1,2,0,2,"1,2"
7355,720575940619481408,right,Mi9,502,5,8,-1,9,"5,8"
7356,720575940625635074,right,Mi9,503,3,17,5,12,"3,17"
7357,720575940624775159,right,Mi9,504,-2,9,6,3,"-2,9"
7358,720575940655474593,right,Mi9,505,6,-22,-17,-5,"6,-22"
7359,720575940615158959,right,Mi9,506,1,-12,-7,-5,"1,-12"
7360,720575940611966613,right,Mi9,507,-5,-12,-1,-11,"-5,-12"
7361,720575940624615659,right,Mi9,508,-5,11,10,1,"-5,11"
7362,720575940620704608,right,Mi9,509,-4,10,9,1,"-4,10"
7363,720575940637024367,right,Mi9,510,-2,11,7,4,"-2,11"
7364,720575940633216047,right,Mi9,511,5,-11,-11,0,"5,-11"
7365,720575940620704171,right,Mi9,512,6,0,-6,6,"6,0"
7366,720575940631896376,right,Mi9,513,-4,-13,-3,-10,"-4,-13"
7367,720575940621708129,right,Mi9,514,-4,-10,-1,-9,"-4,-10"
7368,720575940624578567,right,Mi9,515,-8,-7,4,-11,"-8,-7"
7369,720575940615195615,right,Mi9,516,7,-18,-16,-2,"7,-18"
7370,720575940632934030,right,Mi9,518,-4,22,15,7,"-4,22"
7371,720575940623986951,right,Mi9,519,-5,-5,2,-7,"-5,-5"
7372,720575940622922701,right,Mi9,520,-2,-22,-9,-13,"-2,-22"
7373,720575940618625349,right,Mi9,521,6,-9,-11,2,"6,-9"
7374,720575940610273348,right,Mi9,522,-4,0,4,-4,"-4,0"
7375,720575940610956550,right,Mi9,523,2,14,5,9,"2,14"
7376,720575940610163918,right,Mi9,524,4,-20,-14,-6,"4,-20"
7377,720575940614181538,right,Mi9,525,-1,-20,-9,-11,"-1,-20"
7378,720575940629937399,right,Mi9,526,0,-10,-5,-5,"0,-10"
7379,720575940620092660,right,Mi9,527,-4,-8,0,-8,"-4,-8"
7380,720575940618080285,right,Mi9,529,2,-2,-3,1,"2,-2"
7381,720575940628256103,right,Mi9,530,-3,-13,-4,-9,"-3,-13"
7382,720575940630848579,right,Mi9,531,1,0,-1,1,"1,0"
7383,720575940611701312,right,Mi9,532,-8,7,11,-4,"-8,7"
7384,720575940628962639,right,Mi9,533,0,-16,-8,-8,"0,-16"
7385,720575940634332953,right,Mi9,534,3,2,-2,4,"3,2"
7386,720575940647424900,right,Mi9,535,8,-4,-10,6,"8,-4"
7387,720575940641943771,right,Mi9,536,3,4,-1,5,"3,4"
7388,720575940629387014,right,Mi9,537,0,-23,-12,-11,"0,-23"
7389,720575940634221025,right,Mi9,538,-4,1,4,-3,"-4,1"
7390,720575940631764561,right,Mi9,539,-6,15,13,2,"-6,15"
7391,720575940615226274,right,Mi9,540,-2,-9,-3,-6,"-2,-9"
7392,720575940627179389,right,Mi9,541,-4,14,11,3,"-4,14"
7393,720575940607279452,right,Mi9,542,6,-13,-13,0,"6,-13"
7394,720575940659970177,right,Mi9,543,-1,-4,-1,-3,"-1,-4"
7395,720575940622032628,right,Mi9,544,3,-13,-10,-3,"3,-13"
7396,720575940619760433,right,Mi9,545,5,11,0,11,"5,11"
7397,720575940623938659,right,Mi9,546,3,6,0,6,"3,6"
7398,720575940622305449,right,Mi9,547,-1,21,11,10,"-1,21"
7399,720575940618066406,right,Mi9,548,1,-16,-9,-7,"1,-16"
7400,720575940621573473,right,Mi9,549,0,-9,-5,-4,"0,-9"
7401,720575940614824098,right,Mi9,550,-2,3,3,0,"-2,3"
7402,720575940632554925,right,Mi9,551,-4,-9,-1,-8,"-4,-9"
7403,720575940623547628,right,Mi9,552,4,-1,-5,4,"4,-1"
7404,720575940610006738,right,Mi9,553,-3,16,11,5,"-3,16"
7405,720575940626207761,right,Mi9,554,-9,-3,7,-10,"-9,-3"
7406,720575940629420618,right,Mi9,555,-4,9,8,1,"-4,9"
7407,720575940612798899,right,Mi9,556,0,10,5,5,"0,10"
7408,720575940628019906,right,Mi9,557,6,-10,-11,1,"6,-10"
7409,720575940615739298,right,Mi9,558,-4,-21,-7,-14,"-4,-21"
7410,720575940627921018,right,Mi9,559,-6,22,17,5,"-6,22"
7411,720575940620179476,right,Mi9,560,-7,14,14,0,"-7,14"
7412,720575940630769090,right,Mi9,561,5,7,-2,9,"5,7"
7413,720575940635824503,right,Mi9,562,-5,-2,4,-6,"-5,-2"
7414,720575940626898038,right,Mi9,563,5,-13,-12,-1,"5,-13"
7415,720575940629396554,right,Mi9,564,3,-23,-15,-8,"3,-23"
7416,720575940623455612,right,Mi9,565,0,-26,-13,-13,"0,-26"
7417,720575940619231341,right,Mi9,566,5,-8,-9,1,"5,-8"
7418,720575940630364727,right,Mi9,567,-2,22,13,9,"-2,22"
7419,720575940637578893,right,Mi9,568,-6,-8,2,-10,"-6,-8"
7420,720575940621865569,right,Mi9,569,6,6,-3,9,"6,6"
7421,720575940623679684,right,Mi9,570,2,25,10,15,"2,25"
7422,720575940612031090,right,Mi9,571,0,-14,-7,-7,"0,-14"
7423,720575940626863050,right,Mi9,572,-8,3,9,-6,"-8,3"
7424,720575940607317634,right,Mi9,573,4,14,3,11,"4,14"
7425,720575940614394577,right,Mi9,574,-6,5,8,-3,"-6,5"
7426,720575940621669997,right,Mi9,575,6,9,-2,11,"6,9"
7427,720575940614051635,right,Mi9,576,0,28,14,14,"0,28"
7428,720575940646255726,right,Mi9,577,5,-14,-12,-2,"5,-14"
7429,720575940612129211,right,Mi9,578,4,-11,-10,-1,"4,-11"
7430,720575940614650791,right,Mi9,579,-3,-10,-2,-8,"-3,-10"
7431,720575940606652960,right,Mi9,580,-2,-23,-10,-13,"-2,-23"
7432,720575940614115247,right,Mi9,582,-1,23,12,11,"-1,23"
7433,720575940616278028,right,Mi9,583,3,-25,-16,-9,"3,-25"
7434,720575940620913243,right,Mi9,584,4,23,7,16,"4,23"
7435,720575940614390481,right,Mi9,585,-1,-23,-11,-12,"-1,-23"
7436,720575940612730920,right,Mi9,586,2,18,7,11,"2,18"
7437,720575940624162229,right,Mi9,587,4,22,7,15,"4,22"
7438,720575940645704983,right,Mi9,588,1,4,1,3,"1,4"
7439,720575940634832028,right,Mi9,589,-1,-5,-2,-3,"-1,-5"
7440,720575940632342063,right,Mi9,591,3,-3,-5,2,"3,-3"
7441,720575940623222808,right,Mi9,593,3,-14,-10,-4,"3,-14"
7442,720575940618189371,right,Mi9,594,7,-16,-15,-1,"7,-16"
7443,720575940632689433,right,Mi9,595,7,-12,-13,1,"7,-12"
7444,720575940623140607,right,Mi9,596,-4,-16,-4,-12,"-4,-16"
7445,720575940639753917,right,Mi9,597,4,1,-4,5,"4,1"
7446,720575940613559471,right,Mi9,598,2,-18,-11,-7,"2,-18"
7447,720575940625674428,right,Mi9,599,-1,9,5,4,"-1,9"
7448,720575940628868603,right,Mi9,600,3,-10,-8,-2,"3,-10"
7449,720575940621971327,right,Mi9,601,1,16,7,9,"1,16"
7450,720575940615946171,right,Mi9,602,4,-2,-5,3,"4,-2"
7451,720575940627064595,right,Mi9,603,-3,-23,-9,-14,"-3,-23"
7452,720575940616265659,right,Mi9,604,-6,-17,-3,-14,"-6,-17"
7453,720575940638323940,right,Mi9,605,3,15,4,11,"3,15"
7454,720575940610277188,right,Mi9,606,-1,-19,-9,-10,"-1,-19"
7455,720575940629175375,right,Mi9,607,1,18,8,10,"1,18"
7456,720575940635704215,right,Mi9,608,1,10,4,6,"1,10"
7457,720575940616756948,right,Mi9,609,-2,0,2,-2,"-2,0"
7458,720575940634661274,right,Mi9,610,2,-23,-14,-9,"2,-23"
7459,720575940617223124,right,Mi9,611,-1,-18,-8,-10,"-1,-18"
7460,720575940639992398,right,Mi9,612,-3,-26,-10,-16,"-3,-26"
7461,720575940609354179,right,Mi9,613,-8,-4,6,-10,"-8,-4"
7462,720575940628158407,right,Mi9,614,-2,-8,-2,-6,"-2,-8"
7463,720575940637620621,right,Mi9,615,-7,-7,3,-10,"-7,-7"
7464,720575940630582492,right,Mi9,616,-3,15,10,5,"-3,15"
7465,720575940622096154,right,Mi9,617,-2,-17,-7,-10,"-2,-17"
7466,720575940641643483,right,Mi9,618,-1,24,13,11,"-1,24"
7467,720575940623712973,right,Mi9,619,-4,-19,-6,-13,"-4,-19"
7468,720575940630549114,right,Mi9,620,7,1,-7,8,"7,1"
7469,720575940614721534,right,Mi9,621,1,24,11,13,"1,24"
7470,720575940625994756,right,Mi9,622,-5,20,15,5,"-5,20"
7471,720575940633365535,right,Mi9,624,1,-17,-10,-7,"1,-17"
7472,720575940627806986,right,Mi9,625,-2,24,14,10,"-2,24"
7473,720575940618143060,right,Mi9,626,-5,-8,1,-9,"-5,-8"
7474,720575940635834975,right,Mi9,627,0,-1,-1,0,"0,-1"
7475,720575940622690954,right,Mi9,628,0,0,0,0,"0,0"
7476,720575940615434562,right,Mi9,629,4,24,8,16,"4,24"
7477,720575940624458791,right,Mi9,630,4,8,0,8,"4,8"
7478,720575940630758764,right,Mi9,631,1,26,12,14,"1,26"
7479,720575940636749167,right,Mi9,632,3,-20,-13,-7,"3,-20"
7480,720575940645393006,right,Mi9,633,-1,-24,-11,-13,"-1,-24"
7481,720575940619122036,right,Mi9,634,-3,-15,-5,-10,"-3,-15"
7482,720575940627101302,right,Mi9,635,6,-6,-9,3,"6,-6"
7483,720575940610161365,right,Mi9,636,0,6,3,3,"0,6"
7484,720575940631503887,right,Mi9,637,3,-21,-14,-7,"3,-21"
7485,720575940626762183,right,Mi9,638,-1,7,4,3,"-1,7"
7486,720575940616497214,right,Mi9,639,-4,19,13,6,"-4,19"
7487,720575940623330318,right,Mi9,640,-1,-16,-7,-9,"-1,-16"
7488,720575940622616649,right,Mi9,641,-8,-5,5,-10,"-8,-5"
7489,720575940615720095,right,Mi9,642,-5,-11,-1,-10,"-5,-11"
7490,720575940633884205,right,Mi9,643,6,14,1,13,"6,14"
7491,720575940631958339,right,Mi9,644,-6,18,15,3,"-6,18"
7492,720575940612464370,right,Mi9,645,-4,27,17,10,"-4,27"
7493,720575940608908483,right,Mi9,646,6,17,2,15,"6,17"
7494,720575940621997172,right,Mi9,647,-4,-7,0,-7,"-4,-7"
7495,720575940626802224,right,Mi9,648,1,7,2,5,"1,7"
7496,720575940616437021,right,Mi9,649,-1,5,3,2,"-1,5"
7497,720575940622527871,right,Mi9,650,-3,-25,-10,-15,"-3,-25"
7498,720575940654680993,right,Mi9,651,-4,-5,1,-6,"-4,-5"
7499,720575940620172885,right,Mi9,652,-6,-11,0,-11,"-6,-11"
7500,720575940637373254,right,Mi9,653,-6,-12,0,-12,"-6,-12"
7501,720575940619339537,right,Mi9,654,-3,8,7,1,"-3,8"
7502,720575940611734734,right,Mi9,655,6,-1,-7,6,"6,-1"
7503,720575940627212561,right,Mi9,656,0,-11,-6,-5,"0,-11"
7504,720575940630640128,right,Mi9,657,-2,-25,-11,-14,"-2,-25"
7505,720575940627213437,right,Mi9,658,1,20,9,11,"1,20"
7506,720575940616380347,right,Mi9,659,-4,-6,1,-7,"-4,-6"
7507,720575940613599914,right,Mi9,660,2,28,12,16,"2,28"
7508,720575940632999469,right,Mi9,661,-3,14,10,4,"-3,14"
7509,720575940627159926,right,Mi9,662,2,-1,-3,2,"2,-1"
7510,720575940618545638,right,Mi9,663,0,8,4,4,"0,8"
7511,720575940633340627,right,Mi9,664,1,-27,-15,-12,"1,-27"
7512,720575940608334770,right,Mi9,665,7,-2,-8,6,"7,-2"
7513,720575940623789712,right,Mi9,666,7,-13,-14,1,"7,-13"
7514,720575940634649826,right,Mi9,667,1,-28,-15,-13,"1,-28"
7515,720575940631587090,right,Mi9,668,1,19,8,11,"1,19"
7516,720575940629762554,right,Mi9,669,4,-16,-12,-4,"4,-16"
7517,720575940628664571,right,Mi9,672,-8,11,13,-2,"-8,11"
7518,720575940608247426,right,Mi9,673,2,5,0,5,"2,5"
7519,720575940618395229,right,Mi9,674,-4,-14,-3,-11,"-4,-14"
7520,720575940637929816,right,Mi9,675,-7,19,16,3,"-7,19"
7521,720575940630943319,right,Mi9,676,-3,-21,-8,-13,"-3,-21"
7522,720575940613906802,right,Mi9,677,0,11,5,6,"0,11"
7523,720575940623704061,right,Mi9,678,3,-7,-7,0,"3,-7"
7524,720575940620619358,right,Mi9,679,4,18,5,13,"4,18"
7525,720575940638796102,right,Mi9,680,-1,25,13,12,"-1,25"
7526,720575940629261553,right,Mi9,681,-2,-21,-9,-12,"-2,-21"
7527,720575940624918932,right,Mi9,682,6,-8,-10,2,"6,-8"
7528,720575940622321953,right,Mi9,684,-6,17,14,3,"-6,17"
7529,720575940612705253,right,Mi9,685,-5,-9,0,-9,"-5,-9"
7530,720575940615357649,right,Mi9,686,5,-22,-16,-6,"5,-22"
7531,720575940631833171,right,Mi9,687,-6,-3,4,-7,"-6,-3"
7532,720575940617666264,right,Mi9,688,-7,10,12,-2,"-7,10"
7533,720575940620861778,right,Mi9,689,-2,18,11,7,"-2,18"
7534,720575940630547420,right,Mi9,690,-7,-3,5,-8,"-7,-3"
7535,720575940625052348,right,Mi9,691,-9,4,11,-7,"-9,4"
7536,720575940631247831,right,Mi9,692,-4,24,16,8,"-4,24"
7537,720575940619069758,right,Mi9,693,-3,25,15,10,"-3,25"
7538,720575940610184049,right,Mi9,695,-6,10,11,-1,"-6,10"
7539,720575940638560740,right,Mi9,696,-2,16,10,6,"-2,16"
7540,720575940622353065,right,Mi9,697,1,-22,-12,-10,"1,-22"
7541,720575940620263640,right,Mi9,698,6,-7,-10,3,"6,-7"
7542,720575940618875805,right,Mi9,699,-5,0,5,-5,"-5,0"
7543,720575940635329016,right,Mi9,700,5,15,2,13,"5,15"
7544,720575940637651312,right,Mi9,701,0,-4,-2,-2,"0,-4"
7545,720575940610198596,right,Mi9,702,-5,23,16,7,"-5,23"
7546,720575940629986295,right,Mi9,703,-3,1,3,-2,"-3,1"
7547,720575940629312855,right,Mi9,704,-7,8,11,-3,"-7,8"
7548,720575940630382188,right,Mi9,705,1,1,-1,2,"1,1"
7549,720575940628799985,right,Mi9,706,-7,-12,1,-13,"-7,-12"
7550,720575940639755829,right,Mi9,707,-2,25,14,11,"-2,25"
7551,720575940614431890,right,Mi9,708,-4,-25,-9,-16,"-4,-25"
7552,720575940620955526,right,Mi9,709,-2,-24,-10,-14,"-2,-24"
7553,720575940614051821,right,Mi9,710,4,-25,-17,-8,"4,-25"
7554,720575940625237321,right,Mi9,711,-1,19,10,9,"-1,19"
7555,720575940632908883,right,Mi9,712,-7,12,13,-1,"-7,12"
7556,720575940638253028,right,Mi9,713,-6,16,14,2,"-6,16"
7557,720575940623264611,right,Mi9,715,4,10,1,9,"4,10"
7558,720575940625972016,right,Mi9,716,4,-6,-7,1,"4,-6"
7559,720575940635114687,right,Mi9,717,2,-22,-13,-9,"2,-22"
7560,720575940636556358,right,Mi9,718,-5,24,17,7,"-5,24"
7561,720575940632395233,right,Mi9,719,1,27,12,15,"1,27"
7562,720575940627941704,right,Mi9,720,-5,21,15,6,"-5,21"
7563,720575940626032119,right,Mi9,721,5,13,1,12,"5,13"
7564,720575940627246937,right,Mi9,722,6,-15,-14,-1,"6,-15"
7565,720575940625809040,right,Mi9,723,-2,-11,-4,-7,"-2,-11"
7566,720575940646098979,right,Mi9,725,-3,-24,-9,-15,"-3,-24"
7567,720575940627809960,right,Mi9,727,7,6,-4,10,"7,6"
7568,720575940617617849,right,Mi9,728,7,12,-1,13,"7,12"
7569,720575940629013547,right,Mi9,729,-3,29,17,12,"-3,29"
7570,720575940622487322,right,Mi9,730,7,0,-7,7,"7,0"
7571,720575940612257551,right,Mi9,731,-6,9,10,-1,"-6,9"
7572,720575940622981193,right,Mi9,732,-3,6,6,0,"-3,6"
7573,720575940642495885,right,Mi9,733,-5,-17,-4,-13,"-5,-17"
7574,720575940631945908,right,Mi9,734,2,0,-2,2,"2,0"
7575,720575940632819148,right,Mi9,735,1,-23,-13,-10,"1,-23"
7576,720575940629276613,right,Mi9,736,-8,1,8,-7,"-8,1"
7577,720575940624783653,right,Mi9,737,0,19,9,10,"0,19"
7578,720575940632824780,right,Mi9,738,-3,13,9,4,"-3,13"
7579,720575940635760632,right,Mi9,739,-7,2,8,-6,"-7,2"
7580,720575940638068096,right,Mi9,740,2,-8,-6,-2,"2,-8"
7581,720575940620674287,right,Mi9,741,-2,-14,-5,-9,"-2,-14"
7582,720575940608906249,right,Mi9,742,-4,11,9,2,"-4,11"
7583,720575940630263746,right,Mi9,743,6,-19,-16,-3,"6,-19"
7584,720575940638230244,right,Mi9,744,-4,25,16,9,"-4,25"
7585,720575940633357649,right,Mi9,745,0,13,6,7,"0,13"
7586,720575940626951178,right,Mi9,746,-3,3,4,-1,"-3,3"
7587,720575940605186225,right,Mi9,747,0,2,1,1,"0,2"
7588,720575940610582084,right,Mi9,748,-4,20,14,6,"-4,20"
7589,720575940625544732,right,Mi9,749,-2,1,2,-1,"-2,1"
7590,720575940631925349,right,Mi9,750,4,-24,-16,-8,"4,-24"
7591,720575940646537582,right,Mi9,751,1,6,2,4,"1,6"
7592,720575940635411374,right,Mi9,752,-2,7,5,2,"-2,7"
7593,720575940614693374,right,Mi9,753,-3,24,15,9,"-3,24"
7594,720575940628808235,right,Mi9,754,-1,-13,-6,-7,"-1,-13"
7595,720575940635029785,right,Mi9,755,4,19,5,14,"4,19"
7596,720575940627556126,right,Mi9,756,5,20,5,15,"5,20"
7597,720575940626830723,right,Mi9,757,0,-6,-3,-3,"0,-6"
7598,720575940624684316,right,Mi9,758,5,-1,-6,5,"5,-1"
7599,720575940630373623,right,Mi9,759,7,14,0,14,"7,14"
7600,720575940641633499,right,Mi9,760,0,17,8,9,"0,17"
7601,720575940626308113,right,Mi9,761,-4,-18,-5,-13,"-4,-18"
7602,720575940611424462,right,Mi9,762,0,14,7,7,"0,14"
7603,720575940623773576,right,Mi9,763,-5,14,12,2,"-5,14"
7604,720575940644950052,right,Mi9,764,-8,-6,5,-11,"-8,-6"
7605,720575940614593489,right,Mi9,765,-3,9,7,2,"-3,9"
7606,720575940638726116,right,Mi9,766,2,-4,-4,0,"2,-4"
7607,720575940608636169,right,Mi9,767,1,28,13,15,"1,28"
7608,720575940615974294,right,Mi9,768,3,5,-1,6,"3,5"
7609,720575940621615498,right,Mi9,769,4,-27,-18,-9,"4,-27"
7610,720575940620669400,right,Mi9,770,5,4,-3,7,"5,4"
7611,720575940642607067,right,Mi9,771,3,-27,-17,-10,"3,-27"
7612,720575940610702946,right,Mi9,772,1,12,5,7,"1,12"
7613,720575940617814326,right,Mi9,773,5,-19,-15,-4,"5,-19"
7614,720575940624644277,right,Mi9,774,-8,6,11,-5,"-8,6"
7615,720575940610721604,right,Mi9,775,5,22,6,16,"5,22"
7616,720575940622807066,right,Mi9,776,5,21,5,16,"5,21"
7617,720575940615611148,right,Mi9,777,6,20,4,16,"6,20"
7618,720575940631613637,right,Mi9,778,4,25,8,17,"4,25"
7619,720575940618730269,right,Mi9,779,5,24,7,17,"5,24"
7620,720575940618686285,right,Mi9,780,-6,25,18,7,"-6,25"
7621,720575940632559582,right,Mi9,781,-5,26,18,8,"-5,26"
7622,720575940610375748,right,Mi9,782,-5,27,18,9,"-5,27"
7623,720575940634994527,right,Mi9,783,-4,28,18,10,"-4,28"
7624,720575940617171542,right,Mi9,785,-3,30,18,12,"-3,30"
7625,720575940642215643,right,Mi9,786,-2,30,17,13,"-2,30"
7626,720575940623338313,right,Mi9,788,3,27,10,17,"3,27"
7627,720575940611840206,right,Mi9,789,-3,-27,-11,-16,"-3,-27"
7628,720575940612924074,right,Mi9,790,-2,-27,-12,-15,"-2,-27"
7629,720575940615118442,right,Mi9,791,-1,-28,-13,-15,"-1,-28"
7630,720575940620265607,right,Mi9,792,8,2,-7,9,"8,2"
7631,720575940625409831,right,Mi9,793,8,-6,-11,5,"8,-6"
7632,720575940608343730,right,Mi9,794,5,-26,-18,-8,"5,-26"
7633,720575940616052842,right,Mi9,795,6,-21,-17,-4,"6,-21"
7634,720575940626094862,right,Mi9,796,4,26,9,17,"4,26"
7635,720575940610510275,right,R7,1,-6,13,12,1,"-6,13"
7636,720575940640795043,right,R7,3,6,-12,-12,0,"6,-12"
7637,720575940614528749,right,R7,5,-1,16,9,7,"-1,16"
7638,720575940628593320,right,R7,6,-2,-4,0,-4,"-2,-4"
7639,720575940616833211,right,R7,7,-6,-6,3,-9,"-6,-6"
7640,720575940619028737,right,R7,8,-4,26,17,9,"-4,26"
7641,720575940627312729,right,R7,9,4,9,0,9,"4,9"
7642,720575940621441006,right,R7,10,5,-15,-13,-2,"5,-15"
7643,720575940621555309,right,R7,13,-1,-26,-12,-14,"-1,-26"
7644,720575940616030358,right,R7,14,0,-27,-14,-13,"0,-27"
7645,720575940614251747,right,R7,16,-2,-16,-6,-10,"-2,-16"
7646,720575940621668742,right,R7,18,5,-16,-13,-3,"5,-16"
7647,720575940640063805,right,R7,20,3,-11,-9,-2,"3,-11"
7648,720575940605179360,right,R7,21,-2,19,11,8,"-2,19"
7649,720575940624483475,right,R7,22,-1,3,2,1,"-1,3"
7650,720575940624191379,right,R7,25,-9,3,10,-7,"-9,3"
7651,720575940632113682,right,R7,26,1,-3,-3,0,"1,-3"
7652,720575940632558184,right,R7,28,5,6,-2,8,"5,6"
7653,720575940609781769,right,R7,30,6,16,2,14,"6,16"
7654,720575940628388264,right,R7,31,0,16,8,8,"0,16"
7655,720575940606827697,right,R7,32,0,12,6,6,"0,12"
7656,720575940630851383,right,R7,33,3,18,6,12,"3,18"
7657,720575940609289227,right,R7,35,1,-24,-13,-11,"1,-24"
7658,720575940623894057,right,R7,36,6,8,-2,10,"6,8"
7659,720575940623743768,right,R7,37,1,5,1,4,"1,5"
7660,720575940638630889,right,R7,39,0,20,10,10,"0,20"
7661,720575940621545819,right,R7,40,-2,-6,-1,-5,"-2,-6"
7662,720575940624267667,right,R7,41,-3,28,17,11,"-3,28"
7663,720575940625817102,right,R7,42,-1,14,8,6,"-1,14"
7664,720575940625091837,right,R7,47,-9,-1,8,-9,"-9,-1"
7665,720575940618508774,right,R7,49,4,-4,-6,2,"4,-4"
7666,720575940621179329,right,R7,51,0,-19,-10,-9,"0,-19"
7667,720575940628299834,right,R7,53,5,14,2,12,"5,14"
7668,720575940614281955,right,R7,55,-4,-11,-2,-9,"-4,-11"
7669,720575940638525662,right,R7,57,6,-11,-12,1,"6,-11"
7670,720575940630738652,right,R7,58,3,12,3,9,"3,12"
7671,720575940611044164,right,R7,60,-8,8,12,-4,"-8,8"
7672,720575940610005955,right,R7,61,-4,-4,2,-6,"-4,-4"
7673,720575940613514098,right,R7,63,4,12,2,10,"4,12"
7674,720575940622261168,right,R7,64,4,-23,-16,-7,"4,-23"
7675,720575940622662494,right,R7,66,2,15,5,10,"2,15"
7676,720575940613278194,right,R7,68,3,16,5,11,"3,16"
7677,720575940625555943,right,R7,71,-2,-3,0,-3,"-2,-3"
7678,720575940633228940,right,R7,72,0,-28,-14,-14,"0,-28"
7679,720575940641445840,right,R7,73,2,2,-1,3,"2,2"
7680,720575940625075464,right,R7,77,2,-5,-5,0,"2,-5"
7681,720575940618570909,right,R7,78,2,20,8,12,"2,20"
7682,720575940606095532,right,R7,79,2,1,-2,3,"2,1"
7683,720575940626688144,right,R7,80,4,13,2,11,"4,13"
7684,720575940617911611,right,R7,81,6,-2,-7,5,"6,-2"
7685,720575940617457547,right,R7,86,-5,-7,1,-8,"-5,-7"
7686,720575940638026974,right,R7,87,1,11,4,7,"1,11"
7687,720575940628128275,right,R7,88,7,4,-5,9,"7,4"
7688,720575940630826231,right,R7,89,1,-19,-11,-8,"1,-19"
7689,720575940617625883,right,R7,92,0,9,4,5,"0,9"
7690,720575940629083377,right,R7,94,5,18,4,14,"5,18"
7691,720575940629102922,right,R7,95,4,-21,-15,-6,"4,-21"
7692,720575940620708299,right,R7,97,-5,2,6,-4,"-5,2"
7693,720575940622673392,right,R7,98,-1,-12,-5,-7,"-1,-12"
7694,720575940621557743,right,R7,99,4,15,3,12,"4,15"
7695,720575940634090195,right,R7,100,2,-10,-7,-3,"2,-10"
7696,720575940624322244,right,R7,101,-7,6,10,-4,"-7,6"
7697,720575940628426257,right,R7,102,3,13,3,10,"3,13"
7698,720575940626212496,right,R7,105,3,22,8,14,"3,22"
7699,720575940614640815,right,R7,106,-7,11,12,-1,"-7,11"
7700,720575940626854842,right,R7,110,-7,0,7,-7,"-7,0"
7701,720575940609276681,right,R7,111,2,-24,-14,-10,"2,-24"
7702,720575940624756989,right,R7,114,2,-13,-9,-4,"2,-13"
7703,720575940634355682,right,R7,115,-4,2,5,-3,"-4,2"
7704,720575940606534502,right,R7,116,-1,-8,-3,-5,"-1,-8"
7705,720575940606689713,right,R7,118,3,1,-3,4,"3,1"
7706,720575940632419395,right,R7,119,-2,6,5,1,"-2,6"
7707,720575940614762035,right,R7,120,-1,-1,0,-1,"-1,-1"
7708,720575940622829812,right,R7,121,-8,4,10,-6,"-8,4"
7709,720575940621566630,right,R7,122,-5,9,9,0,"-5,9"
7710,720575940633478829,right,R7,124,1,-7,-5,-2,"1,-7"
7711,720575940640675699,right,R7,125,5,9,-1,10,"5,9"
7712,720575940618604884,right,R7,126,3,11,2,9,"3,11"
7713,720575940631197496,right,R7,127,0,15,7,8,"0,15"
7714,720575940632508687,right,R7,128,3,-22,-14,-8,"3,-22"
7715,720575940631904719,right,R7,129,0,-13,-7,-6,"0,-13"
7716,720575940623725773,right,R7,130,2,12,4,8,"2,12"
7717,720575940629542928,right,R7,132,2,4,0,4,"2,4"
7718,720575940614692271,right,R7,135,-3,-22,-8,-14,"-3,-22"
7719,720575940619596598,right,R7,136,0,3,1,2,"0,3"
7720,720575940626666021,right,R7,137,5,-7,-9,2,"5,-7"
7721,720575940606040492,right,R7,138,0,27,13,14,"0,27"
7722,720575940632007186,right,R7,140,3,8,1,7,"3,8"
7723,720575940630202050,right,R7,142,-2,-18,-7,-11,"-2,-18"
7724,720575940626344781,right,R7,146,1,-6,-4,-2,"1,-6"
7725,720575940616137282,right,R7,147,1,21,9,12,"1,21"
7726,720575940638565342,right,R7,148,-7,-11,1,-12,"-7,-11"
7727,720575940612367310,right,R7,149,6,-14,-13,-1,"6,-14"
7728,720575940632880441,right,R7,151,-3,-14,-4,-10,"-3,-14"
7729,720575940611660152,right,R7,152,3,-15,-11,-4,"3,-15"
7730,720575940625137405,right,R7,156,-9,1,9,-8,"-9,1"
7731,720575940618713634,right,R7,158,3,-5,-6,1,"3,-5"
7732,720575940639102015,right,R7,161,4,-14,-11,-3,"4,-14"
7733,720575940614307811,right,R7,163,-9,7,12,-5,"-9,7"
7734,720575940616291551,right,R7,164,-1,-2,0,-2,"-1,-2"
7735,720575940634509794,right,R7,165,4,16,4,12,"4,16"
7736,720575940619203909,right,R7,166,0,18,9,9,"0,18"
7737,720575940630995200,right,R7,168,-1,17,9,8,"-1,17"
7738,720575940621306644,right,R7,169,0,-18,-9,-9,"0,-18"
7739,720575940637081455,right,R7,170,-5,1,5,-4,"-5,1"
7740,720575940646047511,right,R7,171,6,-20,-16,-4,"6,-20"
7741,720575940631436229,right,R7,172,1,22,10,12,"1,22"
7742,720575940608943708,right,R7,177,-2,-1,1,-2,"-2,-1"
7743,720575940629622607,right,R7,178,2,11,3,8,"2,11"
7744,720575940635075740,right,R7,181,1,-4,-3,-1,"1,-4"
7745,720575940622575877,right,R7,185,2,-11,-8,-3,"2,-11"
7746,720575940616533826,right,R7,186,-1,26,14,12,"-1,26"
7747,720575940623883561,right,R7,187,3,21,7,14,"3,21"
7748,720575940621662145,right,R7,188,-5,17,13,4,"-5,17"
7749,720575940645689892,right,R7,189,6,13,0,13,"6,13"
7750,720575940626802238,right,R7,190,-3,-5,0,-5,"-3,-5"
7751,720575940618528347,right,R7,191,-1,-11,-5,-6,"-1,-11"
7752,720575940616946630,right,R7,192,7,10,-2,12,"7,10"
7753,720575940612644058,right,R7,194,0,-5,-3,-2,"0,-5"
7754,720575940618351060,right,R7,195,-3,-1,2,-3,"-3,-1"
7755,720575940621295599,right,R7,196,-1,8,5,3,"-1,8"
7756,720575940622255937,right,R7,198,6,2,-5,7,"6,2"
7757,720575940624592391,right,R7,200,-5,12,11,1,"-5,12"
7758,720575940641982427,right,R7,202,-1,27,14,13,"-1,27"
7759,720575940633306276,right,R7,203,3,-1,-4,3,"3,-1"
7760,720575940644218784,right,R7,204,5,-2,-6,4,"5,-2"
7761,720575940621931958,right,R7,208,5,-21,-16,-5,"5,-21"
7762,720575940622873182,right,R7,209,-3,-8,-1,-7,"-3,-8"
7763,720575940630630782,right,R7,212,2,-16,-10,-6,"2,-16"
7764,720575940616093855,right,R7,215,6,7,-3,10,"6,7"
7765,720575940606447793,right,R7,216,2,19,7,12,"2,19"
7766,720575940630936832,right,R7,218,2,10,3,7,"2,10"
7767,720575940622176628,right,R7,219,6,-4,-8,4,"6,-4"
7768,720575940625602023,right,R7,220,2,-6,-5,-1,"2,-6"
7769,720575940632467498,right,R7,221,-7,3,8,-5,"-7,3"
7770,720575940613045234,right,R7,223,-2,26,15,11,"-2,26"
7771,720575940613636266,right,R7,226,5,19,4,15,"5,19"
7772,720575940609209180,right,R7,229,5,2,-4,6,"5,2"
7773,720575940630486263,right,R7,230,2,9,2,7,"2,9"
7774,720575940644455840,right,R7,231,4,-12,-10,-2,"4,-12"
7775,720575940612948210,right,R7,233,4,-13,-11,-2,"4,-13"
7776,720575940616860859,right,R7,234,1,3,0,3,"1,3"
7777,720575940629837819,right,R7,235,4,11,1,10,"4,11"
7778,720575940620105265,right,R7,238,-8,-3,6,-9,"-8,-3"
7779,720575940622361215,right,R7,239,-6,6,9,-3,"-6,6"
7780,720575940630958454,right,R7,241,2,-17,-11,-6,"2,-17"
7781,720575940618122845,right,R7,244,-4,-12,-2,-10,"-4,-12"
7782,720575940612083150,right,R7,245,-5,-3,3,-6,"-5,-3"
7783,720575940621581421,right,R7,249,2,-12,-8,-4,"2,-12"
7784,720575940624117896,right,R7,251,-1,-14,-6,-8,"-1,-14"
7785,720575940634173153,right,R7,252,3,23,8,15,"3,23"
7786,720575940615115059,right,R7,253,5,16,3,13,"5,16"
7787,720575940636094815,right,R7,258,-4,-17,-5,-12,"-4,-17"
7788,720575940634328290,right,R7,259,-7,-5,4,-9,"-7,-5"
7789,720575940627548930,right,R7,260,-3,19,12,7,"-3,19"
7790,720575940629011196,right,R7,264,-1,-6,-2,-4,"-1,-6"
7791,720575940628784040,right,R7,268,7,-6,-10,4,"7,-6"
7792,720575940625968935,right,R7,269,2,-19,-12,-7,"2,-19"
7793,720575940615385706,right,R7,271,4,6,-1,7,"4,6"
7794,720575940627718296,right,R7,272,3,-2,-4,2,"3,-2"
7795,720575940638106736,right,R7,273,-6,23,17,6,"-6,23"
7796,720575940633160332,right,R7,274,6,4,-4,8,"6,4"
7797,720575940635374231,right,R7,276,2,3,-1,4,"2,3"
7798,720575940635357024,right,R7,277,7,-3,-9,6,"7,-3"
7799,720575940618600738,right,R7,278,-5,10,10,0,"-5,10"
7800,720575940615386530,right,R7,282,0,26,13,13,"0,26"
7801,720575940628143162,right,R7,284,0,25,12,13,"0,25"
7802,720575940628816917,right,R7,285,6,-18,-15,-3,"6,-18"
7803,720575940627009086,right,R7,286,0,-24,-12,-12,"0,-24"
7804,720575940621079431,right,R7,289,-1,11,6,5,"-1,11"
7805,720575940620451800,right,R7,290,5,-24,-17,-7,"5,-24"
7806,720575940639279686,right,R7,291,7,2,-6,8,"7,2"
7807,720575940636063339,right,R7,298,-5,5,7,-2,"-5,5"
7808,720575940633101260,right,R7,299,-4,12,10,2,"-4,12"
7809,720575940622780165,right,R7,301,-5,16,13,3,"-5,16"
7810,720575940617035788,right,R7,302,2,17,6,11,"2,17"
7811,720575940625007112,right,R7,305,-7,4,9,-5,"-7,4"
7812,720575940639439174,right,R7,306,3,7,0,7,"3,7"
7813,720575940606814897,right,R7,310,2,22,9,13,"2,22"
7814,720575940627760280,right,R7,311,-7,15,14,1,"-7,15"
7815,720575940625429652,right,R7,312,4,-7,-8,1,"4,-7"
7816,720575940635080985,right,R7,313,7,3,-6,9,"7,3"
7817,720575940635568026,right,R7,315,-3,-6,0,-6,"-3,-6"
7818,720575940616135530,right,R7,316,5,-4,-7,3,"5,-4"
7819,720575940628331688,right,R7,317,-5,-4,3,-7,"-5,-4"
7820,720575940632619576,right,R7,318,4,-19,-14,-5,"4,-19"
7821,720575940612251746,right,R7,319,-2,5,4,1,"-2,5"
7822,720575940655814049,right,R7,320,-2,-5,-1,-4,"-2,-5"
7823,720575940620979282,right,R7,324,3,24,9,15,"3,24"
7824,720575940621668120,right,R7,325,5,1,-5,6,"5,1"
7825,720575940620940927,right,R7,326,2,16,6,10,"2,16"
7826,720575940626849226,right,R7,327,5,3,-4,7,"5,3"
7827,720575940619837598,right,R7,328,5,-9,-10,1,"5,-9"
7828,720575940619741494,right,R7,329,0,24,12,12,"0,24"
7829,720575940628898792,right,R7,331,1,-15,-9,-6,"1,-15"
7830,720575940616616390,right,R7,333,0,-21,-11,-10,"0,-21"
7831,720575940624248870,right,R7,334,1,-26,-14,-12,"1,-26"
7832,720575940614500392,right,R7,335,2,8,2,6,"2,8"
7833,720575940617762875,right,R7,336,0,23,11,12,"0,23"
7834,720575940627072514,right,R7,337,-5,-6,2,-8,"-5,-6"
7835,720575940625261547,right,R7,338,-1,0,1,-1,"-1,0"
7836,720575940627307097,right,R7,339,6,11,-1,12,"6,11"
7837,720575940618653697,right,R7,345,3,-12,-9,-3,"3,-12"
7838,720575940625274603,right,R7,347,-5,-13,-2,-11,"-5,-13"
7839,720575940633762003,right,R7,348,3,14,4,10,"3,14"
7840,720575940634377698,right,R7,349,-5,-14,-2,-12,"-5,-14"
7841,720575940620921734,right,R7,350,1,15,6,9,"1,15"
7842,720575940614902568,right,R7,355,-7,-6,4,-10,"-7,-6"
7843,720575940628184914,right,R7,359,2,23,9,14,"2,23"
7844,720575940621826470,right,R7,360,-5,19,14,5,"-5,19"
7845,720575940609720515,right,R7,362,2,-20,-12,-8,"2,-20"
7846,720575940621459905,right,R7,363,7,-4,-9,5,"7,-4"
7847,720575940626717114,right,R7,364,4,4,-2,6,"4,4"
7848,720575940628823281,right,R7,365,4,7,-1,8,"4,7"
7849,720575940627805833,right,R7,367,-6,-15,-2,-13,"-6,-15"
7850,720575940646164334,right,R7,369,5,-5,-8,3,"5,-5"
7851,720575940619901598,right,R7,370,-3,21,13,8,"-3,21"
7852,720575940626644068,right,R7,372,1,-2,-2,0,"1,-2"
7853,720575940622366704,right,R7,374,2,13,4,9,"2,13"
7854,720575940613782294,right,R7,375,-6,7,9,-2,"-6,7"
7855,720575940631732687,right,R7,377,0,7,3,4,"0,7"
7856,720575940636971895,right,R7,385,-3,-18,-6,-12,"-3,-18"
7857,720575940624761597,right,R7,386,-6,19,15,4,"-6,19"
7858,720575940638942015,right,R7,387,-1,-15,-7,-8,"-1,-15"
7859,720575940632773703,right,R7,388,3,19,6,13,"3,19"
7860,720575940632426088,right,R7,390,-6,-9,1,-10,"-6,-9"
7861,720575940606421257,right,R7,391,4,-3,-6,3,"4,-3"
7862,720575940623880328,right,R7,392,-4,7,7,0,"-4,7"
7863,720575940623949923,right,R7,393,-1,22,12,10,"-1,22"
7864,720575940618551041,right,R7,394,-7,-8,3,-11,"-7,-8"
7865,720575940613020658,right,R7,395,0,-22,-11,-11,"0,-22"
7866,720575940622943207,right,R7,396,-1,10,6,4,"-1,10"
7867,720575940623039446,right,R7,397,-3,-19,-7,-12,"-3,-19"
7868,720575940627799677,right,R7,401,-2,-19,-8,-11,"-2,-19"
7869,720575940617281622,right,R7,402,3,26,10,16,"3,26"
7870,720575940621072065,right,R7,403,-2,-12,-4,-8,"-2,-12"
7871,720575940628439812,right,R7,405,3,10,2,8,"3,10"
7872,720575940627284324,right,R7,406,1,-25,-14,-11,"1,-25"
7873,720575940629159153,right,R7,407,-5,-10,0,-10,"-5,-10"
7874,720575940653274870,right,R7,408,-6,-4,4,-8,"-6,-4"
7875,720575940619909359,right,R7,409,0,-3,-2,-1,"0,-3"
7876,720575940632869423,right,R7,410,-2,-2,1,-3,"-2,-2"
7877,720575940628730344,right,R7,411,-5,-19,-5,-14,"-5,-19"
7878,720575940627281922,right,R7,413,-2,-7,-2,-5,"-2,-7"
7879,720575940632021867,right,R7,414,4,21,6,15,"4,21"
7880,720575940625272980,right,R7,415,6,12,0,12,"6,12"
7881,720575940625954744,right,R7,416,3,-8,-7,-1,"3,-8"
7882,720575940628193161,right,R7,417,-6,-10,1,-11,"-6,-10"
7883,720575940621610678,right,R7,419,-3,-11,-3,-8,"-3,-11"
7884,720575940632266794,right,R7,420,6,-3,-8,5,"6,-3"
7885,720575940627148234,right,R7,422,-7,-4,5,-9,"-7,-4"
7886,720575940647411491,right,R7,423,3,-18,-12,-6,"3,-18"
7887,720575940632396875,right,R7,424,-3,-2,2,-4,"-3,-2"
7888,720575940632108586,right,R7,425,3,20,7,13,"3,20"
7889,720575940618089428,right,R7,427,5,-18,-14,-4,"5,-18"
7890,720575940628253690,right,R7,429,-2,14,9,5,"-2,14"
7891,720575940625534612,right,R7,430,-3,-7,-1,-6,"-3,-7"
7892,720575940620840327,right,R7,431,-2,-10,-3,-7,"-2,-10"
7893,720575940625290900,right,R7,432,-5,7,8,-1,"-5,7"
7894,720575940621436911,right,R7,435,5,-17,-14,-3,"5,-17"
7895,720575940622239664,right,R7,436,0,-15,-8,-7,"0,-15"
7896,720575940611892946,right,R7,438,2,27,11,16,"2,27"
7897,720575940625983219,right,R7,440,1,23,10,13,"1,23"
7898,720575940632832583,right,R7,442,-5,25,17,8,"-5,25"
7899,720575940631936197,right,R7,446,2,-14,-9,-5,"2,-14"
7900,720575940625158206,right,R7,447,-1,2,2,0,"-1,2"
7901,720575940637259895,right,R7,449,6,-16,-14,-2,"6,-16"
7902,720575940631242700,right,R7,450,2,-9,-7,-2,"2,-9"
7903,720575940628767899,right,R7,451,4,20,6,14,"4,20"
7904,720575940636414712,right,R7,452,1,-9,-6,-3,"1,-9"
7905,720575940623930665,right,R7,453,3,25,9,16,"3,25"
7906,720575940626826682,right,R7,454,5,-12,-11,-1,"5,-12"
7907,720575940616882738,right,R7,455,7,-7,-11,4,"7,-7"
7908,720575940628293892,right,R7,456,0,21,10,11,"0,21"
7909,720575940625709582,right,R7,458,5,0,-5,5,"5,0"
7910,720575940622614260,right,R7,459,5,-3,-7,4,"5,-3"
7911,720575940628008264,right,R7,460,-3,-20,-7,-13,"-3,-20"
7912,720575940616430146,right,R7,461,7,-5,-10,5,"7,-5"
7913,720575940622500592,right,R7,462,-1,18,10,8,"-1,18"
7914,720575940625906190,right,R7,463,5,17,3,14,"5,17"
7915,720575940631207276,right,R7,465,3,0,-3,3,"3,0"
7916,720575940625872973,right,R7,466,1,14,6,8,"1,14"
7917,720575940613244389,right,R7,467,-2,-20,-8,-12,"-2,-20"
7918,720575940612419790,right,R7,471,3,-26,-16,-10,"3,-26"
7919,720575940614063853,right,R7,472,1,25,11,14,"1,25"
7920,720575940635631767,right,R7,473,-4,23,15,8,"-4,23"
7921,720575940631286487,right,R7,476,-1,15,8,7,"-1,15"
7922,720575940613467158,right,R7,481,4,-8,-8,0,"4,-8"
7923,720575940636905071,right,R7,482,1,17,7,10,"1,17"
7924,720575940627497609,right,R7,483,2,-7,-6,-1,"2,-7"
7925,720575940632951633,right,R7,484,3,-9,-8,-1,"3,-9"
7926,720575940637806766,right,R7,485,-3,-3,1,-4,"-3,-3"
7927,720575940619880758,right,R7,488,7,5,-5,10,"7,5"
7928,720575940628073298,right,R7,491,7,-1,-8,7,"7,-1"
7929,720575940613514649,right,R7,492,-7,-2,6,-8,"-7,-2"
7930,720575940609758985,right,R7,493,-3,23,14,9,"-3,23"
7931,720575940615613855,right,R7,496,7,8,-3,11,"7,8"
7932,720575940616946886,right,R7,497,6,1,-6,7,"6,1"
7933,720575940634801844,right,R7,498,6,10,-1,11,"6,10"
7934,720575940634306274,right,R7,499,5,10,0,10,"5,10"
7935,720575940628712964,right,R7,500,7,-8,-11,3,"7,-8"
7936,720575940629012732,right,R7,501,1,2,0,2,"1,2"
7937,720575940660931713,right,R7,502,5,8,-1,9,"5,8"
7938,720575940634132634,right,R7,503,3,17,5,12,"3,17"
7939,720575940621067712,right,R7,504,-2,9,6,3,"-2,9"
7940,720575940643100813,right,R7,507,-5,-12,-1,-11,"-5,-12"
7941,720575940625750164,right,R7,508,-5,11,10,1,"-5,11"
7942,720575940606450110,right,R7,511,5,-11,-11,0,"5,-11"
7943,720575940628063613,right,R7,512,6,0,-6,6,"6,0"
7944,720575940644542755,right,R7,514,-4,-10,-1,-9,"-4,-10"
7945,720575940627945810,right,R7,519,-5,-5,2,-7,"-5,-5"
7946,720575940626634698,right,R7,521,6,-9,-11,2,"6,-9"
7947,720575940628986954,right,R7,523,2,14,5,9,"2,14"
7948,720575940632484419,right,R7,525,-1,-20,-9,-11,"-1,-20"
7949,720575940630898944,right,R7,526,0,-10,-5,-5,"0,-10"
7950,720575940630526967,right,R7,527,-4,-8,0,-8,"-4,-8"
7951,720575940625114877,right,R7,528,2,7,1,6,"2,7"
7952,720575940618186555,right,R7,529,2,-2,-3,1,"2,-2"
7953,720575940621956161,right,R7,531,1,0,-1,1,"1,0"
7954,720575940625675412,right,R7,532,-8,7,11,-4,"-8,7"
7955,720575940622990597,right,R7,533,0,-16,-8,-8,"0,-16"
7956,720575940631638981,right,R7,534,3,2,-2,4,"3,2"
7957,720575940629372521,right,R7,536,3,4,-1,5,"3,4"
7958,720575940618392610,right,R7,537,0,-23,-12,-11,"0,-23"
7959,720575940614506536,right,R7,538,-4,1,4,-3,"-4,1"
7960,720575940645816343,right,R7,539,-6,15,13,2,"-6,15"
7961,720575940626342733,right,R7,540,-2,-9,-3,-6,"-2,-9"
7962,720575940619045957,right,R7,542,6,-13,-13,0,"6,-13"
7963,720575940626800944,right,R7,543,-1,-4,-1,-3,"-1,-4"
7964,720575940620259377,right,R7,546,3,6,0,6,"3,6"
7965,720575940640156494,right,R7,547,-1,21,11,10,"-1,21"
7966,720575940617289403,right,R7,548,1,-16,-9,-7,"1,-16"
7967,720575940634206690,right,R7,549,0,-9,-5,-4,"0,-9"
7968,720575940627970898,right,R7,551,-4,-9,-1,-8,"-4,-9"
7969,720575940621508262,right,R7,552,4,-1,-5,4,"4,-1"
7970,720575940631278444,right,R7,556,0,10,5,5,"0,10"
7971,720575940622320048,right,R7,561,5,7,-2,9,"5,7"
7972,720575940614299107,right,R7,562,-5,-2,4,-6,"-5,-2"
7973,720575940624488595,right,R7,563,5,-13,-12,-1,"5,-13"
7974,720575940627455234,right,R7,567,-2,22,13,9,"-2,22"
7975,720575940632103466,right,R7,568,-6,-8,2,-10,"-6,-8"
7976,720575940612238946,right,R7,570,2,25,10,15,"2,25"
7977,720575940647406115,right,R7,571,0,-14,-7,-7,"0,-14"
7978,720575940639314291,right,R7,573,4,14,3,11,"4,14"
7979,720575940631317292,right,R7,575,6,9,-2,11,"6,9"
7980,720575940625930995,right,R7,576,0,28,14,14,"0,28"
7981,720575940625308391,right,R7,579,-3,-10,-2,-8,"-3,-10"
7982,720575940631870671,right,R7,580,-2,-23,-10,-13,"-2,-23"
7983,720575940621461441,right,R7,581,3,9,1,8,"3,9"
7984,720575940627155331,right,R7,583,3,-25,-16,-9,"3,-25"
7985,720575940617262197,right,R7,585,-1,-23,-11,-12,"-1,-23"
7986,720575940622828276,right,R7,586,2,18,7,11,"2,18"
7987,720575940633839021,right,R7,587,4,22,7,15,"4,22"
7988,720575940622972705,right,R7,589,-1,-5,-2,-3,"-1,-5"
7989,720575940626594853,right,R7,590,1,9,3,6,"1,9"
7990,720575940621117121,right,R7,591,3,-3,-5,2,"3,-3"
7991,720575940615790230,right,R7,595,7,-12,-13,1,"7,-12"
7992,720575940636660855,right,R7,596,-4,-16,-4,-12,"-4,-16"
7993,720575940626774064,right,R7,597,4,1,-4,5,"4,1"
7994,720575940640581235,right,R7,598,2,-18,-11,-7,"2,-18"
7995,720575940618657281,right,R7,600,3,-10,-8,-2,"3,-10"
7996,720575940624180628,right,R7,601,1,16,7,9,"1,16"
7997,720575940619326262,right,R7,602,4,-2,-5,3,"4,-2"
7998,720575940633464109,right,R7,603,-3,-23,-9,-14,"-3,-23"
7999,720575940618566557,right,R7,604,-6,-17,-3,-14,"-6,-17"
8000,720575940619344453,right,R7,605,3,15,4,11,"3,15"
8001,720575940621783137,right,R7,606,-1,-19,-9,-10,"-1,-19"
8002,720575940620935188,right,R7,607,1,18,8,10,"1,18"
8003,720575940625880846,right,R7,609,-2,0,2,-2,"-2,0"
8004,720575940629783811,right,R7,610,2,-23,-14,-9,"2,-23"
8005,720575940643065997,right,R7,611,-1,-18,-8,-10,"-1,-18"
8006,720575940622306486,right,R7,615,-7,-7,3,-10,"-7,-7"
8007,720575940613128345,right,R7,616,-3,15,10,5,"-3,15"
8008,720575940635079324,right,R7,617,-2,-17,-7,-10,"-2,-17"
8009,720575940612468942,right,R7,620,7,1,-7,8,"7,1"
8010,720575940650787193,right,R7,621,1,24,11,13,"1,24"
8011,720575940624086825,right,R7,622,-5,20,15,5,"-5,20"
8012,720575940613666326,right,R7,623,1,13,5,8,"1,13"
8013,720575940624623879,right,R7,625,-2,24,14,10,"-2,24"
8014,720575940628218511,right,R7,626,-5,-8,1,-9,"-5,-8"
8015,720575940629787651,right,R7,628,0,0,0,0,"0,0"
8016,720575940635654039,right,R7,629,4,24,8,16,"4,24"
8017,720575940612839859,right,R7,630,4,8,0,8,"4,8"
8018,720575940653311478,right,R7,631,1,26,12,14,"1,26"
8019,720575940623737549,right,R7,633,-1,-24,-11,-13,"-1,-24"
8020,720575940625449620,right,R7,634,-3,-15,-5,-10,"-3,-15"
8021,720575940644754592,right,R7,635,6,-6,-9,3,"6,-6"
8022,720575940616369474,right,R7,637,3,-21,-14,-7,"3,-21"
8023,720575940633341604,right,R7,640,-1,-16,-7,-9,"-1,-16"
8024,720575940634459361,right,R7,642,-5,-11,-1,-10,"-5,-11"
8025,720575940624989960,right,R7,643,6,14,1,13,"6,14"
8026,720575940621661377,right,R7,647,-4,-7,0,-7,"-4,-7"
8027,720575940624151432,right,R7,649,-1,5,3,2,"-1,5"
8028,720575940622616670,right,R7,650,-3,-25,-10,-15,"-3,-25"
8029,720575940627974808,right,R7,652,-6,-11,0,-11,"-6,-11"
8030,720575940638404580,right,R7,655,6,-1,-7,6,"6,-1"
8031,720575940647181091,right,R7,656,0,-11,-6,-5,"0,-11"
8032,720575940624544806,right,R7,657,-2,-25,-11,-14,"-2,-25"
8033,720575940620961729,right,R7,658,1,20,9,11,"1,20"
8034,720575940628243002,right,R7,659,-4,-6,1,-7,"-4,-6"
8035,720575940647182627,right,R7,662,2,-1,-3,2,"2,-1"
8036,720575940620878539,right,R7,663,0,8,4,4,"0,8"
8037,720575940639258431,right,R7,664,1,-27,-15,-12,"1,-27"
8038,720575940626364976,right,R7,665,7,-2,-8,6,"7,-2"
8039,720575940621087570,right,R7,668,1,19,8,11,"1,19"
8040,720575940626914110,right,R7,669,4,-16,-12,-4,"4,-16"
8041,720575940613201075,right,R7,672,-8,11,13,-2,"-8,11"
8042,720575940629067004,right,R7,674,-4,-14,-3,-11,"-4,-14"
8043,720575940618628436,right,R7,676,-3,-21,-8,-13,"-3,-21"
8044,720575940626279205,right,R7,678,3,-7,-7,0,"3,-7"
8045,720575940622193432,right,R7,679,4,18,5,13,"4,18"
8046,720575940606495422,right,R7,681,-2,-21,-9,-12,"-2,-21"
8047,720575940627280130,right,R7,682,6,-8,-10,2,"6,-8"
8048,720575940623914851,right,R7,684,-6,17,14,3,"-6,17"
8049,720575940630314110,right,R7,685,-5,-9,0,-9,"-5,-9"
8050,720575940635996826,right,R7,686,5,-22,-16,-6,"5,-22"
8051,720575940615318178,right,R7,687,-6,-3,4,-7,"-6,-3"
8052,720575940629970279,right,R7,689,-2,18,11,7,"-2,18"
8053,720575940633849901,right,R7,692,-4,24,16,8,"-4,24"
8054,720575940624028003,right,R7,693,-3,25,15,10,"-3,25"
8055,720575940624106948,right,R7,694,4,3,-3,6,"4,3"
8056,720575940628447119,right,R7,695,-6,10,11,-1,"-6,10"
8057,720575940644770504,right,R7,697,1,-22,-12,-10,"1,-22"
8058,720575940624195987,right,R7,698,6,-7,-10,3,"6,-7"
8059,720575940627824912,right,R7,700,5,15,2,13,"5,15"
8060,720575940635494810,right,R7,701,0,-4,-2,-2,"0,-4"
8061,720575940619807542,right,R7,702,-5,23,16,7,"-5,23"
8062,720575940636454392,right,R7,704,-7,8,11,-3,"-7,8"
8063,720575940609505545,right,R7,705,1,1,-1,2,"1,1"
8064,720575940617065403,right,R7,707,-2,25,14,11,"-2,25"
8065,720575940631913047,right,R7,710,4,-25,-17,-8,"4,-25"
8066,720575940627937157,right,R7,711,-1,19,10,9,"-1,19"
8067,720575940626462864,right,R7,714,5,12,1,11,"5,12"
8068,720575940627108636,right,R7,715,4,10,1,9,"4,10"
8069,720575940641063632,right,R7,716,4,-6,-7,1,"4,-6"
8070,720575940611818594,right,R7,719,1,27,12,15,"1,27"
8071,720575940624349674,right,R7,721,5,13,1,12,"5,13"
8072,720575940655749793,right,R7,722,6,-15,-14,-1,"6,-15"
8073,720575940621474330,right,R7,724,4,2,-3,5,"4,2"
8074,720575940630464503,right,R7,725,-3,-24,-9,-15,"-3,-24"
8075,720575940645059784,right,R7,727,7,6,-4,10,"7,6"
8076,720575940619144000,right,R7,728,7,12,-1,13,"7,12"
8077,720575940631374843,right,R7,730,7,0,-7,7,"7,0"
8078,720575940627925842,right,R7,731,-6,9,10,-1,"-6,9"
8079,720575940635609751,right,R7,734,2,0,-2,2,"2,0"
8080,720575940628194577,right,R7,735,1,-23,-13,-10,"1,-23"
8081,720575940636832375,right,R7,736,-8,1,8,-7,"-8,1"
8082,720575940645656612,right,R7,737,0,19,9,10,"0,19"
8083,720575940631228665,right,R7,739,-7,2,8,-6,"-7,2"
8084,720575940622464383,right,R7,741,-2,-14,-5,-9,"-2,-14"
8085,720575940625812408,right,R7,742,-4,11,9,2,"-4,11"
8086,720575940632936248,right,R7,744,-4,25,16,9,"-4,25"
8087,720575940616016287,right,R7,745,0,13,6,7,"0,13"
8088,720575940623123881,right,R7,747,0,2,1,1,"0,2"
8089,720575940637659534,right,R7,748,-4,20,14,6,"-4,20"
8090,720575940618650625,right,R7,749,-2,1,2,-1,"-2,1"
8091,720575940633223308,right,R7,751,1,6,2,4,"1,6"
8092,720575940613668210,right,R7,752,-2,7,5,2,"-2,7"
8093,720575940644535200,right,R7,753,-3,24,15,9,"-3,24"
8094,720575940606367166,right,R7,754,-1,-13,-6,-7,"-1,-13"
8095,720575940647041315,right,R7,755,4,19,5,14,"4,19"
8096,720575940621555565,right,R7,756,5,20,5,15,"5,20"
8097,720575940624033535,right,R7,758,5,-1,-6,5,"5,-1"
8098,720575940624609461,right,R7,760,0,17,8,9,"0,17"
8099,720575940628416017,right,R7,761,-4,-18,-5,-13,"-4,-18"
8100,720575940618594333,right,R7,762,0,14,7,7,"0,14"
8101,720575940623073809,right,R7,763,-5,14,12,2,"-5,14"
8102,720575940612598165,right,R7,766,2,-4,-4,0,"2,-4"
8103,720575940615436178,right,R7,768,3,5,-1,6,"3,5"
8104,720575940624971337,right,R7,770,5,4,-3,7,"5,4"
8105,720575940631606981,right,R7,773,5,-19,-15,-4,"5,-19"
8106,720575940628640252,right,R7,775,5,22,6,16,"5,22"
8107,720575940612990869,right,R8,1,-6,13,12,1,"-6,13"
8108,720575940618237533,right,R8,2,-8,2,9,-7,"-8,2"
8109,720575940642841636,right,R8,5,-1,16,9,7,"-1,16"
8110,720575940626681744,right,R8,6,-2,-4,0,-4,"-2,-4"
8111,720575940633631661,right,R8,7,-6,-6,3,-9,"-6,-6"
8112,720575940624504516,right,R8,8,-4,26,17,9,"-4,26"
8113,720575940629043708,right,R8,9,4,9,0,9,"4,9"
8114,720575940637804144,right,R8,10,5,-15,-13,-2,"5,-15"
8115,720575940629127153,right,R8,12,-7,9,11,-2,"-7,9"
8116,720575940636287851,right,R8,13,-1,-26,-12,-14,"-1,-26"
8117,720575940626400304,right,R8,15,2,-3,-4,1,"2,-3"
8118,720575940645192228,right,R8,16,-2,-16,-6,-10,"-2,-16"
8119,720575940624028515,right,R8,17,1,-5,-4,-1,"1,-5"
8120,720575940627225274,right,R8,18,5,-16,-13,-3,"5,-16"
8121,720575940635530848,right,R8,20,3,-11,-9,-2,"3,-11"
8122,720575940627104284,right,R8,21,-2,19,11,8,"-2,19"
8123,720575940637513390,right,R8,22,-1,3,2,1,"-1,3"
8124,720575940620592587,right,R8,23,-3,-16,-5,-11,"-3,-16"
8125,720575940630984247,right,R8,24,-1,-10,-4,-6,"-1,-10"
8126,720575940611473272,right,R8,25,-9,3,10,-7,"-9,3"
8127,720575940613271781,right,R8,26,1,-3,-3,0,"1,-3"
8128,720575940644949960,right,R8,27,0,-25,-13,-12,"0,-25"
8129,720575940629126662,right,R8,28,5,6,-2,8,"5,6"
8130,720575940616283714,right,R8,29,-1,-3,-1,-2,"-1,-3"
8131,720575940628946152,right,R8,30,6,16,2,14,"6,16"
8132,720575940642217717,right,R8,31,0,16,8,8,"0,16"
8133,720575940609479179,right,R8,32,0,12,6,6,"0,12"
8134,720575940630851639,right,R8,33,3,18,6,12,"3,18"
8135,720575940635244700,right,R8,35,1,-24,-13,-11,"1,-24"
8136,720575940617300054,right,R8,36,6,8,-2,10,"6,8"
8137,720575940659591297,right,R8,37,1,5,1,4,"1,5"
8138,720575940625383572,right,R8,38,0,-2,-1,-1,"0,-2"
8139,720575940611742818,right,R8,39,0,20,10,10,"0,20"
8140,720575940632737327,right,R8,40,-2,-6,-1,-5,"-2,-6"
8141,720575940628230223,right,R8,41,-3,28,17,11,"-3,28"
8142,720575940636066155,right,R8,42,-1,14,8,6,"-1,14"
8143,720575940623506909,right,R8,44,5,-10,-10,0,"5,-10"
8144,720575940633588900,right,R8,45,-5,-1,4,-5,"-5,-1"
8145,720575940628302858,right,R8,47,-9,-1,8,-9,"-9,-1"
8146,720575940645617175,right,R8,49,4,-4,-6,2,"4,-4"
8147,720575940633497631,right,R8,50,-2,21,12,9,"-2,21"
8148,720575940628473928,right,R8,51,0,-19,-10,-9,"0,-19"
8149,720575940620630987,right,R8,52,-1,-22,-10,-12,"-1,-22"
8150,720575940606401507,right,R8,53,5,14,2,12,"5,14"
8151,720575940622258870,right,R8,55,-4,-11,-2,-9,"-4,-11"
8152,720575940621958310,right,R8,57,6,-11,-12,1,"6,-11"
8153,720575940631710671,right,R8,58,3,12,3,9,"3,12"
8154,720575940639837373,right,R8,59,-2,2,3,-1,"-2,2"
8155,720575940633161799,right,R8,60,-8,8,12,-4,"-8,8"
8156,720575940628333992,right,R8,61,-4,-4,2,-6,"-4,-4"
8157,720575940624152344,right,R8,63,4,12,2,10,"4,12"
8158,720575940630609346,right,R8,65,-1,28,15,13,"-1,28"
8159,720575940613491941,right,R8,66,2,15,5,10,"2,15"
8160,720575940640214325,right,R8,68,3,16,5,11,"3,16"
8161,720575940633122607,right,R8,69,1,8,3,5,"1,8"
8162,720575940622900257,right,R8,71,-2,-3,0,-3,"-2,-3"
8163,720575940619779126,right,R8,72,0,-28,-14,-14,"0,-28"
8164,720575940619775355,right,R8,73,2,2,-1,3,"2,2"
8165,720575940642976141,right,R8,74,-1,-9,-4,-5,"-1,-9"
8166,720575940625333228,right,R8,76,-3,-4,1,-5,"-3,-4"
8167,720575940640214643,right,R8,77,2,-5,-5,0,"2,-5"
8168,720575940629835419,right,R8,78,2,20,8,12,"2,20"
8169,720575940621543083,right,R8,79,2,1,-2,3,"2,1"
8170,720575940624699901,right,R8,80,4,13,2,11,"4,13"
8171,720575940620777095,right,R8,81,6,-2,-7,5,"6,-2"
8172,720575940621891238,right,R8,82,-7,7,10,-3,"-7,7"
8173,720575940630803578,right,R8,83,2,-21,-13,-8,"2,-21"
8174,720575940625494164,right,R8,84,-2,12,8,4,"-2,12"
8175,720575940618769665,right,R8,85,4,-22,-15,-7,"4,-22"
8176,720575940606182246,right,R8,86,-5,-7,1,-8,"-5,-7"
8177,720575940636028664,right,R8,87,1,11,4,7,"1,11"
8178,720575940638072432,right,R8,89,1,-19,-11,-8,"1,-19"
8179,720575940620940629,right,R8,90,-4,5,6,-1,"-4,5"
8180,720575940611758034,right,R8,91,-1,6,4,2,"-1,6"
8181,720575940616486598,right,R8,92,0,9,4,5,"0,9"
8182,720575940621324564,right,R8,93,-6,3,7,-4,"-6,3"
8183,720575940610840782,right,R8,94,5,18,4,14,"5,18"
8184,720575940640279093,right,R8,95,4,-21,-15,-6,"4,-21"
8185,720575940616331487,right,R8,97,-5,2,6,-4,"-5,2"
8186,720575940615592354,right,R8,98,-1,-12,-5,-7,"-1,-12"
8187,720575940617918393,right,R8,99,4,15,3,12,"4,15"
8188,720575940614850479,right,R8,100,2,-10,-7,-3,"2,-10"
8189,720575940639989181,right,R8,101,-7,6,10,-4,"-7,6"
8190,720575940631208443,right,R8,102,3,13,3,10,"3,13"
8191,720575940628148111,right,R8,105,3,22,8,14,"3,22"
8192,720575940648147844,right,R8,106,-7,11,12,-1,"-7,11"
8193,720575940631880399,right,R8,108,-3,-12,-3,-9,"-3,-12"
8194,720575940650571385,right,R8,109,4,-5,-7,2,"4,-5"
8195,720575940640285272,right,R8,110,-7,0,7,-7,"-7,0"
8196,720575940630415810,right,R8,111,2,-24,-14,-10,"2,-24"
8197,720575940609330012,right,R8,114,2,-13,-9,-4,"2,-13"
8198,720575940628813316,right,R8,115,-4,2,5,-3,"-4,2"
8199,720575940616158943,right,R8,116,-1,-8,-3,-5,"-1,-8"
8200,720575940627144323,right,R8,117,-8,-2,7,-9,"-8,-2"
8201,720575940629915139,right,R8,118,3,1,-3,4,"3,1"
8202,720575940612968666,right,R8,119,-2,6,5,1,"-2,6"
8203,720575940622294221,right,R8,120,-1,-1,0,-1,"-1,-1"
8204,720575940625986087,right,R8,121,-8,4,10,-6,"-8,4"
8205,720575940648618628,right,R8,122,-5,9,9,0,"-5,9"
8206,720575940612920433,right,R8,124,1,-7,-5,-2,"1,-7"
8207,720575940613374691,right,R8,125,5,9,-1,10,"5,9"
8208,720575940629544195,right,R8,126,3,11,2,9,"3,11"
8209,720575940627265892,right,R8,127,0,15,7,8,"0,15"
8210,720575940621678957,right,R8,129,0,-13,-7,-6,"0,-13"
8211,720575940637156197,right,R8,130,2,12,4,8,"2,12"
8212,720575940623576029,right,R8,132,2,4,0,4,"2,4"
8213,720575940615644818,right,R8,134,-5,-18,-4,-14,"-5,-18"
8214,720575940630804791,right,R8,135,-3,-22,-8,-14,"-3,-22"
8215,720575940615021352,right,R8,136,0,3,1,2,"0,3"
8216,720575940628288143,right,R8,137,5,-7,-9,2,"5,-7"
8217,720575940627519613,right,R8,138,0,27,13,14,"0,27"
8218,720575940616363935,right,R8,140,3,8,1,7,"3,8"
8219,720575940609190921,right,R8,142,-2,-18,-7,-11,"-2,-18"
8220,720575940612830577,right,R8,145,0,4,2,2,"0,4"
8221,720575940636539896,right,R8,146,1,-6,-4,-2,"1,-6"
8222,720575940637277070,right,R8,147,1,21,9,12,"1,21"
8223,720575940633523916,right,R8,148,-7,-11,1,-12,"-7,-11"
8224,720575940609928459,right,R8,149,6,-14,-13,-1,"6,-14"
8225,720575940625634830,right,R8,150,-8,5,10,-5,"-8,5"
8226,720575940614352867,right,R8,151,-3,-14,-4,-10,"-3,-14"
8227,720575940618228441,right,R8,152,3,-15,-11,-4,"3,-15"
8228,720575940639003455,right,R8,156,-9,1,9,-8,"-9,1"
8229,720575940613292202,right,R8,157,-1,-7,-3,-4,"-1,-7"
8230,720575940611588050,right,R8,158,3,-5,-6,1,"3,-5"
8231,720575940624639978,right,R8,162,-4,-2,3,-5,"-4,-2"
8232,720575940634855449,right,R8,165,4,16,4,12,"4,16"
8233,720575940626859152,right,R8,166,0,18,9,9,"0,18"
8234,720575940636160504,right,R8,168,-1,17,9,8,"-1,17"
8235,720575940637804206,right,R8,169,0,-18,-9,-9,"0,-18"
8236,720575940621748929,right,R8,170,-5,1,5,-4,"-5,1"
8237,720575940636781167,right,R8,171,6,-20,-16,-4,"6,-20"
8238,720575940616077983,right,R8,172,1,22,10,12,"1,22"
8239,720575940620585265,right,R8,174,4,-15,-12,-3,"4,-15"
8240,720575940628632337,right,R8,175,-6,-7,2,-9,"-6,-7"
8241,720575940623049804,right,R8,176,-2,13,8,5,"-2,13"
8242,720575940606524337,right,R8,177,-2,-1,1,-2,"-2,-1"
8243,720575940626630288,right,R8,178,2,11,3,8,"2,11"
8244,720575940653496822,right,R8,181,1,-4,-3,-1,"1,-4"
8245,720575940626375501,right,R8,182,7,-10,-12,2,"7,-10"
8246,720575940627563550,right,R8,183,-5,-15,-3,-12,"-5,-15"
8247,720575940631952715,right,R8,184,-6,-5,3,-8,"-6,-5"
8248,720575940633507359,right,R8,185,2,-11,-8,-3,"2,-11"
8249,720575940632515897,right,R8,186,-1,26,14,12,"-1,26"
8250,720575940630223771,right,R8,187,3,21,7,14,"3,21"
8251,720575940645369111,right,R8,188,-5,17,13,4,"-5,17"
8252,720575940626044348,right,R8,189,6,13,0,13,"6,13"
8253,720575940620972308,right,R8,190,-3,-5,0,-5,"-3,-5"
8254,720575940616547270,right,R8,191,-1,-11,-5,-6,"-1,-11"
8255,720575940628826116,right,R8,192,7,10,-2,12,"7,10"
8256,720575940624063526,right,R8,193,-5,4,7,-3,"-5,4"
8257,720575940628873192,right,R8,194,0,-5,-3,-2,"0,-5"
8258,720575940626956837,right,R8,195,-3,-1,2,-3,"-3,-1"
8259,720575940619575163,right,R8,196,-1,8,5,3,"-1,8"
8260,720575940647644724,right,R8,197,0,-20,-10,-10,"0,-20"
8261,720575940615146547,right,R8,198,6,2,-5,7,"6,2"
8262,720575940628140421,right,R8,199,0,-12,-6,-6,"0,-12"
8263,720575940640363683,right,R8,200,-5,12,11,1,"-5,12"
8264,720575940633457197,right,R8,202,-1,27,14,13,"-1,27"
8265,720575940632445852,right,R8,203,3,-1,-4,3,"3,-1"
8266,720575940630474434,right,R8,204,5,-2,-6,4,"5,-2"
8267,720575940629079302,right,R8,205,5,-6,-8,2,"5,-6"
8268,720575940629425994,right,R8,206,-3,5,5,0,"-3,5"
8269,720575940612702577,right,R8,208,5,-21,-16,-5,"5,-21"
8270,720575940622572159,right,R8,209,-3,-8,-1,-7,"-3,-8"
8271,720575940621727983,right,R8,210,-6,8,10,-2,"-6,8"
8272,720575940626030925,right,R8,211,-7,-1,6,-7,"-7,-1"
8273,720575940614717736,right,R8,212,2,-16,-10,-6,"2,-16"
8274,720575940617533323,right,R8,213,3,-4,-5,1,"3,-4"
8275,720575940617734203,right,R8,215,6,7,-3,10,"6,7"
8276,720575940618679069,right,R8,216,2,19,7,12,"2,19"
8277,720575940627290457,right,R8,218,2,10,3,7,"2,10"
8278,720575940624153226,right,R8,219,6,-4,-8,4,"6,-4"
8279,720575940613614250,right,R8,220,2,-6,-5,-1,"2,-6"
8280,720575940626408525,right,R8,221,-7,3,8,-5,"-7,3"
8281,720575940621803361,right,R8,223,-2,26,15,11,"-2,26"
8282,720575940613537046,right,R8,225,2,-26,-15,-11,"2,-26"
8283,720575940627603230,right,R8,226,5,19,4,15,"5,19"
8284,720575940612696282,right,R8,227,-7,5,9,-4,"-7,5"
8285,720575940622454817,right,R8,229,5,2,-4,6,"5,2"
8286,720575940613141913,right,R8,230,2,9,2,7,"2,9"
8287,720575940623836440,right,R8,231,4,-12,-10,-2,"4,-12"
8288,720575940633626285,right,R8,232,-4,13,10,3,"-4,13"
8289,720575940644726728,right,R8,233,4,-13,-11,-2,"4,-13"
8290,720575940623871437,right,R8,234,1,3,0,3,"1,3"
8291,720575940628543748,right,R8,235,4,11,1,10,"4,11"
8292,720575940632832824,right,R8,238,-8,-3,6,-9,"-8,-3"
8293,720575940627958149,right,R8,239,-6,6,9,-3,"-6,6"
8294,720575940631557228,right,R8,240,-4,-3,2,-5,"-4,-3"
8295,720575940640426611,right,R8,241,2,-17,-11,-6,"2,-17"
8296,720575940610880324,right,R8,242,-4,6,7,-1,"-4,6"
8297,720575940640724864,right,R8,243,-1,-21,-10,-11,"-1,-21"
8298,720575940618347220,right,R8,244,-4,-12,-2,-10,"-4,-12"
8299,720575940632482105,right,R8,245,-5,-3,3,-6,"-5,-3"
8300,720575940627185436,right,R8,248,-6,0,6,-6,"-6,0"
8301,720575940609288457,right,R8,249,2,-12,-8,-4,"2,-12"
8302,720575940624977481,right,R8,250,-1,1,1,0,"-1,1"
8303,720575940619086149,right,R8,251,-1,-14,-6,-8,"-1,-14"
8304,720575940627861125,right,R8,252,3,23,8,15,"3,23"
8305,720575940633840685,right,R8,253,5,16,3,13,"5,16"
8306,720575940632800396,right,R8,254,3,-24,-15,-9,"3,-24"
8307,720575940626782270,right,R8,255,-6,-13,-1,-12,"-6,-13"
8308,720575940618433826,right,R8,256,5,-20,-15,-5,"5,-20"
8309,720575940624309798,right,R8,258,-4,-17,-5,-12,"-4,-17"
8310,720575940618574493,right,R8,259,-7,-5,4,-9,"-7,-5"
8311,720575940641763981,right,R8,261,-1,13,7,6,"-1,13"
8312,720575940640536179,right,R8,262,1,-11,-7,-4,"1,-11"
8313,720575940613637861,right,R8,263,-3,4,5,-1,"-3,4"
8314,720575940623572445,right,R8,264,-1,-6,-2,-4,"-1,-6"
8315,720575940625165897,right,R8,267,-6,2,7,-5,"-6,2"
8316,720575940613192677,right,R8,268,7,-6,-10,4,"7,-6"
8317,720575940636153451,right,R8,269,2,-19,-12,-7,"2,-19"
8318,720575940624834741,right,R8,270,1,-8,-5,-3,"1,-8"
8319,720575940620986459,right,R8,271,4,6,-1,7,"4,6"
8320,720575940650505081,right,R8,272,3,-2,-4,2,"3,-2"
8321,720575940625588460,right,R8,273,-6,23,17,6,"-6,23"
8322,720575940631221564,right,R8,274,6,4,-4,8,"6,4"
8323,720575940634901017,right,R8,275,-8,-1,7,-8,"-8,-1"
8324,720575940629612075,right,R8,276,2,3,-1,4,"2,3"
8325,720575940631406329,right,R8,277,7,-3,-9,6,"7,-3"
8326,720575940628642044,right,R8,278,-5,10,10,0,"-5,10"
8327,720575940624073510,right,R8,279,-4,8,8,0,"-4,8"
8328,720575940656086177,right,R8,280,-6,-14,-1,-13,"-6,-14"
8329,720575940609013769,right,R8,282,0,26,13,13,"0,26"
8330,720575940607898034,right,R8,283,-4,4,6,-2,"-4,4"
8331,720575940613867235,right,R8,284,0,25,12,13,"0,25"
8332,720575940631526518,right,R8,285,6,-18,-15,-3,"6,-18"
8333,720575940618313105,right,R8,286,0,-24,-12,-12,"0,-24"
8334,720575940613710194,right,R8,290,5,-24,-17,-7,"5,-24"
8335,720575940633292461,right,R8,291,7,2,-6,8,"7,2"
8336,720575940625755123,right,R8,292,-4,18,13,5,"-4,18"
8337,720575940627081828,right,R8,296,1,-18,-10,-8,"1,-18"
8338,720575940618871197,right,R8,298,-5,5,7,-2,"-5,5"
8339,720575940623086369,right,R8,300,4,-18,-13,-5,"4,-18"
8340,720575940622574580,right,R8,301,-5,16,13,3,"-5,16"
8341,720575940624480915,right,R8,302,2,17,6,11,"2,17"
8342,720575940633323807,right,R8,303,-5,22,16,6,"-5,22"
8343,720575940627919902,right,R8,304,6,5,-4,9,"6,5"
8344,720575940628473092,right,R8,305,-7,4,9,-5,"-7,4"
8345,720575940628201786,right,R8,306,3,7,0,7,"3,7"
8346,720575940613579178,right,R8,308,-5,8,9,-1,"-5,8"
8347,720575940615659682,right,R8,310,2,22,9,13,"2,22"
8348,720575940614832435,right,R8,311,-7,15,14,1,"-7,15"
8349,720575940624020521,right,R8,312,4,-7,-8,1,"4,-7"
8350,720575940606723430,right,R8,313,7,3,-6,9,"7,3"
8351,720575940621680481,right,R8,315,-3,-6,0,-6,"-3,-6"
8352,720575940615280551,right,R8,316,5,-4,-7,3,"5,-4"
8353,720575940628746312,right,R8,317,-5,-4,3,-7,"-5,-4"
8354,720575940618467985,right,R8,318,4,-19,-14,-5,"4,-19"
8355,720575940612445107,right,R8,319,-2,5,4,1,"-2,5"
8356,720575940628688616,right,R8,320,-2,-5,-1,-4,"-2,-5"
8357,720575940626264880,right,R8,322,2,26,11,15,"2,26"
8358,720575940615130274,right,R8,324,3,24,9,15,"3,24"
8359,720575940629951504,right,R8,325,5,1,-5,6,"5,1"
8360,720575940632792899,right,R8,326,2,16,6,10,"2,16"
8361,720575940618518246,right,R8,328,5,-9,-10,1,"5,-9"
8362,720575940625686349,right,R8,329,0,24,12,12,"0,24"
8363,720575940624437130,right,R8,330,3,3,-2,5,"3,3"
8364,720575940620910160,right,R8,331,1,-15,-9,-6,"1,-15"
8365,720575940616317599,right,R8,334,1,-26,-14,-12,"1,-26"
8366,720575940639674200,right,R8,335,2,8,2,6,"2,8"
8367,720575940613428502,right,R8,336,0,23,11,12,"0,23"
8368,720575940631563769,right,R8,337,-5,-6,2,-8,"-5,-6"
8369,720575940612768369,right,R8,338,-1,0,1,-1,"-1,0"
8370,720575940632451897,right,R8,339,6,11,-1,12,"6,11"
8371,720575940608239026,right,R8,340,-4,17,12,5,"-4,17"
8372,720575940630168314,right,R8,341,6,-17,-15,-2,"6,-17"
8373,720575940639955509,right,R8,342,2,-15,-10,-5,"2,-15"
8374,720575940640218702,right,R8,343,-3,27,16,11,"-3,27"
8375,720575940624684727,right,R8,345,3,-12,-9,-3,"3,-12"
8376,720575940618697757,right,R8,346,-7,-9,2,-11,"-7,-9"
8377,720575940625978044,right,R8,347,-5,-13,-2,-11,"-5,-13"
8378,720575940618485945,right,R8,348,3,14,4,10,"3,14"
8379,720575940626614053,right,R8,349,-5,-14,-2,-12,"-5,-14"
8380,720575940611534449,right,R8,350,1,15,6,9,"1,15"
8381,720575940626341424,right,R8,353,2,24,10,14,"2,24"
8382,720575940614929361,right,R8,354,-2,-26,-11,-15,"-2,-26"
8383,720575940653535990,right,R8,355,-7,-6,4,-10,"-7,-6"
8384,720575940614387181,right,R8,356,0,22,11,11,"0,22"
8385,720575940630611712,right,R8,359,2,23,9,14,"2,23"
8386,720575940622897178,right,R8,360,-5,19,14,5,"-5,19"
8387,720575940616290527,right,R8,361,0,-7,-4,-3,"0,-7"
8388,720575940606399678,right,R8,362,2,-20,-12,-8,"2,-20"
8389,720575940628441105,right,R8,363,7,-4,-9,5,"7,-4"
8390,720575940615468987,right,R8,364,4,4,-2,6,"4,4"
8391,720575940626094413,right,R8,365,4,7,-1,8,"4,7"
8392,720575940635028761,right,R8,367,-6,-15,-2,-13,"-6,-15"
8393,720575940634046419,right,R8,369,5,-5,-8,3,"5,-5"
8394,720575940611671416,right,R8,370,-3,21,13,8,"-3,21"
8395,720575940624260646,right,R8,371,6,-5,-9,4,"6,-5"
8396,720575940628467985,right,R8,372,1,-2,-2,0,"1,-2"
8397,720575940634787097,right,R8,373,1,-21,-12,-9,"1,-21"
8398,720575940626341680,right,R8,374,2,13,4,9,"2,13"
8399,720575940622057332,right,R8,375,-6,7,9,-2,"-6,7"
8400,720575940629166953,right,R8,377,0,7,3,4,"0,7"
8401,720575940635885759,right,R8,378,-3,18,12,6,"-3,18"
8402,720575940623865624,right,R8,382,3,-6,-6,0,"3,-6"
8403,720575940615052946,right,R8,385,-3,-18,-6,-12,"-3,-18"
8404,720575940621743451,right,R8,386,-6,19,15,4,"-6,19"
8405,720575940632255530,right,R8,388,3,19,6,13,"3,19"
8406,720575940613077221,right,R8,390,-6,-9,1,-10,"-6,-9"
8407,720575940612982770,right,R8,391,4,-3,-6,3,"4,-3"
8408,720575940647525940,right,R8,392,-4,7,7,0,"-4,7"
8409,720575940632662329,right,R8,393,-1,22,12,10,"-1,22"
8410,720575940618327330,right,R8,394,-7,-8,3,-11,"-7,-8"
8411,720575940621783649,right,R8,395,0,-22,-11,-11,"0,-22"
8412,720575940630306942,right,R8,396,-1,10,6,4,"-1,10"
8413,720575940636329140,right,R8,397,-3,-19,-7,-12,"-3,-19"
8414,720575940630989879,right,R8,401,-2,-19,-8,-11,"-2,-19"
8415,720575940624604855,right,R8,402,3,26,10,16,"3,26"
8416,720575940619120453,right,R8,403,-2,-12,-4,-8,"-2,-12"
8417,720575940618216166,right,R8,404,-1,20,11,9,"-1,20"
8418,720575940634301154,right,R8,405,3,10,2,8,"3,10"
8419,720575940624139800,right,R8,406,1,-25,-14,-11,"1,-25"
8420,720575940621287104,right,R8,407,-5,-10,0,-10,"-5,-10"
8421,720575940621423041,right,R8,408,-6,-4,4,-8,"-6,-4"
8422,720575940610417347,right,R8,409,0,-3,-2,-1,"0,-3"
8423,720575940614101731,right,R8,410,-2,-2,1,-3,"-2,-2"
8424,720575940628317778,right,R8,411,-5,-19,-5,-14,"-5,-19"
8425,720575940625745907,right,R8,413,-2,-7,-2,-5,"-2,-7"
8426,720575940624717565,right,R8,414,4,21,6,15,"4,21"
8427,720575940615934943,right,R8,415,6,12,0,12,"6,12"
8428,720575940641200512,right,R8,416,3,-8,-7,-1,"3,-8"
8429,720575940621040213,right,R8,417,-6,-10,1,-11,"-6,-10"
8430,720575940623376716,right,R8,419,-3,-11,-3,-8,"-3,-11"
8431,720575940632631097,right,R8,420,6,-3,-8,5,"6,-3"
8432,720575940631194167,right,R8,422,-7,-4,5,-9,"-7,-4"
8433,720575940630487287,right,R8,423,3,-18,-12,-6,"3,-18"
8434,720575940624112531,right,R8,425,3,20,7,13,"3,20"
8435,720575940627211522,right,R8,426,-3,0,3,-3,"-3,0"
8436,720575940632115983,right,R8,427,5,-18,-14,-4,"5,-18"
8437,720575940621190022,right,R8,429,-2,14,9,5,"-2,14"
8438,720575940627537497,right,R8,430,-3,-7,-1,-6,"-3,-7"
8439,720575940630591479,right,R8,431,-2,-10,-3,-7,"-2,-10"
8440,720575940622751145,right,R8,432,-5,7,8,-1,"-5,7"
8441,720575940607890121,right,R8,434,-3,7,6,1,"-3,7"
8442,720575940647152931,right,R8,435,5,-17,-14,-3,"5,-17"
8443,720575940638782953,right,R8,436,0,-15,-8,-7,"0,-15"
8444,720575940629678697,right,R8,437,-3,12,9,3,"-3,12"
8445,720575940615145011,right,R8,438,2,27,11,16,"2,27"
8446,720575940631037244,right,R8,439,-3,-9,-2,-7,"-3,-9"
8447,720575940634222049,right,R8,440,1,23,10,13,"1,23"
8448,720575940614727720,right,R8,441,3,-16,-11,-5,"3,-16"
8449,720575940621000468,right,R8,442,-5,25,17,8,"-5,25"
8450,720575940610022357,right,R8,445,-2,8,6,2,"-2,8"
8451,720575940621905773,right,R8,446,2,-14,-9,-5,"2,-14"
8452,720575940633169177,right,R8,447,-1,2,2,0,"-1,2"
8453,720575940621922998,right,R8,449,6,-16,-14,-2,"6,-16"
8454,720575940609161308,right,R8,450,2,-9,-7,-2,"2,-9"
8455,720575940640159293,right,R8,451,4,20,6,14,"4,20"
8456,720575940621996129,right,R8,452,1,-9,-6,-3,"1,-9"
8457,720575940625447655,right,R8,453,3,25,9,16,"3,25"
8458,720575940620575281,right,R8,454,5,-12,-11,-1,"5,-12"
8459,720575940617999931,right,R8,455,7,-7,-11,4,"7,-7"
8460,720575940626533220,right,R8,456,0,21,10,11,"0,21"
8461,720575940625438700,right,R8,457,-2,17,10,7,"-2,17"
8462,720575940605822176,right,R8,458,5,0,-5,5,"5,0"
8463,720575940631433785,right,R8,459,5,-3,-7,4,"5,-3"
8464,720575940625550311,right,R8,460,-3,-20,-7,-13,"-3,-20"
8465,720575940616429890,right,R8,461,7,-5,-10,5,"7,-5"
8466,720575940615916182,right,R8,462,-1,18,10,8,"-1,18"
8467,720575940628320017,right,R8,463,5,17,3,14,"5,17"
8468,720575940630238567,right,R8,464,4,0,-4,4,"4,0"
8469,720575940613574553,right,R8,465,3,0,-3,3,"3,0"
8470,720575940623581917,right,R8,466,1,14,6,8,"1,14"
8471,720575940609720843,right,R8,467,-2,-20,-8,-12,"-2,-20"
8472,720575940624814519,right,R8,470,4,-9,-9,0,"4,-9"
8473,720575940626559120,right,R8,471,3,-26,-16,-10,"3,-26"
8474,720575940628478184,right,R8,472,1,25,11,14,"1,25"
8475,720575940623937037,right,R8,476,-1,15,8,7,"-1,15"
8476,720575940626694949,right,R8,477,-3,2,4,-2,"-3,2"
8477,720575940613630742,right,R8,480,3,-19,-13,-6,"3,-19"
8478,720575940623710249,right,R8,481,4,-8,-8,0,"4,-8"
8479,720575940644731040,right,R8,482,1,17,7,10,"1,17"
8480,720575940638069872,right,R8,483,2,-7,-6,-1,"2,-7"
8481,720575940633938643,right,R8,484,3,-9,-8,-1,"3,-9"
8482,720575940620740432,right,R8,485,-3,-3,1,-4,"-3,-3"
8483,720575940624978357,right,R8,488,7,5,-5,10,"7,5"
8484,720575940635854943,right,R8,489,-3,10,8,2,"-3,10"
8485,720575940624616375,right,R8,490,-5,6,8,-2,"-5,6"
8486,720575940628073554,right,R8,491,7,-1,-8,7,"7,-1"
8487,720575940613547890,right,R8,492,-7,-2,6,-8,"-7,-2"
8488,720575940634431970,right,R8,493,-3,23,14,9,"-3,23"
8489,720575940617005836,right,R8,495,4,5,-2,7,"4,5"
8490,720575940626995033,right,R8,496,7,8,-3,11,"7,8"
8491,720575940617646453,right,R8,497,6,1,-6,7,"6,1"
8492,720575940606412771,right,R8,498,6,10,-1,11,"6,10"
8493,720575940648165508,right,R8,499,5,10,0,10,"5,10"
8494,720575940618937684,right,R8,500,7,-8,-11,3,"7,-8"
8495,720575940624836937,right,R8,501,1,2,0,2,"1,2"
8496,720575940625168457,right,R8,502,5,8,-1,9,"5,8"
8497,720575940627286105,right,R8,503,3,17,5,12,"3,17"
8498,720575940637042533,right,R8,504,-2,9,6,3,"-2,9"
8499,720575940612412110,right,R8,506,1,-12,-7,-5,"1,-12"
8500,720575940633614675,right,R8,507,-5,-12,-1,-11,"-5,-12"
8501,720575940623633885,right,R8,508,-5,11,10,1,"-5,11"
8502,720575940623905672,right,R8,509,-4,10,9,1,"-4,10"
8503,720575940629673771,right,R8,511,5,-11,-11,0,"5,-11"
8504,720575940635324572,right,R8,512,6,0,-6,6,"6,0"
8505,720575940628320789,right,R8,513,-4,-13,-3,-10,"-4,-13"
8506,720575940615663522,right,R8,514,-4,-10,-1,-9,"-4,-10"
8507,720575940609198684,right,R8,518,-4,22,15,7,"-4,22"
8508,720575940627945554,right,R8,519,-5,-5,2,-7,"-5,-5"
8509,720575940623862040,right,R8,520,-2,-22,-9,-13,"-2,-22"
8510,720575940619161669,right,R8,521,6,-9,-11,2,"6,-9"
8511,720575940626426701,right,R8,522,-4,0,4,-4,"-4,0"
8512,720575940628819196,right,R8,523,2,14,5,9,"2,14"
8513,720575940618684673,right,R8,524,4,-20,-14,-6,"4,-20"
8514,720575940621535470,right,R8,527,-4,-8,0,-8,"-4,-8"
8515,720575940624691125,right,R8,529,2,-2,-3,1,"2,-2"
8516,720575940619079709,right,R8,530,-3,-13,-4,-9,"-3,-13"
8517,720575940648335748,right,R8,531,1,0,-1,1,"1,0"
8518,720575940624286698,right,R8,532,-8,7,11,-4,"-8,7"
8519,720575940632539434,right,R8,533,0,-16,-8,-8,"0,-16"
8520,720575940635589530,right,R8,534,3,2,-2,4,"3,2"
8521,720575940609497611,right,R8,536,3,4,-1,5,"3,4"
8522,720575940635983002,right,R8,537,0,-23,-12,-11,"0,-23"
8523,720575940611416440,right,R8,538,-4,1,4,-3,"-4,1"
8524,720575940655910561,right,R8,539,-6,15,13,2,"-6,15"
8525,720575940625161545,right,R8,540,-2,-9,-3,-6,"-2,-9"
8526,720575940636748911,right,R8,542,6,-13,-13,0,"6,-13"
8527,720575940614982451,right,R8,543,-1,-4,-1,-3,"-1,-4"
8528,720575940616325343,right,R8,544,3,-13,-10,-3,"3,-13"
8529,720575940631205420,right,R8,545,5,11,0,11,"5,11"
8530,720575940622718302,right,R8,546,3,6,0,6,"3,6"
8531,720575940635605183,right,R8,547,-1,21,11,10,"-1,21"
8532,720575940626702480,right,R8,549,0,-9,-5,-4,"0,-9"
8533,720575940618254297,right,R8,551,-4,-9,-1,-8,"-4,-9"
8534,720575940631547991,right,R8,552,4,-1,-5,4,"4,-1"
8535,720575940629232646,right,R8,553,-3,16,11,5,"-3,16"
8536,720575940612848858,right,R8,556,0,10,5,5,"0,10"
8537,720575940627243962,right,R8,557,6,-10,-11,1,"6,-10"
8538,720575940619007489,right,R8,558,-4,-21,-7,-14,"-4,-21"
8539,720575940619907032,right,R8,561,5,7,-2,9,"5,7"
8540,720575940617053115,right,R8,562,-5,-2,4,-6,"-5,-2"
8541,720575940617043468,right,R8,563,5,-13,-12,-1,"5,-13"
8542,720575940632053519,right,R8,564,3,-23,-15,-8,"3,-23"
8543,720575940638649822,right,R8,565,0,-26,-13,-13,"0,-26"
8544,720575940632541763,right,R8,566,5,-8,-9,1,"5,-8"
8545,720575940612886677,right,R8,567,-2,22,13,9,"-2,22"
8546,720575940613454962,right,R8,568,-6,-8,2,-10,"-6,-8"
8547,720575940633367635,right,R8,570,2,25,10,15,"2,25"
8548,720575940632200207,right,R8,571,0,-14,-7,-7,"0,-14"
8549,720575940642439899,right,R8,572,-8,3,9,-6,"-8,3"
8550,720575940632050986,right,R8,573,4,14,3,11,"4,14"
8551,720575940637030007,right,R8,574,-6,5,8,-3,"-6,5"
8552,720575940614937666,right,R8,575,6,9,-2,11,"6,9"
8553,720575940628028029,right,R8,576,0,28,14,14,"0,28"
8554,720575940630975036,right,R8,579,-3,-10,-2,-8,"-3,-10"
8555,720575940612447694,right,R8,580,-2,-23,-10,-13,"-2,-23"
8556,720575940624073668,right,R8,581,3,9,1,8,"3,9"
8557,720575940630742316,right,R8,583,3,-25,-16,-9,"3,-25"
8558,720575940628218129,right,R8,585,-1,-23,-11,-12,"-1,-23"
8559,720575940618532865,right,R8,586,2,18,7,11,"2,18"
8560,720575940623758616,right,R8,587,4,22,7,15,"4,22"
8561,720575940632746296,right,R8,588,1,4,1,3,"1,4"
8562,720575940629914115,right,R8,589,-1,-5,-2,-3,"-1,-5"
8563,720575940607909554,right,R8,590,1,9,3,6,"1,9"
8564,720575940630004792,right,R8,591,3,-3,-5,2,"3,-3"
8565,720575940628814084,right,R8,593,3,-14,-10,-4,"3,-14"
8566,720575940639130601,right,R8,595,7,-12,-13,1,"7,-12"
8567,720575940616488002,right,R8,596,-4,-16,-4,-12,"-4,-16"
8568,720575940627469058,right,R8,597,4,1,-4,5,"4,1"
8569,720575940608215426,right,R8,598,2,-18,-11,-7,"2,-18"
8570,720575940614838323,right,R8,600,3,-10,-8,-2,"3,-10"
8571,720575940632090666,right,R8,601,1,16,7,9,"1,16"
8572,720575940625419272,right,R8,602,4,-2,-5,3,"4,-2"
8573,720575940631980303,right,R8,603,-3,-23,-9,-14,"-3,-23"
8574,720575940623543501,right,R8,604,-6,-17,-3,-14,"-6,-17"
8575,720575940636208888,right,R8,605,3,15,4,11,"3,15"
8576,720575940625676787,right,R8,606,-1,-19,-9,-10,"-1,-19"
8577,720575940618099385,right,R8,607,1,18,8,10,"1,18"
8578,720575940616112543,right,R8,608,1,10,4,6,"1,10"
8579,720575940630171959,right,R8,609,-2,0,2,-2,"-2,0"
8580,720575940628422421,right,R8,610,2,-23,-14,-9,"2,-23"
8581,720575940618209117,right,R8,611,-1,-18,-8,-10,"-1,-18"
8582,720575940621979745,right,R8,613,-8,-4,6,-10,"-8,-4"
8583,720575940629470763,right,R8,615,-7,-7,3,-10,"-7,-7"
8584,720575940623148108,right,R8,616,-3,15,10,5,"-3,15"
8585,720575940626165837,right,R8,617,-2,-17,-7,-10,"-2,-17"
8586,720575940622484852,right,R8,619,-4,-19,-6,-13,"-4,-19"
8587,720575940627958936,right,R8,620,7,1,-7,8,"7,1"
8588,720575940630909660,right,R8,621,1,24,11,13,"1,24"
8589,720575940628119059,right,R8,622,-5,20,15,5,"-5,20"
8590,720575940625449971,right,R8,623,1,13,5,8,"1,13"
8591,720575940613887858,right,R8,624,1,-17,-10,-7,"1,-17"
8592,720575940613775331,right,R8,625,-2,24,14,10,"-2,24"
8593,720575940624641205,right,R8,626,-5,-8,1,-9,"-5,-8"
8594,720575940638214878,right,R8,627,0,-1,-1,0,"0,-1"
8595,720575940636397748,right,R8,628,0,0,0,0,"0,0"
8596,720575940614925054,right,R8,629,4,24,8,16,"4,24"
8597,720575940639696829,right,R8,630,4,8,0,8,"4,8"
8598,720575940637618830,right,R8,631,1,26,12,14,"1,26"
8599,720575940645427236,right,R8,632,3,-20,-13,-7,"3,-20"
8600,720575940625422520,right,R8,633,-1,-24,-11,-13,"-1,-24"
8601,720575940627602206,right,R8,634,-3,-15,-5,-10,"-3,-15"
8602,720575940625905383,right,R8,635,6,-6,-9,3,"6,-6"
8603,720575940633390500,right,R8,636,0,6,3,3,"0,6"
8604,720575940616369218,right,R8,637,3,-21,-14,-7,"3,-21"
8605,720575940617269947,right,R8,640,-1,-16,-7,-9,"-1,-16"
8606,720575940609520393,right,R8,642,-5,-11,-1,-10,"-5,-11"
8607,720575940620089211,right,R8,643,6,14,1,13,"6,14"
8608,720575940627946066,right,R8,647,-4,-7,0,-7,"-4,-7"
8609,720575940618197433,right,R8,648,1,7,2,5,"1,7"
8610,720575940621834662,right,R8,649,-1,5,3,2,"-1,5"
8611,720575940621503169,right,R8,651,-4,-5,1,-6,"-4,-5"
8612,720575940621023573,right,R8,652,-6,-11,0,-11,"-6,-11"
8613,720575940629947751,right,R8,653,-6,-12,0,-12,"-6,-12"
8614,720575940630603255,right,R8,654,-3,8,7,1,"-3,8"
8615,720575940629213127,right,R8,655,6,-1,-7,6,"6,-1"
8616,720575940635295840,right,R8,656,0,-11,-6,-5,"0,-11"
8617,720575940627148546,right,R8,657,-2,-25,-11,-14,"-2,-25"
8618,720575940621500326,right,R8,658,1,20,9,11,"1,20"
8619,720575940608918108,right,R8,659,-4,-6,1,-7,"-4,-6"
8620,720575940618455074,right,R8,662,2,-1,-3,2,"2,-1"
8621,720575940615199143,right,R8,663,0,8,4,4,"0,8"
8622,720575940619072001,right,R8,664,1,-27,-15,-12,"1,-27"
8623,720575940637167582,right,R8,665,7,-2,-8,6,"7,-2"
8624,720575940621270443,right,R8,669,4,-16,-12,-4,"4,-16"
8625,720575940618540957,right,R8,671,-4,-23,-8,-15,"-4,-23"
8626,720575940616137322,right,R8,672,-8,11,13,-2,"-8,11"
8627,720575940627180290,right,R8,673,2,5,0,5,"2,5"
8628,720575940616829627,right,R8,676,-3,-21,-8,-13,"-3,-21"
8629,720575940613431062,right,R8,677,0,11,5,6,"0,11"
8630,720575940626152269,right,R8,678,3,-7,-7,0,"3,-7"
8631,720575940629673004,right,R8,679,4,18,5,13,"4,18"
8632,720575940647522356,right,R8,681,-2,-21,-9,-12,"-2,-21"
8633,720575940643067789,right,R8,682,6,-8,-10,2,"6,-8"
8634,720575940633541165,right,R8,683,2,6,1,5,"2,6"
8635,720575940631524805,right,R8,685,-5,-9,0,-9,"-5,-9"
8636,720575940613213875,right,R8,686,5,-22,-16,-6,"5,-22"
8637,720575940620718727,right,R8,687,-6,-3,4,-7,"-6,-3"
8638,720575940621913264,right,R8,688,-7,10,12,-2,"-7,10"
8639,720575940613590642,right,R8,689,-2,18,11,7,"-2,18"
8640,720575940618875549,right,R8,690,-7,-3,5,-8,"-7,-3"
8641,720575940656074145,right,R8,692,-4,24,16,8,"-4,24"
8642,720575940621016912,right,R8,693,-3,25,15,10,"-3,25"
8643,720575940661284993,right,R8,694,4,3,-3,6,"4,3"
8644,720575940625492152,right,R8,695,-6,10,11,-1,"-6,10"
8645,720575940647654452,right,R8,697,1,-22,-12,-10,"1,-22"
8646,720575940616866747,right,R8,698,6,-7,-10,3,"6,-7"
8647,720575940613520498,right,R8,700,5,15,2,13,"5,15"
8648,720575940661201025,right,R8,701,0,-4,-2,-2,"0,-4"
8649,720575940616141535,right,R8,702,-5,23,16,7,"-5,23"
8650,720575940612179042,right,R8,703,-3,1,3,-2,"-3,1"
8651,720575940628390404,right,R8,704,-7,8,11,-3,"-7,8"
8652,720575940626697264,right,R8,705,1,1,-1,2,"1,1"
8653,720575940631662329,right,R8,709,-2,-24,-10,-14,"-2,-24"
8654,720575940612964757,right,R8,710,4,-25,-17,-8,"4,-25"
8655,720575940635535002,right,R8,711,-1,19,10,9,"-1,19"
8656,720575940614156072,right,R8,714,5,12,1,11,"5,12"
8657,720575940614658355,right,R8,715,4,10,1,9,"4,10"
8658,720575940625448968,right,R8,716,4,-6,-7,1,"4,-6"
8659,720575940633830701,right,R8,717,2,-22,-13,-9,"2,-22"
8660,720575940635936703,right,R8,719,1,27,12,15,"1,27"
8661,720575940614720040,right,R8,720,-5,21,15,6,"-5,21"
8662,720575940628189256,right,R8,721,5,13,1,12,"5,13"
8663,720575940621433734,right,R8,722,6,-15,-14,-1,"6,-15"
8664,720575940618292697,right,R8,724,4,2,-3,5,"4,2"
8665,720575940635567039,right,R8,725,-3,-24,-9,-15,"-3,-24"
8666,720575940609785301,right,R8,727,7,6,-4,10,"7,6"
8667,720575940628296872,right,R8,728,7,12,-1,13,"7,12"
8668,720575940634319827,right,R8,730,7,0,-7,7,"7,0"
8669,720575940618508006,right,R8,731,-6,9,10,-1,"-6,9"
8670,720575940643054733,right,R8,732,-3,6,6,0,"-3,6"
8671,720575940627709565,right,R8,734,2,0,-2,2,"2,0"
8672,720575940619266880,right,R8,735,1,-23,-13,-10,"1,-23"
8673,720575940624795829,right,R8,736,-8,1,8,-7,"-8,1"
8674,720575940636270840,right,R8,737,0,19,9,10,"0,19"
8675,720575940631220284,right,R8,738,-3,13,9,4,"-3,13"
8676,720575940615257490,right,R8,739,-7,2,8,-6,"-7,2"
8677,720575940634841369,right,R8,740,2,-8,-6,-2,"2,-8"
8678,720575940624117784,right,R8,741,-2,-14,-5,-9,"-2,-14"
8679,720575940606492350,right,R8,742,-4,11,9,2,"-4,11"
8680,720575940625388948,right,R8,744,-4,25,16,9,"-4,25"
8681,720575940627945042,right,R8,745,0,13,6,7,"0,13"
8682,720575940616858636,right,R8,746,-3,3,4,-1,"-3,3"
8683,720575940621447407,right,R8,747,0,2,1,1,"0,2"
8684,720575940629974019,right,R8,748,-4,20,14,6,"-4,20"
8685,720575940635651263,right,R8,749,-2,1,2,-1,"-2,1"
8686,720575940624045411,right,R8,751,1,6,2,4,"1,6"
8687,720575940620575573,right,R8,752,-2,7,5,2,"-2,7"
8688,720575940618669908,right,R8,753,-3,24,15,9,"-3,24"
8689,720575940644449480,right,R8,755,4,19,5,14,"4,19"
8690,720575940609378571,right,R8,756,5,20,5,15,"5,20"
8691,720575940626633104,right,R8,757,0,-6,-3,-3,"0,-6"
8692,720575940634232290,right,R8,758,5,-1,-6,5,"5,-1"
8693,720575940616689202,right,R8,760,0,17,8,9,"0,17"
8694,720575940642562779,right,R8,761,-4,-18,-5,-13,"-4,-18"
8695,720575940629315371,right,R8,762,0,14,7,7,"0,14"
8696,720575940619853878,right,R8,763,-5,14,12,2,"-5,14"
8697,720575940624244420,right,R8,766,2,-4,-4,0,"2,-4"
8698,720575940632591171,right,R8,768,3,5,-1,6,"3,5"
8699,720575940635717786,right,R8,770,5,4,-3,7,"5,4"
8700,720575940634572384,right,R8,772,1,12,5,7,"1,12"
8701,720575940623642723,right,R8,773,5,-19,-15,-4,"5,-19"
8702,720575940622659422,right,R8,774,-8,6,11,-5,"-8,6"
8703,720575940618606676,right,R8,775,5,22,6,16,"5,22"
8704,720575940624495630,right,T1,1,-6,13,12,1,"-6,13"
8705,720575940628242170,right,T1,2,-8,2,9,-7,"-8,2"
8706,720575940617679163,right,T1,3,6,-12,-12,0,"6,-12"
8707,720575940618837844,right,T1,4,-5,-21,-6,-15,"-5,-21"
8708,720575940628090184,right,T1,5,-1,16,9,7,"-1,16"
8709,720575940620064646,right,T1,6,-2,-4,0,-4,"-2,-4"
8710,720575940615088530,right,T1,7,-6,-6,3,-9,"-6,-6"
8711,720575940618479650,right,T1,8,-4,26,17,9,"-4,26"
8712,720575940617747851,right,T1,9,4,9,0,9,"4,9"
8713,720575940614671853,right,T1,10,5,-15,-13,-2,"5,-15"
8714,720575940623905416,right,T1,11,7,-14,-14,0,"7,-14"
8715,720575940623908649,right,T1,12,-7,9,11,-2,"-7,9"
8716,720575940626662960,right,T1,13,-1,-26,-12,-14,"-1,-26"
8717,720575940620980615,right,T1,14,0,-27,-14,-13,"0,-27"
8718,720575940617008070,right,T1,15,2,-3,-4,1,"2,-3"
8719,720575940632283467,right,T1,16,-2,-16,-6,-10,"-2,-16"
8720,720575940635467887,right,T1,17,1,-5,-4,-1,"1,-5"
8721,720575940628071185,right,T1,18,5,-16,-13,-3,"5,-16"
8722,720575940621334804,right,T1,20,3,-11,-9,-2,"3,-11"
8723,720575940630774603,right,T1,21,-2,19,11,8,"-2,19"
8724,720575940638829646,right,T1,22,-1,3,2,1,"-1,3"
8725,720575940640201013,right,T1,23,-3,-16,-5,-11,"-3,-16"
8726,720575940640029555,right,T1,24,-1,-10,-4,-6,"-1,-10"
8727,720575940606741771,right,T1,25,-9,3,10,-7,"-9,3"
8728,720575940607643570,right,T1,26,1,-3,-3,0,"1,-3"
8729,720575940621986913,right,T1,27,0,-25,-13,-12,"0,-25"
8730,720575940624155853,right,T1,28,5,6,-2,8,"5,6"
8731,720575940627494013,right,T1,29,-1,-3,-1,-2,"-1,-3"
8732,720575940610201539,right,T1,30,6,16,2,14,"6,16"
8733,720575940622317488,right,T1,31,0,16,8,8,"0,16"
8734,720575940618700322,right,T1,33,3,18,6,12,"3,18"
8735,720575940608177586,right,T1,34,6,18,3,15,"6,18"
8736,720575940616861964,right,T1,35,1,-24,-13,-11,"1,-24"
8737,720575940628201274,right,T1,36,6,8,-2,10,"6,8"
8738,720575940628568904,right,T1,37,1,5,1,4,"1,5"
8739,720575940610932322,right,T1,38,0,-2,-1,-1,"0,-2"
8740,720575940614769361,right,T1,39,0,20,10,10,"0,20"
8741,720575940629646183,right,T1,40,-2,-6,-1,-5,"-2,-6"
8742,720575940620958228,right,T1,41,-3,28,17,11,"-3,28"
8743,720575940619803697,right,T1,42,-1,14,8,6,"-1,14"
8744,720575940639801251,right,T1,44,5,-10,-10,0,"5,-10"
8745,720575940640875427,right,T1,45,-5,-1,4,-5,"-5,-1"
8746,720575940632344106,right,T1,46,-5,15,12,3,"-5,15"
8747,720575940624670748,right,T1,47,-9,-1,8,-9,"-9,-1"
8748,720575940623480556,right,T1,48,-4,-22,-7,-15,"-4,-22"
8749,720575940633001553,right,T1,49,4,-4,-6,2,"4,-4"
8750,720575940611453906,right,T1,50,-2,21,12,9,"-2,21"
8751,720575940612342746,right,T1,51,0,-19,-10,-9,"0,-19"
8752,720575940627787578,right,T1,52,-1,-22,-10,-12,"-1,-22"
8753,720575940645368087,right,T1,53,5,14,2,12,"5,14"
8754,720575940624271556,right,T1,55,-4,-11,-2,-9,"-4,-11"
8755,720575940640271933,right,T1,56,1,-13,-8,-5,"1,-13"
8756,720575940623344483,right,T1,57,6,-11,-12,1,"6,-11"
8757,720575940624260393,right,T1,58,3,12,3,9,"3,12"
8758,720575940640215504,right,T1,59,-2,2,3,-1,"-2,2"
8759,720575940631062572,right,T1,60,-8,8,12,-4,"-8,8"
8760,720575940620680357,right,T1,61,-4,-4,2,-6,"-4,-4"
8761,720575940641748532,right,T1,63,4,12,2,10,"4,12"
8762,720575940621183141,right,T1,64,4,-23,-16,-7,"4,-23"
8763,720575940620881867,right,T1,65,-1,28,15,13,"-1,28"
8764,720575940637739888,right,T1,66,2,15,5,10,"2,15"
8765,720575940626997541,right,T1,67,-2,-13,-5,-8,"-2,-13"
8766,720575940624684552,right,T1,68,3,16,5,11,"3,16"
8767,720575940646913827,right,T1,71,-2,-3,0,-3,"-2,-3"
8768,720575940621793263,right,T1,72,0,-28,-14,-14,"0,-28"
8769,720575940620179649,right,T1,73,2,2,-1,3,"2,2"
8770,720575940621999871,right,T1,74,-1,-9,-4,-5,"-1,-9"
8771,720575940621170968,right,T1,75,-6,14,13,1,"-6,14"
8772,720575940621017765,right,T1,76,-3,-4,1,-5,"-3,-4"
8773,720575940628070421,right,T1,77,2,-5,-5,0,"2,-5"
8774,720575940626053390,right,T1,78,2,20,8,12,"2,20"
8775,720575940610817582,right,T1,79,2,1,-2,3,"2,1"
8776,720575940623575295,right,T1,80,4,13,2,11,"4,13"
8777,720575940620793792,right,T1,81,6,-2,-7,5,"6,-2"
8778,720575940614347439,right,T1,82,-7,7,10,-3,"-7,7"
8779,720575940635797343,right,T1,83,2,-21,-13,-8,"2,-21"
8780,720575940645498647,right,T1,84,-2,12,8,4,"-2,12"
8781,720575940628693777,right,T1,85,4,-22,-15,-7,"4,-22"
8782,720575940606064416,right,T1,86,-5,-7,1,-8,"-5,-7"
8783,720575940616405554,right,T1,87,1,11,4,7,"1,11"
8784,720575940620863367,right,T1,89,1,-19,-11,-8,"1,-19"
8785,720575940623963747,right,T1,90,-4,5,6,-1,"-4,5"
8786,720575940644052128,right,T1,91,-1,6,4,2,"-1,6"
8787,720575940625488136,right,T1,93,-6,3,7,-4,"-6,3"
8788,720575940636870757,right,T1,94,5,18,4,14,"5,18"
8789,720575940623961385,right,T1,95,4,-21,-15,-6,"4,-21"
8790,720575940629098758,right,T1,96,1,-10,-6,-4,"1,-10"
8791,720575940619654454,right,T1,97,-5,2,6,-4,"-5,2"
8792,720575940640668733,right,T1,98,-1,-12,-5,-7,"-1,-12"
8793,720575940647710516,right,T1,99,4,15,3,12,"4,15"
8794,720575940637308261,right,T1,100,2,-10,-7,-3,"2,-10"
8795,720575940611333654,right,T1,101,-7,6,10,-4,"-7,6"
8796,720575940626921244,right,T1,102,3,13,3,10,"3,13"
8797,720575940637977828,right,T1,103,7,9,-3,12,"7,9"
8798,720575940629333489,right,T1,104,-1,-27,-13,-14,"-1,-27"
8799,720575940625031975,right,T1,105,3,22,8,14,"3,22"
8800,720575940631392364,right,T1,106,-7,11,12,-1,"-7,11"
8801,720575940619603358,right,T1,107,8,-2,-9,7,"8,-2"
8802,720575940626916739,right,T1,108,-3,-12,-3,-9,"-3,-12"
8803,720575940611450978,right,T1,109,4,-5,-7,2,"4,-5"
8804,720575940636321387,right,T1,110,-7,0,7,-7,"-7,0"
8805,720575940630919163,right,T1,111,2,-24,-14,-10,"2,-24"
8806,720575940633345567,right,T1,112,-6,1,6,-5,"-6,1"
8807,720575940624711916,right,T1,113,-2,4,4,0,"-2,4"
8808,720575940614604650,right,T1,114,2,-13,-9,-4,"2,-13"
8809,720575940633004079,right,T1,115,-4,2,5,-3,"-4,2"
8810,720575940622082657,right,T1,116,-1,-8,-3,-5,"-1,-8"
8811,720575940638766426,right,T1,117,-8,-2,7,-9,"-8,-2"
8812,720575940623871940,right,T1,118,3,1,-3,4,"3,1"
8813,720575940621726191,right,T1,120,-1,-1,0,-1,"-1,-1"
8814,720575940629012431,right,T1,121,-8,4,10,-6,"-8,4"
8815,720575940618819974,right,T1,122,-5,9,9,0,"-5,9"
8816,720575940612536785,right,T1,123,-8,10,13,-3,"-8,10"
8817,720575940616020886,right,T1,124,1,-7,-5,-2,"1,-7"
8818,720575940624859213,right,T1,125,5,9,-1,10,"5,9"
8819,720575940627831122,right,T1,126,3,11,2,9,"3,11"
8820,720575940631427535,right,T1,127,0,15,7,8,"0,15"
8821,720575940606584241,right,T1,128,3,-22,-14,-8,"3,-22"
8822,720575940626985478,right,T1,129,0,-13,-7,-6,"0,-13"
8823,720575940629418345,right,T1,130,2,12,4,8,"2,12"
8824,720575940620967700,right,T1,131,-6,20,16,4,"-6,20"
8825,720575940641868429,right,T1,132,2,4,0,4,"2,4"
8826,720575940615419047,right,T1,133,-3,20,13,7,"-3,20"
8827,720575940632952204,right,T1,134,-5,-18,-4,-14,"-5,-18"
8828,720575940624116715,right,T1,135,-3,-22,-8,-14,"-3,-22"
8829,720575940619763847,right,T1,136,0,3,1,2,"0,3"
8830,720575940627548285,right,T1,137,5,-7,-9,2,"5,-7"
8831,720575940632489017,right,T1,138,0,27,13,14,"0,27"
8832,720575940615351914,right,T1,139,1,-14,-8,-6,"1,-14"
8833,720575940622753050,right,T1,140,3,8,1,7,"3,8"
8834,720575940628831818,right,T1,142,-2,-18,-7,-11,"-2,-18"
8835,720575940640512627,right,T1,144,7,-11,-13,2,"7,-11"
8836,720575940623073050,right,T1,146,1,-6,-4,-2,"1,-6"
8837,720575940615465322,right,T1,147,1,21,9,12,"1,21"
8838,720575940624665834,right,T1,148,-7,-11,1,-12,"-7,-11"
8839,720575940631283287,right,T1,149,6,-14,-13,-1,"6,-14"
8840,720575940612304179,right,T1,150,-8,5,10,-5,"-8,5"
8841,720575940640518528,right,T1,151,-3,-14,-4,-10,"-3,-14"
8842,720575940636798831,right,T1,152,3,-15,-11,-4,"3,-15"
8843,720575940622873844,right,T1,153,8,0,-8,8,"8,0"
8844,720575940639126249,right,T1,154,-8,0,8,-8,"-8,0"
8845,720575940639119824,right,T1,155,-8,13,14,-1,"-8,13"
8846,720575940648488580,right,T1,156,-9,1,9,-8,"-9,1"
8847,720575940646784035,right,T1,157,-1,-7,-3,-4,"-1,-7"
8848,720575940626851100,right,T1,158,3,-5,-6,1,"3,-5"
8849,720575940623730957,right,T1,160,-2,20,12,8,"-2,20"
8850,720575940626854288,right,T1,161,4,-14,-11,-3,"4,-14"
8851,720575940610903342,right,T1,162,-4,-2,3,-5,"-4,-2"
8852,720575940639631942,right,T1,163,-9,7,12,-5,"-9,7"
8853,720575940645318423,right,T1,164,-1,-2,0,-2,"-1,-2"
8854,720575940611791878,right,T1,165,4,16,4,12,"4,16"
8855,720575940635312831,right,T1,166,0,18,9,9,"0,18"
8856,720575940617001915,right,T1,167,0,-17,-9,-8,"0,-17"
8857,720575940617208459,right,T1,168,-1,17,9,8,"-1,17"
8858,720575940632479815,right,T1,169,0,-18,-9,-9,"0,-18"
8859,720575940625371650,right,T1,170,-5,1,5,-4,"-5,1"
8860,720575940631947538,right,T1,171,6,-20,-16,-4,"6,-20"
8861,720575940623558413,right,T1,172,1,22,10,12,"1,22"
8862,720575940608048770,right,T1,173,2,-25,-15,-10,"2,-25"
8863,720575940637490544,right,T1,174,4,-15,-12,-3,"4,-15"
8864,720575940630927164,right,T1,175,-6,-7,2,-9,"-6,-7"
8865,720575940624217075,right,T1,176,-2,13,8,5,"-2,13"
8866,720575940629288451,right,T1,177,-2,-1,1,-2,"-2,-1"
8867,720575940624606537,right,T1,178,2,11,3,8,"2,11"
8868,720575940633928787,right,T1,179,-5,-16,-3,-13,"-5,-16"
8869,720575940621197294,right,T1,180,2,-27,-16,-11,"2,-27"
8870,720575940620154021,right,T1,181,1,-4,-3,-1,"1,-4"
8871,720575940627687762,right,T1,182,7,-10,-12,2,"7,-10"
8872,720575940632794415,right,T1,183,-5,-15,-3,-12,"-5,-15"
8873,720575940614334504,right,T1,184,-6,-5,3,-8,"-6,-5"
8874,720575940631472146,right,T1,185,2,-11,-8,-3,"2,-11"
8875,720575940612940506,right,T1,186,-1,26,14,12,"-1,26"
8876,720575940609614601,right,T1,187,3,21,7,14,"3,21"
8877,720575940629692715,right,T1,188,-5,17,13,4,"-5,17"
8878,720575940638833636,right,T1,189,6,13,0,13,"6,13"
8879,720575940627217941,right,T1,190,-3,-5,0,-5,"-3,-5"
8880,720575940612645618,right,T1,191,-1,-11,-5,-6,"-1,-11"
8881,720575940628500228,right,T1,192,7,10,-2,12,"7,10"
8882,720575940648519556,right,T1,193,-5,4,7,-3,"-5,4"
8883,720575940624155597,right,T1,194,0,-5,-3,-2,"0,-5"
8884,720575940621489390,right,T1,195,-3,-1,2,-3,"-3,-1"
8885,720575940622040486,right,T1,196,-1,8,5,3,"-1,8"
8886,720575940632209209,right,T1,197,0,-20,-10,-10,"0,-20"
8887,720575940635695039,right,T1,198,6,2,-5,7,"6,2"
8888,720575940631482476,right,T1,199,0,-12,-6,-6,"0,-12"
8889,720575940614945843,right,T1,200,-5,12,11,1,"-5,12"
8890,720575940617358267,right,T1,201,-8,9,12,-3,"-8,9"
8891,720575940630678007,right,T1,202,-1,27,14,13,"-1,27"
8892,720575940609509385,right,T1,203,3,-1,-4,3,"3,-1"
8893,720575940613381785,right,T1,204,5,-2,-6,4,"5,-2"
8894,720575940618047296,right,T1,205,5,-6,-8,2,"5,-6"
8895,720575940616753809,right,T1,206,-3,5,5,0,"-3,5"
8896,720575940617703563,right,T1,207,1,29,13,16,"1,29"
8897,720575940637295991,right,T1,208,5,-21,-16,-5,"5,-21"
8898,720575940614733521,right,T1,209,-3,-8,-1,-7,"-3,-8"
8899,720575940606279782,right,T1,210,-6,8,10,-2,"-6,8"
8900,720575940631410939,right,T1,211,-7,-1,6,-7,"-7,-1"
8901,720575940623151393,right,T1,212,2,-16,-10,-6,"2,-16"
8902,720575940607180162,right,T1,213,3,-4,-5,1,"3,-4"
8903,720575940615604842,right,T1,214,-5,3,6,-3,"-5,3"
8904,720575940638554175,right,T1,216,2,19,7,12,"2,19"
8905,720575940631527887,right,T1,217,6,15,1,14,"6,15"
8906,720575940631217196,right,T1,218,2,10,3,7,"2,10"
8907,720575940636785775,right,T1,219,6,-4,-8,4,"6,-4"
8908,720575940611302293,right,T1,220,2,-6,-5,-1,"2,-6"
8909,720575940629598449,right,T1,221,-7,3,8,-5,"-7,3"
8910,720575940625435687,right,T1,222,-3,26,16,10,"-3,26"
8911,720575940629653547,right,T1,223,-2,26,15,11,"-2,26"
8912,720575940627297155,right,T1,224,0,5,2,3,"0,5"
8913,720575940623779864,right,T1,225,2,-26,-15,-11,"2,-26"
8914,720575940612135118,right,T1,226,5,19,4,15,"5,19"
8915,720575940620039429,right,T1,227,-7,5,9,-4,"-7,5"
8916,720575940623347043,right,T1,228,-7,1,7,-6,"-7,1"
8917,720575940611847958,right,T1,229,5,2,-4,6,"5,2"
8918,720575940623973133,right,T1,230,2,9,2,7,"2,9"
8919,720575940628294888,right,T1,231,4,-12,-10,-2,"4,-12"
8920,720575940608081842,right,T1,233,4,-13,-11,-2,"4,-13"
8921,720575940607641801,right,T1,234,1,3,0,3,"1,3"
8922,720575940640413091,right,T1,235,4,11,1,10,"4,11"
8923,720575940629749607,right,T1,236,-1,4,3,1,"-1,4"
8924,720575940624293768,right,T1,237,-2,27,15,12,"-2,27"
8925,720575940632140586,right,T1,238,-8,-3,6,-9,"-8,-3"
8926,720575940623207950,right,T1,239,-6,6,9,-3,"-6,6"
8927,720575940615010814,right,T1,240,-4,-3,2,-5,"-4,-3"
8928,720575940614955451,right,T1,241,2,-17,-11,-6,"2,-17"
8929,720575940614246559,right,T1,242,-4,6,7,-1,"-4,6"
8930,720575940640382525,right,T1,243,-1,-21,-10,-11,"-1,-21"
8931,720575940619383109,right,T1,244,-4,-12,-2,-10,"-4,-12"
8932,720575940623642845,right,T1,245,-5,-3,3,-6,"-5,-3"
8933,720575940625109995,right,T1,246,-4,15,11,4,"-4,15"
8934,720575940621760355,right,T1,247,-4,-15,-4,-11,"-4,-15"
8935,720575940618066617,right,T1,248,-6,0,6,-6,"-6,0"
8936,720575940642723469,right,T1,249,2,-12,-8,-4,"2,-12"
8937,720575940608745923,right,T1,250,-1,1,1,0,"-1,1"
8938,720575940617571545,right,T1,251,-1,-14,-6,-8,"-1,-14"
8939,720575940633100615,right,T1,252,3,23,8,15,"3,23"
8940,720575940638829658,right,T1,253,5,16,3,13,"5,16"
8941,720575940628791880,right,T1,254,3,-24,-15,-9,"3,-24"
8942,720575940633887533,right,T1,255,-6,-13,-1,-12,"-6,-13"
8943,720575940635325792,right,T1,256,5,-20,-15,-5,"5,-20"
8944,720575940615721695,right,T1,257,2,21,8,13,"2,21"
8945,720575940629066236,right,T1,258,-4,-17,-5,-12,"-4,-17"
8946,720575940624909309,right,T1,259,-7,-5,4,-9,"-7,-5"
8947,720575940613213682,right,T1,260,-3,19,12,7,"-3,19"
8948,720575940627626885,right,T1,261,-1,13,7,6,"-1,13"
8949,720575940635770975,right,T1,262,1,-11,-7,-4,"1,-11"
8950,720575940620926657,right,T1,263,-3,4,5,-1,"-3,4"
8951,720575940625011300,right,T1,264,-1,-6,-2,-4,"-1,-6"
8952,720575940616212934,right,T1,265,-6,-1,5,-6,"-6,-1"
8953,720575940614703597,right,T1,266,-1,-25,-12,-13,"-1,-25"
8954,720575940634458010,right,T1,267,-6,2,7,-5,"-6,2"
8955,720575940618320212,right,T1,268,7,-6,-10,4,"7,-6"
8956,720575940632160460,right,T1,269,2,-19,-12,-7,"2,-19"
8957,720575940634456034,right,T1,270,1,-8,-5,-3,"1,-8"
8958,720575940633371417,right,T1,271,4,6,-1,7,"4,6"
8959,720575940613807466,right,T1,272,3,-2,-4,2,"3,-2"
8960,720575940611938258,right,T1,273,-6,23,17,6,"-6,23"
8961,720575940619131675,right,T1,275,-8,-1,7,-8,"-8,-1"
8962,720575940611050052,right,T1,276,2,3,-1,4,"2,3"
8963,720575940607786882,right,T1,277,7,-3,-9,6,"7,-3"
8964,720575940614207971,right,T1,278,-5,10,10,0,"-5,10"
8965,720575940628007092,right,T1,279,-4,8,8,0,"-4,8"
8966,720575940627425052,right,T1,280,-6,-14,-1,-13,"-6,-14"
8967,720575940624237450,right,T1,281,-9,2,10,-8,"-9,2"
8968,720575940635424959,right,T1,282,0,26,13,13,"0,26"
8969,720575940630433730,right,T1,283,-4,4,6,-2,"-4,4"
8970,720575940630045306,right,T1,284,0,25,12,13,"0,25"
8971,720575940627887891,right,T1,285,6,-18,-15,-3,"6,-18"
8972,720575940621370644,right,T1,286,0,-24,-12,-12,"0,-24"
8973,720575940638036046,right,T1,287,-5,13,11,2,"-5,13"
8974,720575940643345096,right,T1,289,-1,11,6,5,"-1,11"
8975,720575940616738866,right,T1,290,5,-24,-17,-7,"5,-24"
8976,720575940629023750,right,T1,291,7,2,-6,8,"7,2"
8977,720575940608062594,right,T1,292,-4,18,13,5,"-4,18"
8978,720575940633537069,right,T1,293,4,-17,-13,-4,"4,-17"
8979,720575940632977828,right,T1,294,1,-20,-11,-9,"1,-20"
8980,720575940630596919,right,T1,296,1,-18,-10,-8,"1,-18"
8981,720575940640596595,right,T1,297,7,-9,-12,3,"7,-9"
8982,720575940609182556,right,T1,298,-5,5,7,-2,"-5,5"
8983,720575940648108164,right,T1,299,-4,12,10,2,"-4,12"
8984,720575940653287926,right,T1,300,4,-18,-13,-5,"4,-18"
8985,720575940628081683,right,T1,301,-5,16,13,3,"-5,16"
8986,720575940605487974,right,T1,302,2,17,6,11,"2,17"
8987,720575940615724729,right,T1,303,-5,22,16,6,"-5,22"
8988,720575940625304764,right,T1,305,-7,4,9,-5,"-7,4"
8989,720575940628119313,right,T1,306,3,7,0,7,"3,7"
8990,720575940618040157,right,T1,307,5,-25,-18,-7,"5,-25"
8991,720575940633734366,right,T1,308,-5,8,9,-1,"-5,8"
8992,720575940618043185,right,T1,309,-6,12,12,0,"-6,12"
8993,720575940615629418,right,T1,310,2,22,9,13,"2,22"
8994,720575940631109371,right,T1,311,-7,15,14,1,"-7,15"
8995,720575940628742472,right,T1,312,4,-7,-8,1,"4,-7"
8996,720575940622278325,right,T1,314,-9,5,11,-6,"-9,5"
8997,720575940623733709,right,T1,315,-3,-6,0,-6,"-3,-6"
8998,720575940621799407,right,T1,316,5,-4,-7,3,"5,-4"
8999,720575940610383684,right,T1,317,-5,-4,3,-7,"-5,-4"
9000,720575940629547280,right,T1,318,4,-19,-14,-5,"4,-19"
9001,720575940635302300,right,T1,319,-2,5,4,1,"-2,5"
9002,720575940621073391,right,T1,320,-2,-5,-1,-4,"-2,-5"
9003,720575940609106012,right,T1,322,2,26,11,15,"2,26"
9004,720575940616132057,right,T1,323,-7,-13,0,-13,"-7,-13"
9005,720575940632817000,right,T1,324,3,24,9,15,"3,24"
9006,720575940609792451,right,T1,326,2,16,6,10,"2,16"
9007,720575940628620806,right,T1,328,5,-9,-10,1,"5,-9"
9008,720575940648661124,right,T1,329,0,24,12,12,"0,24"
9009,720575940628777288,right,T1,330,3,3,-2,5,"3,3"
9010,720575940633687460,right,T1,331,1,-15,-9,-6,"1,-15"
9011,720575940632373290,right,T1,332,4,-26,-17,-9,"4,-26"
9012,720575940612597617,right,T1,333,0,-21,-11,-10,"0,-21"
9013,720575940620597707,right,T1,334,1,-26,-14,-12,"1,-26"
9014,720575940622537855,right,T1,335,2,8,2,6,"2,8"
9015,720575940636655215,right,T1,336,0,23,11,12,"0,23"
9016,720575940623742051,right,T1,337,-5,-6,2,-8,"-5,-6"
9017,720575940622355592,right,T1,338,-1,0,1,-1,"-1,0"
9018,720575940645616420,right,T1,339,6,11,-1,12,"6,11"
9019,720575940623451687,right,T1,341,6,-17,-15,-2,"6,-17"
9020,720575940616571846,right,T1,342,2,-15,-10,-5,"2,-15"
9021,720575940634446818,right,T1,344,-2,-15,-6,-9,"-2,-15"
9022,720575940621044463,right,T1,345,3,-12,-9,-3,"3,-12"
9023,720575940639632181,right,T1,346,-7,-9,2,-11,"-7,-9"
9024,720575940608835164,right,T1,347,-5,-13,-2,-11,"-5,-13"
9025,720575940633846061,right,T1,348,3,14,4,10,"3,14"
9026,720575940627089252,right,T1,349,-5,-14,-2,-12,"-5,-14"
9027,720575940644228000,right,T1,350,1,15,6,9,"1,15"
9028,720575940622605044,right,T1,351,-1,-17,-8,-9,"-1,-17"
9029,720575940634806297,right,T1,352,-2,28,16,12,"-2,28"
9030,720575940635016288,right,T1,353,2,24,10,14,"2,24"
9031,720575940624365508,right,T1,354,-2,-26,-11,-15,"-2,-26"
9032,720575940625943827,right,T1,355,-7,-6,4,-10,"-7,-6"
9033,720575940616450278,right,T1,356,0,22,11,11,"0,22"
9034,720575940612987029,right,T1,357,4,17,4,13,"4,17"
9035,720575940618489318,right,T1,358,-3,17,11,6,"-3,17"
9036,720575940621060033,right,T1,359,2,23,9,14,"2,23"
9037,720575940612672986,right,T1,360,-5,19,14,5,"-5,19"
9038,720575940610349892,right,T1,361,0,-7,-4,-3,"0,-7"
9039,720575940629337418,right,T1,362,2,-20,-12,-8,"2,-20"
9040,720575940625094670,right,T1,363,7,-4,-9,5,"7,-4"
9041,720575940627537095,right,T1,364,4,4,-2,6,"4,4"
9042,720575940632247823,right,T1,365,4,7,-1,8,"4,7"
9043,720575940619096349,right,T1,366,-5,-20,-5,-15,"-5,-20"
9044,720575940613185715,right,T1,367,-6,-15,-2,-13,"-6,-15"
9045,720575940621100629,right,T1,368,-4,-20,-6,-14,"-4,-20"
9046,720575940622583813,right,T1,369,5,-5,-8,3,"5,-5"
9047,720575940635582827,right,T1,370,-3,21,13,8,"-3,21"
9048,720575940607506050,right,T1,371,6,-5,-9,4,"6,-5"
9049,720575940645153047,right,T1,372,1,-2,-2,0,"1,-2"
9050,720575940633289517,right,T1,373,1,-21,-12,-9,"1,-21"
9051,720575940626920988,right,T1,374,2,13,4,9,"2,13"
9052,720575940615985311,right,T1,375,-6,7,9,-2,"-6,7"
9053,720575940606066208,right,T1,376,-7,-10,2,-12,"-7,-10"
9054,720575940621740653,right,T1,377,0,7,3,4,"0,7"
9055,720575940608506325,right,T1,379,3,-17,-12,-5,"3,-17"
9056,720575940627295875,right,T1,380,-1,29,15,14,"-1,29"
9057,720575940632175435,right,T1,381,-8,-9,3,-12,"-8,-9"
9058,720575940633234991,right,T1,382,3,-6,-6,0,"3,-6"
9059,720575940626796905,right,T1,383,-6,11,11,0,"-6,11"
9060,720575940629613809,right,T1,384,-6,-2,5,-7,"-6,-2"
9061,720575940628563530,right,T1,385,-3,-18,-6,-12,"-3,-18"
9062,720575940621098069,right,T1,386,-6,19,15,4,"-6,19"
9063,720575940617393781,right,T1,387,-1,-15,-7,-8,"-1,-15"
9064,720575940647083811,right,T1,388,3,19,6,13,"3,19"
9065,720575940627284410,right,T1,389,-6,-16,-2,-14,"-6,-16"
9066,720575940628931856,right,T1,390,-6,-9,1,-10,"-6,-9"
9067,720575940632617043,right,T1,391,4,-3,-6,3,"4,-3"
9068,720575940632377106,right,T1,392,-4,7,7,0,"-4,7"
9069,720575940631755339,right,T1,393,-1,22,12,10,"-1,22"
9070,720575940640056509,right,T1,394,-7,-8,3,-11,"-7,-8"
9071,720575940624310453,right,T1,395,0,-22,-11,-11,"0,-22"
9072,720575940624471223,right,T1,396,-1,10,6,4,"-1,10"
9073,720575940623421389,right,T1,397,-3,-19,-7,-12,"-3,-19"
9074,720575940618971163,right,T1,398,-3,22,14,8,"-3,22"
9075,720575940621344677,right,T1,399,-4,-24,-8,-16,"-4,-24"
9076,720575940620619173,right,T1,401,-2,-19,-8,-11,"-2,-19"
9077,720575940625339635,right,T1,402,3,26,10,16,"3,26"
9078,720575940624336787,right,T1,403,-2,-12,-4,-8,"-2,-12"
9079,720575940606268081,right,T1,404,-1,20,11,9,"-1,20"
9080,720575940629582491,right,T1,405,3,10,2,8,"3,10"
9081,720575940614231336,right,T1,406,1,-25,-14,-11,"1,-25"
9082,720575940631629354,right,T1,407,-5,-10,0,-10,"-5,-10"
9083,720575940623142157,right,T1,408,-6,-4,4,-8,"-6,-4"
9084,720575940617582593,right,T1,409,0,-3,-2,-1,"0,-3"
9085,720575940634612576,right,T1,410,-2,-2,1,-3,"-2,-2"
9086,720575940632344034,right,T1,411,-5,-19,-5,-14,"-5,-19"
9087,720575940635339694,right,T1,412,-6,21,16,5,"-6,21"
9088,720575940630641143,right,T1,413,-2,-7,-2,-5,"-2,-7"
9089,720575940629511785,right,T1,414,4,21,6,15,"4,21"
9090,720575940619712670,right,T1,415,6,12,0,12,"6,12"
9091,720575940621306816,right,T1,416,3,-8,-7,-1,"3,-8"
9092,720575940617380928,right,T1,417,-6,-10,1,-11,"-6,-10"
9093,720575940621844801,right,T1,419,-3,-11,-3,-8,"-3,-11"
9094,720575940618778960,right,T1,420,6,-3,-8,5,"6,-3"
9095,720575940629834395,right,T1,421,-1,12,7,5,"-1,12"
9096,720575940622877729,right,T1,422,-7,-4,5,-9,"-7,-4"
9097,720575940612690394,right,T1,423,3,-18,-12,-6,"3,-18"
9098,720575940611076194,right,T1,424,-3,-2,2,-4,"-3,-2"
9099,720575940611425122,right,T1,425,3,20,7,13,"3,20"
9100,720575940618723653,right,T1,426,-3,0,3,-3,"-3,0"
9101,720575940629562609,right,T1,427,5,-18,-14,-4,"5,-18"
9102,720575940633880621,right,T1,428,-2,23,13,10,"-2,23"
9103,720575940631522811,right,T1,429,-2,14,9,5,"-2,14"
9104,720575940617468811,right,T1,430,-3,-7,-1,-6,"-3,-7"
9105,720575940626732163,right,T1,431,-2,-10,-3,-7,"-2,-10"
9106,720575940638227072,right,T1,432,-5,7,8,-1,"-5,7"
9107,720575940627366518,right,T1,433,0,-8,-4,-4,"0,-8"
9108,720575940616762054,right,T1,434,-3,7,6,1,"-3,7"
9109,720575940620855431,right,T1,435,5,-17,-14,-3,"5,-17"
9110,720575940613553891,right,T1,436,0,-15,-8,-7,"0,-15"
9111,720575940639054707,right,T1,437,-3,12,9,3,"-3,12"
9112,720575940623733272,right,T1,438,2,27,11,16,"2,27"
9113,720575940628960455,right,T1,439,-3,-9,-2,-7,"-3,-9"
9114,720575940626338608,right,T1,440,1,23,10,13,"1,23"
9115,720575940616157638,right,T1,441,3,-16,-11,-5,"3,-16"
9116,720575940627746181,right,T1,442,-5,25,17,8,"-5,25"
9117,720575940645044788,right,T1,443,-6,4,8,-4,"-6,4"
9118,720575940614238639,right,T1,444,4,-10,-9,-1,"4,-10"
9119,720575940624877129,right,T1,445,-2,8,6,2,"-2,8"
9120,720575940616998412,right,T1,446,2,-14,-9,-5,"2,-14"
9121,720575940622550566,right,T1,447,-1,2,2,0,"-1,2"
9122,720575940628724721,right,T1,449,6,-16,-14,-2,"6,-16"
9123,720575940616528571,right,T1,450,2,-9,-7,-2,"2,-9"
9124,720575940630963800,right,T1,451,4,20,6,14,"4,20"
9125,720575940621558767,right,T1,452,1,-9,-6,-3,"1,-9"
9126,720575940618843037,right,T1,454,5,-12,-11,-1,"5,-12"
9127,720575940621347243,right,T1,455,7,-7,-11,4,"7,-7"
9128,720575940621398255,right,T1,456,0,21,10,11,"0,21"
9129,720575940630178048,right,T1,458,5,0,-5,5,"5,0"
9130,720575940639070527,right,T1,459,5,-3,-7,4,"5,-3"
9131,720575940653199094,right,T1,460,-3,-20,-7,-13,"-3,-20"
9132,720575940613095642,right,T1,461,7,-5,-10,5,"7,-5"
9133,720575940626986558,right,T1,462,-1,18,10,8,"-1,18"
9134,720575940612655027,right,T1,463,5,17,3,14,"5,17"
9135,720575940625183502,right,T1,464,4,0,-4,4,"4,0"
9136,720575940621148654,right,T1,465,3,0,-3,3,"3,0"
9137,720575940632854423,right,T1,466,1,14,6,8,"1,14"
9138,720575940626462339,right,T1,467,-2,-20,-8,-12,"-2,-20"
9139,720575940633527460,right,T1,468,-3,11,8,3,"-3,11"
9140,720575940624936373,right,T1,469,-7,13,13,0,"-7,13"
9141,720575940621586523,right,T1,470,4,-9,-9,0,"4,-9"
9142,720575940624021759,right,T1,471,3,-26,-16,-10,"3,-26"
9143,720575940630793788,right,T1,472,1,25,11,14,"1,25"
9144,720575940628944616,right,T1,473,-4,23,15,8,"-4,23"
9145,720575940614391347,right,T1,475,-4,-1,3,-4,"-4,-1"
9146,720575940619746213,right,T1,476,-1,15,8,7,"-1,15"
9147,720575940618827165,right,T1,477,-3,2,4,-2,"-3,2"
9148,720575940616885721,right,T1,478,-7,16,15,1,"-7,16"
9149,720575940628142906,right,T1,480,3,-19,-13,-6,"3,-19"
9150,720575940627321150,right,T1,481,4,-8,-8,0,"4,-8"
9151,720575940635231383,right,T1,482,1,17,7,10,"1,17"
9152,720575940632871225,right,T1,483,2,-7,-6,-1,"2,-7"
9153,720575940620492679,right,T1,484,3,-9,-8,-1,"3,-9"
9154,720575940638805850,right,T1,485,-3,-3,1,-4,"-3,-3"
9155,720575940644014792,right,T1,486,0,1,0,1,"0,1"
9156,720575940624842760,right,T1,487,1,-1,-2,1,"1,-1"
9157,720575940628504337,right,T1,489,-3,10,8,2,"-3,10"
9158,720575940605240544,right,T1,490,-5,6,8,-2,"-5,6"
9159,720575940624286404,right,T1,491,7,-1,-8,7,"7,-1"
9160,720575940624144784,right,T1,492,-7,-2,6,-8,"-7,-2"
9161,720575940632355659,right,T1,493,-3,23,14,9,"-3,23"
9162,720575940640788131,right,T1,494,0,29,14,15,"0,29"
9163,720575940631843858,right,T1,497,6,1,-6,7,"6,1"
9164,720575940620016856,right,T1,498,6,10,-1,11,"6,10"
9165,720575940615921474,right,T1,500,7,-8,-11,3,"7,-8"
9166,720575940622377142,right,T1,501,1,2,0,2,"1,2"
9167,720575940617298363,right,T1,503,3,17,5,12,"3,17"
9168,720575940638447838,right,T1,504,-2,9,6,3,"-2,9"
9169,720575940631393785,right,T1,505,6,-22,-17,-5,"6,-22"
9170,720575940648331140,right,T1,506,1,-12,-7,-5,"1,-12"
9171,720575940617858534,right,T1,507,-5,-12,-1,-11,"-5,-12"
9172,720575940636370287,right,T1,508,-5,11,10,1,"-5,11"
9173,720575940622348214,right,T1,509,-4,10,9,1,"-4,10"
9174,720575940619753307,right,T1,510,-2,11,7,4,"-2,11"
9175,720575940627965982,right,T1,511,5,-11,-11,0,"5,-11"
9176,720575940609554699,right,T1,512,6,0,-6,6,"6,0"
9177,720575940628070568,right,T1,513,-4,-13,-3,-10,"-4,-13"
9178,720575940629438969,right,T1,515,-8,-7,4,-11,"-8,-7"
9179,720575940628056914,right,T1,516,7,-18,-16,-2,"7,-18"
9180,720575940611620046,right,T1,518,-4,22,15,7,"-4,22"
9181,720575940644675232,right,T1,520,-2,-22,-9,-13,"-2,-22"
9182,720575940621222337,right,T1,521,6,-9,-11,2,"6,-9"
9183,720575940627921937,right,T1,522,-4,0,4,-4,"-4,0"
9184,720575940631002071,right,T1,523,2,14,5,9,"2,14"
9185,720575940625454055,right,T1,524,4,-20,-14,-6,"4,-20"
9186,720575940627072006,right,T1,525,-1,-20,-9,-11,"-1,-20"
9187,720575940619821105,right,T1,526,0,-10,-5,-5,"0,-10"
9188,720575940638518249,right,T1,527,-4,-8,0,-8,"-4,-8"
9189,720575940613589930,right,T1,528,2,7,1,6,"2,7"
9190,720575940627511556,right,T1,529,2,-2,-3,1,"2,-2"
9191,720575940640434139,right,T1,530,-3,-13,-4,-9,"-3,-13"
9192,720575940630326267,right,T1,531,1,0,-1,1,"1,0"
9193,720575940632185615,right,T1,532,-8,7,11,-4,"-8,7"
9194,720575940632742713,right,T1,533,0,-16,-8,-8,"0,-16"
9195,720575940627456649,right,T1,534,3,2,-2,4,"3,2"
9196,720575940621944486,right,T1,535,8,-4,-10,6,"8,-4"
9197,720575940614217965,right,T1,536,3,4,-1,5,"3,4"
9198,720575940629905487,right,T1,537,0,-23,-12,-11,"0,-23"
9199,720575940610222805,right,T1,538,-4,1,4,-3,"-4,1"
9200,720575940631329128,right,T1,539,-6,15,13,2,"-6,15"
9201,720575940620076248,right,T1,540,-2,-9,-3,-6,"-2,-9"
9202,720575940619407670,right,T1,541,-4,14,11,3,"-4,14"
9203,720575940612680883,right,T1,542,6,-13,-13,0,"6,-13"
9204,720575940629630823,right,T1,543,-1,-4,-1,-3,"-1,-4"
9205,720575940629647207,right,T1,544,3,-13,-10,-3,"3,-13"
9206,720575940617918609,right,T1,545,5,11,0,11,"5,11"
9207,720575940642620379,right,T1,546,3,6,0,6,"3,6"
9208,720575940628424335,right,T1,547,-1,21,11,10,"-1,21"
9209,720575940626546750,right,T1,548,1,-16,-9,-7,"1,-16"
9210,720575940611771158,right,T1,549,0,-9,-5,-4,"0,-9"
9211,720575940619710191,right,T1,550,-2,3,3,0,"-2,3"
9212,720575940650193529,right,T1,551,-4,-9,-1,-8,"-4,-9"
9213,720575940631595083,right,T1,552,4,-1,-5,4,"4,-1"
9214,720575940638665818,right,T1,554,-9,-3,7,-10,"-9,-3"
9215,720575940628301384,right,T1,555,-4,9,8,1,"-4,9"
9216,720575940633476889,right,T1,556,0,10,5,5,"0,10"
9217,720575940618535097,right,T1,557,6,-10,-11,1,"6,-10"
9218,720575940629863223,right,T1,558,-4,-21,-7,-14,"-4,-21"
9219,720575940615309310,right,T1,559,-6,22,17,5,"-6,22"
9220,720575940638857168,right,T1,560,-7,14,14,0,"-7,14"
9221,720575940642381813,right,T1,561,5,7,-2,9,"5,7"
9222,720575940631673931,right,T1,562,-5,-2,4,-6,"-5,-2"
9223,720575940633104268,right,T1,563,5,-13,-12,-1,"5,-13"
9224,720575940628117562,right,T1,564,3,-23,-15,-8,"3,-23"
9225,720575940618360294,right,T1,565,0,-26,-13,-13,"0,-26"
9226,720575940613142642,right,T1,566,5,-8,-9,1,"5,-8"
9227,720575940623663880,right,T1,567,-2,22,13,9,"-2,22"
9228,720575940625305895,right,T1,568,-6,-8,2,-10,"-6,-8"
9229,720575940637471662,right,T1,570,2,25,10,15,"2,25"
9230,720575940608965899,right,T1,571,0,-14,-7,-7,"0,-14"
9231,720575940612574887,right,T1,572,-8,3,9,-6,"-8,3"
9232,720575940645665156,right,T1,573,4,14,3,11,"4,14"
9233,720575940610867524,right,T1,574,-6,5,8,-3,"-6,5"
9234,720575940618946843,right,T1,575,6,9,-2,11,"6,9"
9235,720575940633296465,right,T1,576,0,28,14,14,"0,28"
9236,720575940635717567,right,T1,577,5,-14,-12,-2,"5,-14"
9237,720575940632230713,right,T1,578,4,-11,-10,-1,"4,-11"
9238,720575940635320986,right,T1,579,-3,-10,-2,-8,"-3,-10"
9239,720575940606794673,right,T1,580,-2,-23,-10,-13,"-2,-23"
9240,720575940612246882,right,T1,581,3,9,1,8,"3,9"
9241,720575940611491538,right,T1,582,-1,23,12,11,"-1,23"
9242,720575940607870386,right,T1,583,3,-25,-16,-9,"3,-25"
9243,720575940629698151,right,T1,584,4,23,7,16,"4,23"
9244,720575940627119178,right,T1,585,-1,-23,-11,-12,"-1,-23"
9245,720575940638460735,right,T1,586,2,18,7,11,"2,18"
9246,720575940635516590,right,T1,587,4,22,7,15,"4,22"
9247,720575940610375492,right,T1,588,1,4,1,3,"1,4"
9248,720575940632536228,right,T1,589,-1,-5,-2,-3,"-1,-5"
9249,720575940631448261,right,T1,591,3,-3,-5,2,"3,-3"
9250,720575940630626807,right,T1,593,3,-14,-10,-4,"3,-14"
9251,720575940632481295,right,T1,594,7,-16,-15,-1,"7,-16"
9252,720575940632254738,right,T1,595,7,-12,-13,1,"7,-12"
9253,720575940644944072,right,T1,596,-4,-16,-4,-12,"-4,-16"
9254,720575940650605689,right,T1,597,4,1,-4,5,"4,1"
9255,720575940619397080,right,T1,598,2,-18,-11,-7,"2,-18"
9256,720575940660909185,right,T1,600,3,-10,-8,-2,"3,-10"
9257,720575940629826295,right,T1,601,1,16,7,9,"1,16"
9258,720575940618145078,right,T1,602,4,-2,-5,3,"4,-2"
9259,720575940633806163,right,T1,604,-6,-17,-3,-14,"-6,-17"
9260,720575940609021705,right,T1,605,3,15,4,11,"3,15"
9261,720575940628350460,right,T1,606,-1,-19,-9,-10,"-1,-19"
9262,720575940620609121,right,T1,607,1,18,8,10,"1,18"
9263,720575940637408357,right,T1,608,1,10,4,6,"1,10"
9264,720575940625438138,right,T1,609,-2,0,2,-2,"-2,0"
9265,720575940628142664,right,T1,610,2,-23,-14,-9,"2,-23"
9266,720575940615327082,right,T1,611,-1,-18,-8,-10,"-1,-18"
9267,720575940623614344,right,T1,612,-3,-26,-10,-16,"-3,-26"
9268,720575940661199745,right,T1,613,-8,-4,6,-10,"-8,-4"
9269,720575940614834942,right,T1,614,-2,-8,-2,-6,"-2,-8"
9270,720575940618243585,right,T1,615,-7,-7,3,-10,"-7,-7"
9271,720575940618098617,right,T1,616,-3,15,10,5,"-3,15"
9272,720575940633353367,right,T1,617,-2,-17,-7,-10,"-2,-17"
9273,720575940625545624,right,T1,618,-1,24,13,11,"-1,24"
9274,720575940624070680,right,T1,619,-4,-19,-6,-13,"-4,-19"
9275,720575940625885840,right,T1,620,7,1,-7,8,"7,1"
9276,720575940625535987,right,T1,621,1,24,11,13,"1,24"
9277,720575940628487445,right,T1,622,-5,20,15,5,"-5,20"
9278,720575940626566986,right,T1,623,1,13,5,8,"1,13"
9279,720575940646266478,right,T1,624,1,-17,-10,-7,"1,-17"
9280,720575940618974533,right,T1,625,-2,24,14,10,"-2,24"
9281,720575940619010112,right,T1,626,-5,-8,1,-9,"-5,-8"
9282,720575940627523861,right,T1,627,0,-1,-1,0,"0,-1"
9283,720575940631530747,right,T1,628,0,0,0,0,"0,0"
9284,720575940631351291,right,T1,629,4,24,8,16,"4,24"
9285,720575940630030235,right,T1,630,4,8,0,8,"4,8"
9286,720575940624205546,right,T1,631,1,26,12,14,"1,26"
9287,720575940619525456,right,T1,632,3,-20,-13,-7,"3,-20"
9288,720575940628007506,right,T1,633,-1,-24,-11,-13,"-1,-24"
9289,720575940622040673,right,T1,634,-3,-15,-5,-10,"-3,-15"
9290,720575940605634784,right,T1,635,6,-6,-9,3,"6,-6"
9291,720575940626861370,right,T1,636,0,6,3,3,"0,6"
9292,720575940628381829,right,T1,637,3,-21,-14,-7,"3,-21"
9293,720575940613201834,right,T1,638,-1,7,4,3,"-1,7"
9294,720575940612061337,right,T1,639,-4,19,13,6,"-4,19"
9295,720575940630757583,right,T1,640,-1,-16,-7,-9,"-1,-16"
9296,720575940635303580,right,T1,641,-8,-5,5,-10,"-8,-5"
9297,720575940628882506,right,T1,642,-5,-11,-1,-10,"-5,-11"
9298,720575940660495233,right,T1,643,6,14,1,13,"6,14"
9299,720575940622521323,right,T1,644,-6,18,15,3,"-6,18"
9300,720575940630780727,right,T1,645,-4,27,17,10,"-4,27"
9301,720575940632658463,right,T1,646,6,17,2,15,"6,17"
9302,720575940623265123,right,T1,647,-4,-7,0,-7,"-4,-7"
9303,720575940623546589,right,T1,648,1,7,2,5,"1,7"
9304,720575940620092539,right,T1,650,-3,-25,-10,-15,"-3,-25"
9305,720575940639977461,right,T1,651,-4,-5,1,-6,"-4,-5"
9306,720575940632905263,right,T1,652,-6,-11,0,-11,"-6,-11"
9307,720575940611568942,right,T1,653,-6,-12,0,-12,"-6,-12"
9308,720575940655123361,right,T1,654,-3,8,7,1,"-3,8"
9309,720575940612854806,right,T1,655,6,-1,-7,6,"6,-1"
9310,720575940652858870,right,T1,656,0,-11,-6,-5,"0,-11"
9311,720575940621464747,right,T1,657,-2,-25,-11,-14,"-2,-25"
9312,720575940628712903,right,T1,658,1,20,9,11,"1,20"
9313,720575940619066369,right,T1,659,-4,-6,1,-7,"-4,-6"
9314,720575940614994863,right,T1,661,-3,14,10,4,"-3,14"
9315,720575940611288689,right,T1,662,2,-1,-3,2,"2,-1"
9316,720575940623950600,right,T1,663,0,8,4,4,"0,8"
9317,720575940628988668,right,T1,664,1,-27,-15,-12,"1,-27"
9318,720575940606421536,right,T1,665,7,-2,-8,6,"7,-2"
9319,720575940628135305,right,T1,667,1,-28,-15,-13,"1,-28"
9320,720575940641326032,right,T1,668,1,19,8,11,"1,19"
9321,720575940628267786,right,T1,669,4,-16,-12,-4,"4,-16"
9322,720575940620140958,right,T1,671,-4,-23,-8,-15,"-4,-23"
9323,720575940615688594,right,T1,672,-8,11,13,-2,"-8,11"
9324,720575940613645682,right,T1,673,2,5,0,5,"2,5"
9325,720575940614144818,right,T1,674,-4,-14,-3,-11,"-4,-14"
9326,720575940626458876,right,T1,675,-7,19,16,3,"-7,19"
9327,720575940645625892,right,T1,676,-3,-21,-8,-13,"-3,-21"
9328,720575940625486996,right,T1,677,0,11,5,6,"0,11"
9329,720575940624583753,right,T1,678,3,-7,-7,0,"3,-7"
9330,720575940612401839,right,T1,679,4,18,5,13,"4,18"
9331,720575940636686191,right,T1,680,-1,25,13,12,"-1,25"
9332,720575940626433829,right,T1,681,-2,-21,-9,-12,"-2,-21"
9333,720575940638200297,right,T1,682,6,-8,-10,2,"6,-8"
9334,720575940640144974,right,T1,683,2,6,1,5,"2,6"
9335,720575940630609196,right,T1,685,-5,-9,0,-9,"-5,-9"
9336,720575940620866763,right,T1,686,5,-22,-16,-6,"5,-22"
9337,720575940626431690,right,T1,687,-6,-3,4,-7,"-6,-3"
9338,720575940618053067,right,T1,688,-7,10,12,-2,"-7,10"
9339,720575940614625320,right,T1,690,-7,-3,5,-8,"-7,-3"
9340,720575940634935470,right,T1,691,-9,4,11,-7,"-9,4"
9341,720575940631632715,right,T1,692,-4,24,16,8,"-4,24"
9342,720575940629464875,right,T1,693,-3,25,15,10,"-3,25"
9343,720575940634586338,right,T1,694,4,3,-3,6,"4,3"
9344,720575940625186312,right,T1,695,-6,10,11,-1,"-6,10"
9345,720575940627185508,right,T1,696,-2,16,10,6,"-2,16"
9346,720575940618701339,right,T1,697,1,-22,-12,-10,"1,-22"
9347,720575940631250492,right,T1,698,6,-7,-10,3,"6,-7"
9348,720575940611421702,right,T1,700,5,15,2,13,"5,15"
9349,720575940638999997,right,T1,701,0,-4,-2,-2,"0,-4"
9350,720575940627301988,right,T1,702,-5,23,16,7,"-5,23"
9351,720575940617954049,right,T1,703,-3,1,3,-2,"-3,1"
9352,720575940623970147,right,T1,704,-7,8,11,-3,"-7,8"
9353,720575940627297608,right,T1,705,1,1,-1,2,"1,1"
9354,720575940630651300,right,T1,706,-7,-12,1,-13,"-7,-12"
9355,720575940617999419,right,T1,707,-2,25,14,11,"-2,25"
9356,720575940634537441,right,T1,708,-4,-25,-9,-16,"-4,-25"
9357,720575940616298562,right,T1,709,-2,-24,-10,-14,"-2,-24"
9358,720575940613121689,right,T1,710,4,-25,-17,-8,"4,-25"
9359,720575940644654280,right,T1,711,-1,19,10,9,"-1,19"
9360,720575940621320803,right,T1,712,-7,12,13,-1,"-7,12"
9361,720575940622318000,right,T1,713,-6,16,14,2,"-6,16"
9362,720575940616278338,right,T1,714,5,12,1,11,"5,12"
9363,720575940622484212,right,T1,715,4,10,1,9,"4,10"
9364,720575940615629986,right,T1,716,4,-6,-7,1,"4,-6"
9365,720575940631641851,right,T1,717,2,-22,-13,-9,"2,-22"
9366,720575940613391474,right,T1,718,-5,24,17,7,"-5,24"
9367,720575940623092182,right,T1,719,1,27,12,15,"1,27"
9368,720575940655714721,right,T1,720,-5,21,15,6,"-5,21"
9369,720575940618485787,right,T1,721,5,13,1,12,"5,13"
9370,720575940630736121,right,T1,722,6,-15,-14,-1,"6,-15"
9371,720575940620920710,right,T1,723,-2,-11,-4,-7,"-2,-11"
9372,720575940618766875,right,T1,724,4,2,-3,5,"4,2"
9373,720575940637871278,right,T1,725,-3,-24,-9,-15,"-3,-24"
9374,720575940631315500,right,T1,726,2,-28,-16,-12,"2,-28"
9375,720575940623115222,right,T1,728,7,12,-1,13,"7,12"
9376,720575940627987077,right,T1,729,-3,29,17,12,"-3,29"
9377,720575940644751048,right,T1,730,7,0,-7,7,"7,0"
9378,720575940615524235,right,T1,731,-6,9,10,-1,"-6,9"
9379,720575940608001219,right,T1,732,-3,6,6,0,"-3,6"
9380,720575940615331490,right,T1,733,-5,-17,-4,-13,"-5,-17"
9381,720575940625064445,right,T1,734,2,0,-2,2,"2,0"
9382,720575940635699807,right,T1,735,1,-23,-13,-10,"1,-23"
9383,720575940624886556,right,T1,736,-8,1,8,-7,"-8,1"
9384,720575940639267893,right,T1,737,0,19,9,10,"0,19"
9385,720575940619838843,right,T1,738,-3,13,9,4,"-3,13"
9386,720575940620248097,right,T1,739,-7,2,8,-6,"-7,2"
9387,720575940627675474,right,T1,740,2,-8,-6,-2,"2,-8"
9388,720575940626761008,right,T1,741,-2,-14,-5,-9,"-2,-14"
9389,720575940613448874,right,T1,742,-4,11,9,2,"-4,11"
9390,720575940641020288,right,T1,743,6,-19,-16,-3,"6,-19"
9391,720575940646479982,right,T1,744,-4,25,16,9,"-4,25"
9392,720575940633935661,right,T1,745,0,13,6,7,"0,13"
9393,720575940627877150,right,T1,746,-3,3,4,-1,"-3,3"
9394,720575940640262608,right,T1,747,0,2,1,1,"0,2"
9395,720575940632058451,right,T1,749,-2,1,2,-1,"-2,1"
9396,720575940611395960,right,T1,750,4,-24,-16,-8,"4,-24"
9397,720575940608158082,right,T1,751,1,6,2,4,"1,6"
9398,720575940624728503,right,T1,752,-2,7,5,2,"-2,7"
9399,720575940629614833,right,T1,753,-3,24,15,9,"-3,24"
9400,720575940652841462,right,T1,754,-1,-13,-6,-7,"-1,-13"
9401,720575940640708211,right,T1,755,4,19,5,14,"4,19"
9402,720575940620785261,right,T1,756,5,20,5,15,"5,20"
9403,720575940611705810,right,T1,757,0,-6,-3,-3,"0,-6"
9404,720575940641872859,right,T1,758,5,-1,-6,5,"5,-1"
9405,720575940620256903,right,T1,759,7,14,0,14,"7,14"
9406,720575940621395622,right,T1,761,-4,-18,-5,-13,"-4,-18"
9407,720575940627219300,right,T1,762,0,14,7,7,"0,14"
9408,720575940618399417,right,T1,763,-5,14,12,2,"-5,14"
9409,720575940616128413,right,T1,764,-8,-6,5,-11,"-8,-6"
9410,720575940625797863,right,T1,765,-3,9,7,2,"-3,9"
9411,720575940627722841,right,T1,766,2,-4,-4,0,"2,-4"
9412,720575940614607085,right,T1,767,1,28,13,15,"1,28"
9413,720575940612849045,right,T1,768,3,5,-1,6,"3,5"
9414,720575940641599952,right,T1,769,4,-27,-18,-9,"4,-27"
9415,720575940615890026,right,T1,770,5,4,-3,7,"5,4"
9416,720575940629409359,right,T1,772,1,12,5,7,"1,12"
9417,720575940606775241,right,T1,773,5,-19,-15,-4,"5,-19"
9418,720575940605676972,right,T1,774,-8,6,11,-5,"-8,6"
9419,720575940622801996,right,T1,775,5,22,6,16,"5,22"
9420,720575940613934962,right,T1,776,5,21,5,16,"5,21"
9421,720575940621280594,right,T1,777,6,20,4,16,"6,20"
9422,720575940616853260,right,T1,778,4,25,8,17,"4,25"
9423,720575940635531671,right,T1,779,5,24,7,17,"5,24"
9424,720575940645963543,right,T1,780,-6,25,18,7,"-6,25"
9425,720575940630556663,right,T1,781,-5,26,18,8,"-5,26"
9426,720575940626772272,right,T1,782,-5,27,18,9,"-5,27"
9427,720575940616704050,right,T1,783,-4,28,18,10,"-4,28"
9428,720575940623726104,right,T1,784,-4,29,18,11,"-4,29"
9429,720575940632789305,right,T1,785,-3,30,18,12,"-3,30"
9430,720575940613434597,right,T1,787,3,28,11,17,"3,28"
9431,720575940627330562,right,T1,788,3,27,10,17,"3,27"
9432,720575940615837846,right,T1,789,-3,-27,-11,-16,"-3,-27"
9433,720575940611930466,right,T1,790,-2,-27,-12,-15,"-2,-27"
9434,720575940642607579,right,T1,791,-1,-28,-13,-15,"-1,-28"
9435,720575940622003638,right,T1,792,8,2,-7,9,"8,2"
9436,720575940624362120,right,T1,794,5,-26,-18,-8,"5,-26"
9437,720575940618347494,right,T1,795,6,-21,-17,-4,"6,-21"
9438,720575940632427091,right,T2,1,-6,13,12,1,"-6,13"
9439,720575940603707657,right,T2,2,-8,2,9,-7,"-8,2"
9440,720575940627203087,right,T2,3,6,-12,-12,0,"6,-12"
9441,720575940633664025,right,T2,5,-1,16,9,7,"-1,16"
9442,720575940631673996,right,T2,6,-2,-4,0,-4,"-2,-4"
9443,720575940605776416,right,T2,7,-6,-6,3,-9,"-6,-6"
9444,720575940631047249,right,T2,8,-4,26,17,9,"-4,26"
9445,720575940634576480,right,T2,9,4,9,0,9,"4,9"
9446,720575940637590750,right,T2,10,5,-15,-13,-2,"5,-15"
9447,720575940627062543,right,T2,11,7,-14,-14,0,"7,-14"
9448,720575940634472670,right,T2,12,-7,9,11,-2,"-7,9"
9449,720575940608368306,right,T2,13,-1,-26,-12,-14,"-1,-26"
9450,720575940628093768,right,T2,14,0,-27,-14,-13,"0,-27"
9451,720575940622129780,right,T2,15,2,-3,-4,1,"2,-3"
9452,720575940630039567,right,T2,16,-2,-16,-6,-10,"-2,-16"
9453,720575940632139949,right,T2,17,1,-5,-4,-1,"1,-5"
9454,720575940617557478,right,T2,18,5,-16,-13,-3,"5,-16"
9455,720575940618996894,right,T2,19,-7,17,15,2,"-7,17"
9456,720575940636604302,right,T2,20,3,-11,-9,-2,"3,-11"
9457,720575940625821733,right,T2,21,-2,19,11,8,"-2,19"
9458,720575940643221192,right,T2,22,-1,3,2,1,"-1,3"
9459,720575940618728021,right,T2,23,-3,-16,-5,-11,"-3,-16"
9460,720575940627837205,right,T2,24,-1,-10,-4,-6,"-1,-10"
9461,720575940624782654,right,T2,25,-9,3,10,-7,"-9,3"
9462,720575940629301239,right,T2,26,1,-3,-3,0,"1,-3"
9463,720575940620425643,right,T2,28,5,6,-2,8,"5,6"
9464,720575940626316681,right,T2,29,-1,-3,-1,-2,"-1,-3"
9465,720575940619425158,right,T2,30,6,16,2,14,"6,16"
9466,720575940621540518,right,T2,31,0,16,8,8,"0,16"
9467,720575940627166212,right,T2,32,0,12,6,6,"0,12"
9468,720575940654976673,right,T2,35,1,-24,-13,-11,"1,-24"
9469,720575940626762814,right,T2,36,6,8,-2,10,"6,8"
9470,720575940619722689,right,T2,37,1,5,1,4,"1,5"
9471,720575940613285034,right,T2,38,0,-2,-1,-1,"0,-2"
9472,720575940614927155,right,T2,39,0,20,10,10,"0,20"
9473,720575940632225235,right,T2,40,-2,-6,-1,-5,"-2,-6"
9474,720575940631410730,right,T2,41,-3,28,17,11,"-3,28"
9475,720575940627186988,right,T2,42,-1,14,8,6,"-1,14"
9476,720575940626467417,right,T2,43,-5,18,14,4,"-5,18"
9477,720575940611206242,right,T2,44,5,-10,-10,0,"5,-10"
9478,720575940619470445,right,T2,45,-5,-1,4,-5,"-5,-1"
9479,720575940626202212,right,T2,46,-5,15,12,3,"-5,15"
9480,720575940631871519,right,T2,47,-9,-1,8,-9,"-9,-1"
9481,720575940628906599,right,T2,49,4,-4,-6,2,"4,-4"
9482,720575940660040833,right,T2,50,-2,21,12,9,"-2,21"
9483,720575940633775842,right,T2,51,0,-19,-10,-9,"0,-19"
9484,720575940631407308,right,T2,52,-1,-22,-10,-12,"-1,-22"
9485,720575940633326244,right,T2,53,5,14,2,12,"5,14"
9486,720575940623951240,right,T2,54,-4,3,5,-2,"-4,3"
9487,720575940641495771,right,T2,55,-4,-11,-2,-9,"-4,-11"
9488,720575940632714835,right,T2,56,1,-13,-8,-5,"1,-13"
9489,720575940615146919,right,T2,57,6,-11,-12,1,"6,-11"
9490,720575940620217280,right,T2,58,3,12,3,9,"3,12"
9491,720575940635967374,right,T2,60,-8,8,12,-4,"-8,8"
9492,720575940644402724,right,T2,61,-4,-4,2,-6,"-4,-4"
9493,720575940624773524,right,T2,63,4,12,2,10,"4,12"
9494,720575940625942576,right,T2,64,4,-23,-16,-7,"4,-23"
9495,720575940615129762,right,T2,65,-1,28,15,13,"-1,28"
9496,720575940618217805,right,T2,66,2,15,5,10,"2,15"
9497,720575940622674141,right,T2,67,-2,-13,-5,-8,"-2,-13"
9498,720575940622982057,right,T2,68,3,16,5,11,"3,16"
9499,720575940614025135,right,T2,69,1,8,3,5,"1,8"
9500,720575940617736571,right,T2,70,-4,21,14,7,"-4,21"
9501,720575940620036461,right,T2,71,-2,-3,0,-3,"-2,-3"
9502,720575940612510634,right,T2,72,0,-28,-14,-14,"0,-28"
9503,720575940623499337,right,T2,73,2,2,-1,3,"2,2"
9504,720575940633378252,right,T2,74,-1,-9,-4,-5,"-1,-9"
9505,720575940619724109,right,T2,75,-6,14,13,1,"-6,14"
9506,720575940629966135,right,T2,76,-3,-4,1,-5,"-3,-4"
9507,720575940643738784,right,T2,77,2,-5,-5,0,"2,-5"
9508,720575940615956934,right,T2,78,2,20,8,12,"2,20"
9509,720575940615237062,right,T2,79,2,1,-2,3,"2,1"
9510,720575940612274162,right,T2,80,4,13,2,11,"4,13"
9511,720575940626760372,right,T2,81,6,-2,-7,5,"6,-2"
9512,720575940626270339,right,T2,82,-7,7,10,-3,"-7,7"
9513,720575940619381627,right,T2,83,2,-21,-13,-8,"2,-21"
9514,720575940633258722,right,T2,84,-2,12,8,4,"-2,12"
9515,720575940616048690,right,T2,85,4,-22,-15,-7,"4,-22"
9516,720575940614061539,right,T2,86,-5,-7,1,-8,"-5,-7"
9517,720575940621292224,right,T2,87,1,11,4,7,"1,11"
9518,720575940619764918,right,T2,88,7,4,-5,9,"7,4"
9519,720575940622651862,right,T2,89,1,-19,-11,-8,"1,-19"
9520,720575940633060269,right,T2,90,-4,5,6,-1,"-4,5"
9521,720575940625707522,right,T2,91,-1,6,4,2,"-1,6"
9522,720575940624324425,right,T2,92,0,9,4,5,"0,9"
9523,720575940627154106,right,T2,95,4,-21,-15,-6,"4,-21"
9524,720575940652427766,right,T2,96,1,-10,-6,-4,"1,-10"
9525,720575940629602364,right,T2,97,-5,2,6,-4,"-5,2"
9526,720575940612380645,right,T2,98,-1,-12,-5,-7,"-1,-12"
9527,720575940609557771,right,T2,100,2,-10,-7,-3,"2,-10"
9528,720575940628413712,right,T2,101,-7,6,10,-4,"-7,6"
9529,720575940618891521,right,T2,102,3,13,3,10,"3,13"
9530,720575940616130271,right,T2,104,-1,-27,-13,-14,"-1,-27"
9531,720575940625539051,right,T2,105,3,22,8,14,"3,22"
9532,720575940630238689,right,T2,106,-7,11,12,-1,"-7,11"
9533,720575940616405727,right,T2,107,8,-2,-9,7,"8,-2"
9534,720575940631792524,right,T2,108,-3,-12,-3,-9,"-3,-12"
9535,720575940620608586,right,T2,109,4,-5,-7,2,"4,-5"
9536,720575940635030426,right,T2,110,-7,0,7,-7,"-7,0"
9537,720575940620863215,right,T2,111,2,-24,-14,-10,"2,-24"
9538,720575940624994830,right,T2,112,-6,1,6,-5,"-6,1"
9539,720575940644509038,right,T2,113,-2,4,4,0,"-2,4"
9540,720575940628182016,right,T2,114,2,-13,-9,-4,"2,-13"
9541,720575940633982862,right,T2,115,-4,2,5,-3,"-4,2"
9542,720575940615518018,right,T2,116,-1,-8,-3,-5,"-1,-8"
9543,720575940627526652,right,T2,117,-8,-2,7,-9,"-8,-2"
9544,720575940626128536,right,T2,118,3,1,-3,4,"3,1"
9545,720575940617304916,right,T2,119,-2,6,5,1,"-2,6"
9546,720575940612168470,right,T2,120,-1,-1,0,-1,"-1,-1"
9547,720575940620107034,right,T2,121,-8,4,10,-6,"-8,4"
9548,720575940626098178,right,T2,122,-5,9,9,0,"-5,9"
9549,720575940616722393,right,T2,124,1,-7,-5,-2,"1,-7"
9550,720575940623600639,right,T2,126,3,11,2,9,"3,11"
9551,720575940635308280,right,T2,127,0,15,7,8,"0,15"
9552,720575940644764196,right,T2,128,3,-22,-14,-8,"3,-22"
9553,720575940624730099,right,T2,129,0,-13,-7,-6,"0,-13"
9554,720575940618146462,right,T2,130,2,12,4,8,"2,12"
9555,720575940634782174,right,T2,131,-6,20,16,4,"-6,20"
9556,720575940636711566,right,T2,132,2,4,0,4,"2,4"
9557,720575940613569005,right,T2,133,-3,20,13,7,"-3,20"
9558,720575940616747869,right,T2,136,0,3,1,2,"0,3"
9559,720575940633421523,right,T2,138,0,27,13,14,"0,27"
9560,720575940635194464,right,T2,139,1,-14,-8,-6,"1,-14"
9561,720575940618202395,right,T2,140,3,8,1,7,"3,8"
9562,720575940627514962,right,T2,141,5,-23,-17,-6,"5,-23"
9563,720575940620000891,right,T2,142,-2,-18,-7,-11,"-2,-18"
9564,720575940623178986,right,T2,143,-4,16,12,4,"-4,16"
9565,720575940635278431,right,T2,144,7,-11,-13,2,"7,-11"
9566,720575940638574525,right,T2,145,0,4,2,2,"0,4"
9567,720575940619660052,right,T2,146,1,-6,-4,-2,"1,-6"
9568,720575940632893011,right,T2,147,1,21,9,12,"1,21"
9569,720575940604867500,right,T2,148,-7,-11,1,-12,"-7,-11"
9570,720575940638798464,right,T2,149,6,-14,-13,-1,"6,-14"
9571,720575940637761252,right,T2,150,-8,5,10,-5,"-8,5"
9572,720575940614959254,right,T2,152,3,-15,-11,-4,"3,-15"
9573,720575940646461219,right,T2,153,8,0,-8,8,"8,0"
9574,720575940611617429,right,T2,154,-8,0,8,-8,"-8,0"
9575,720575940628137922,right,T2,155,-8,13,14,-1,"-8,13"
9576,720575940620894273,right,T2,156,-9,1,9,-8,"-9,1"
9577,720575940626070291,right,T2,157,-1,-7,-3,-4,"-1,-7"
9578,720575940622698879,right,T2,158,3,-5,-6,1,"3,-5"
9579,720575940628593563,right,T2,159,7,7,-4,11,"7,7"
9580,720575940624315721,right,T2,161,4,-14,-11,-3,"4,-14"
9581,720575940631721559,right,T2,162,-4,-2,3,-5,"-4,-2"
9582,720575940624067592,right,T2,163,-9,7,12,-5,"-9,7"
9583,720575940625037104,right,T2,164,-1,-2,0,-2,"-1,-2"
9584,720575940628365574,right,T2,165,4,16,4,12,"4,16"
9585,720575940629742786,right,T2,166,0,18,9,9,"0,18"
9586,720575940631888963,right,T2,167,0,-17,-9,-8,"0,-17"
9587,720575940621020325,right,T2,168,-1,17,9,8,"-1,17"
9588,720575940624772588,right,T2,169,0,-18,-9,-9,"0,-18"
9589,720575940618204229,right,T2,170,-5,1,5,-4,"-5,1"
9590,720575940626384386,right,T2,172,1,22,10,12,"1,22"
9591,720575940647460643,right,T2,173,2,-25,-15,-10,"2,-25"
9592,720575940610709038,right,T2,174,4,-15,-12,-3,"4,-15"
9593,720575940633059757,right,T2,175,-6,-7,2,-9,"-6,-7"
9594,720575940630839767,right,T2,176,-2,13,8,5,"-2,13"
9595,720575940629501545,right,T2,177,-2,-1,1,-2,"-2,-1"
9596,720575940634681242,right,T2,178,2,11,3,8,"2,11"
9597,720575940628837114,right,T2,181,1,-4,-3,-1,"1,-4"
9598,720575940609438165,right,T2,182,7,-10,-12,2,"7,-10"
9599,720575940620889582,right,T2,183,-5,-15,-3,-12,"-5,-15"
9600,720575940612472231,right,T2,184,-6,-5,3,-8,"-6,-5"
9601,720575940633895137,right,T2,185,2,-11,-8,-3,"2,-11"
9602,720575940635403662,right,T2,186,-1,26,14,12,"-1,26"
9603,720575940612215449,right,T2,187,3,21,7,14,"3,21"
9604,720575940604908716,right,T2,188,-5,17,13,4,"-5,17"
9605,720575940628276162,right,T2,189,6,13,0,13,"6,13"
9606,720575940617670401,right,T2,190,-3,-5,0,-5,"-3,-5"
9607,720575940624456848,right,T2,191,-1,-11,-5,-6,"-1,-11"
9608,720575940626806397,right,T2,193,-5,4,7,-3,"-5,4"
9609,720575940620883137,right,T2,194,0,-5,-3,-2,"0,-5"
9610,720575940649026169,right,T2,195,-3,-1,2,-3,"-3,-1"
9611,720575940626388738,right,T2,196,-1,8,5,3,"-1,8"
9612,720575940632010538,right,T2,197,0,-20,-10,-10,"0,-20"
9613,720575940628517192,right,T2,198,6,2,-5,7,"6,2"
9614,720575940623866090,right,T2,199,0,-12,-6,-6,"0,-12"
9615,720575940633907854,right,T2,200,-5,12,11,1,"-5,12"
9616,720575940633147614,right,T2,201,-8,9,12,-3,"-8,9"
9617,720575940637994724,right,T2,202,-1,27,14,13,"-1,27"
9618,720575940617669588,right,T2,203,3,-1,-4,3,"3,-1"
9619,720575940634879130,right,T2,206,-3,5,5,0,"-3,5"
9620,720575940632075368,right,T2,207,1,29,13,16,"1,29"
9621,720575940622017633,right,T2,209,-3,-8,-1,-7,"-3,-8"
9622,720575940622819464,right,T2,210,-6,8,10,-2,"-6,8"
9623,720575940618758558,right,T2,211,-7,-1,6,-7,"-7,-1"
9624,720575940635143007,right,T2,212,2,-16,-10,-6,"2,-16"
9625,720575940623638506,right,T2,213,3,-4,-5,1,"3,-4"
9626,720575940648438660,right,T2,214,-5,3,6,-3,"-5,3"
9627,720575940628594948,right,T2,215,6,7,-3,10,"6,7"
9628,720575940620132401,right,T2,216,2,19,7,12,"2,19"
9629,720575940623851411,right,T2,219,6,-4,-8,4,"6,-4"
9630,720575940638966947,right,T2,220,2,-6,-5,-1,"2,-6"
9631,720575940612248469,right,T2,221,-7,3,8,-5,"-7,3"
9632,720575940630824570,right,T2,222,-3,26,16,10,"-3,26"
9633,720575940618504093,right,T2,223,-2,26,15,11,"-2,26"
9634,720575940635831664,right,T2,224,0,5,2,3,"0,5"
9635,720575940619711537,right,T2,225,2,-26,-15,-11,"2,-26"
9636,720575940622754473,right,T2,226,5,19,4,15,"5,19"
9637,720575940621353716,right,T2,227,-7,5,9,-4,"-7,5"
9638,720575940614847903,right,T2,228,-7,1,7,-6,"-7,1"
9639,720575940629846775,right,T2,230,2,9,2,7,"2,9"
9640,720575940609873016,right,T2,231,4,-12,-10,-2,"4,-12"
9641,720575940636269925,right,T2,232,-4,13,10,3,"-4,13"
9642,720575940618512805,right,T2,233,4,-13,-11,-2,"4,-13"
9643,720575940611223665,right,T2,234,1,3,0,3,"1,3"
9644,720575940627282557,right,T2,235,4,11,1,10,"4,11"
9645,720575940629713963,right,T2,236,-1,4,3,1,"-1,4"
9646,720575940637682142,right,T2,237,-2,27,15,12,"-2,27"
9647,720575940621868058,right,T2,238,-8,-3,6,-9,"-8,-3"
9648,720575940646059908,right,T2,239,-6,6,9,-3,"-6,6"
9649,720575940645760547,right,T2,240,-4,-3,2,-5,"-4,-3"
9650,720575940626883599,right,T2,241,2,-17,-11,-6,"2,-17"
9651,720575940643683232,right,T2,242,-4,6,7,-1,"-4,6"
9652,720575940611392462,right,T2,243,-1,-21,-10,-11,"-1,-21"
9653,720575940626119964,right,T2,244,-4,-12,-2,-10,"-4,-12"
9654,720575940628865335,right,T2,245,-5,-3,3,-6,"-5,-3"
9655,720575940631109451,right,T2,246,-4,15,11,4,"-4,15"
9656,720575940633262818,right,T2,247,-4,-15,-4,-11,"-4,-15"
9657,720575940619932608,right,T2,248,-6,0,6,-6,"-6,0"
9658,720575940615612091,right,T2,249,2,-12,-8,-4,"2,-12"
9659,720575940624024103,right,T2,250,-1,1,1,0,"-1,1"
9660,720575940614417314,right,T2,251,-1,-14,-6,-8,"-1,-14"
9661,720575940641665933,right,T2,252,3,23,8,15,"3,23"
9662,720575940625438188,right,T2,253,5,16,3,13,"5,16"
9663,720575940639010394,right,T2,254,3,-24,-15,-9,"3,-24"
9664,720575940623089446,right,T2,255,-6,-13,-1,-12,"-6,-13"
9665,720575940643900064,right,T2,256,5,-20,-15,-5,"5,-20"
9666,720575940632517162,right,T2,257,2,21,8,13,"2,21"
9667,720575940612876566,right,T2,258,-4,-17,-5,-12,"-4,-17"
9668,720575940617970260,right,T2,259,-7,-5,4,-9,"-7,-5"
9669,720575940632371598,right,T2,260,-3,19,12,7,"-3,19"
9670,720575940619557712,right,T2,261,-1,13,7,6,"-1,13"
9671,720575940612860694,right,T2,262,1,-11,-7,-4,"1,-11"
9672,720575940628639079,right,T2,263,-3,4,5,-1,"-3,4"
9673,720575940616895517,right,T2,264,-1,-6,-2,-4,"-1,-6"
9674,720575940622561485,right,T2,265,-6,-1,5,-6,"-6,-1"
9675,720575940634678635,right,T2,266,-1,-25,-12,-13,"-1,-25"
9676,720575940618237750,right,T2,267,-6,2,7,-5,"-6,2"
9677,720575940644075424,right,T2,268,7,-6,-10,4,"7,-6"
9678,720575940626940809,right,T2,269,2,-19,-12,-7,"2,-19"
9679,720575940636978910,right,T2,270,1,-8,-5,-3,"1,-8"
9680,720575940621025396,right,T2,272,3,-2,-4,2,"3,-2"
9681,720575940618759757,right,T2,273,-6,23,17,6,"-6,23"
9682,720575940637726810,right,T2,275,-8,-1,7,-8,"-8,-1"
9683,720575940612560611,right,T2,276,2,3,-1,4,"2,3"
9684,720575940620916673,right,T2,277,7,-3,-9,6,"7,-3"
9685,720575940617111769,right,T2,278,-5,10,10,0,"-5,10"
9686,720575940605395232,right,T2,279,-4,8,8,0,"-4,8"
9687,720575940611232206,right,T2,280,-6,-14,-1,-13,"-6,-14"
9688,720575940623928071,right,T2,281,-9,2,10,-8,"-9,2"
9689,720575940623520231,right,T2,282,0,26,13,13,"0,26"
9690,720575940632332842,right,T2,283,-4,4,6,-2,"-4,4"
9691,720575940611646670,right,T2,284,0,25,12,13,"0,25"
9692,720575940618414612,right,T2,285,6,-18,-15,-3,"6,-18"
9693,720575940629539088,right,T2,286,0,-24,-12,-12,"0,-24"
9694,720575940620327606,right,T2,287,-5,13,11,2,"-5,13"
9695,720575940629048838,right,T2,288,-1,30,16,14,"-1,30"
9696,720575940605429950,right,T2,289,-1,11,6,5,"-1,11"
9697,720575940611501666,right,T2,290,5,-24,-17,-7,"5,-24"
9698,720575940631339223,right,T2,291,7,2,-6,8,"7,2"
9699,720575940623390868,right,T2,292,-4,18,13,5,"-4,18"
9700,720575940626983439,right,T2,293,4,-17,-13,-4,"4,-17"
9701,720575940634899356,right,T2,294,1,-20,-11,-9,"1,-20"
9702,720575940631222287,right,T2,295,-2,29,16,13,"-2,29"
9703,720575940640625883,right,T2,296,1,-18,-10,-8,"1,-18"
9704,720575940634700439,right,T2,297,7,-9,-12,3,"7,-9"
9705,720575940611322318,right,T2,298,-5,5,7,-2,"-5,5"
9706,720575940632630319,right,T2,299,-4,12,10,2,"-4,12"
9707,720575940646626339,right,T2,300,4,-18,-13,-5,"4,-18"
9708,720575940618081093,right,T2,301,-5,16,13,3,"-5,16"
9709,720575940618814749,right,T2,302,2,17,6,11,"2,17"
9710,720575940633563278,right,T2,303,-5,22,16,6,"-5,22"
9711,720575940626704698,right,T2,305,-7,4,9,-5,"-7,4"
9712,720575940621615198,right,T2,306,3,7,0,7,"3,7"
9713,720575940620936619,right,T2,307,5,-25,-18,-7,"5,-25"
9714,720575940617737245,right,T2,308,-5,8,9,-1,"-5,8"
9715,720575940611462037,right,T2,309,-6,12,12,0,"-6,12"
9716,720575940611845618,right,T2,311,-7,15,14,1,"-7,15"
9717,720575940645698926,right,T2,312,4,-7,-8,1,"4,-7"
9718,720575940622498124,right,T2,313,7,3,-6,9,"7,3"
9719,720575940625083628,right,T2,314,-9,5,11,-6,"-9,5"
9720,720575940630466412,right,T2,315,-3,-6,0,-6,"-3,-6"
9721,720575940625167118,right,T2,316,5,-4,-7,3,"5,-4"
9722,720575940610494254,right,T2,317,-5,-4,3,-7,"-5,-4"
9723,720575940638659416,right,T2,318,4,-19,-14,-5,"4,-19"
9724,720575940612941999,right,T2,319,-2,5,4,1,"-2,5"
9725,720575940620970662,right,T2,320,-2,-5,-1,-4,"-2,-5"
9726,720575940618291525,right,T2,321,8,4,-6,10,"8,4"
9727,720575940630099355,right,T2,322,2,26,11,15,"2,26"
9728,720575940624075701,right,T2,323,-7,-13,0,-13,"-7,-13"
9729,720575940628714492,right,T2,325,5,1,-5,6,"5,1"
9730,720575940620546497,right,T2,326,2,16,6,10,"2,16"
9731,720575940605758822,right,T2,327,5,3,-4,7,"5,3"
9732,720575940624752108,right,T2,328,5,-9,-10,1,"5,-9"
9733,720575940630358327,right,T2,330,3,3,-2,5,"3,3"
9734,720575940628580849,right,T2,331,1,-15,-9,-6,"1,-15"
9735,720575940637770559,right,T2,332,4,-26,-17,-9,"4,-26"
9736,720575940622651606,right,T2,333,0,-21,-11,-10,"0,-21"
9737,720575940633711073,right,T2,334,1,-26,-14,-12,"1,-26"
9738,720575940626949894,right,T2,335,2,8,2,6,"2,8"
9739,720575940618053377,right,T2,336,0,23,11,12,"0,23"
9740,720575940615620241,right,T2,337,-5,-6,2,-8,"-5,-6"
9741,720575940611116334,right,T2,338,-1,0,1,-1,"-1,0"
9742,720575940628481899,right,T2,339,6,11,-1,12,"6,11"
9743,720575940633391246,right,T2,340,-4,17,12,5,"-4,17"
9744,720575940608909358,right,T2,342,2,-15,-10,-5,"2,-15"
9745,720575940625495885,right,T2,343,-3,27,16,11,"-3,27"
9746,720575940633661153,right,T2,344,-2,-15,-6,-9,"-2,-15"
9747,720575940626884879,right,T2,345,3,-12,-9,-3,"3,-12"
9748,720575940627343237,right,T2,346,-7,-9,2,-11,"-7,-9"
9749,720575940626608911,right,T2,347,-5,-13,-2,-11,"-5,-13"
9750,720575940624185085,right,T2,348,3,14,4,10,"3,14"
9751,720575940609363209,right,T2,349,-5,-14,-2,-12,"-5,-14"
9752,720575940629180154,right,T2,350,1,15,6,9,"1,15"
9753,720575940630761467,right,T2,351,-1,-17,-8,-9,"-1,-17"
9754,720575940629344335,right,T2,352,-2,28,16,12,"-2,28"
9755,720575940622604876,right,T2,353,2,24,10,14,"2,24"
9756,720575940618568166,right,T2,354,-2,-26,-11,-15,"-2,-26"
9757,720575940631933771,right,T2,355,-7,-6,4,-10,"-7,-6"
9758,720575940633364269,right,T2,356,0,22,11,11,"0,22"
9759,720575940617333734,right,T2,357,4,17,4,13,"4,17"
9760,720575940625393639,right,T2,358,-3,17,11,6,"-3,17"
9761,720575940622594124,right,T2,359,2,23,9,14,"2,23"
9762,720575940606118322,right,T2,360,-5,19,14,5,"-5,19"
9763,720575940620801776,right,T2,361,0,-7,-4,-3,"0,-7"
9764,720575940614148527,right,T2,362,2,-20,-12,-8,"2,-20"
9765,720575940627385091,right,T2,363,7,-4,-9,5,"7,-4"
9766,720575940618970113,right,T2,364,4,4,-2,6,"4,4"
9767,720575940624795628,right,T2,365,4,7,-1,8,"4,7"
9768,720575940630221434,right,T2,366,-5,-20,-5,-15,"-5,-20"
9769,720575940626121018,right,T2,367,-6,-15,-2,-13,"-6,-15"
9770,720575940621447706,right,T2,368,-4,-20,-6,-14,"-4,-20"
9771,720575940631479096,right,T2,369,5,-5,-8,3,"5,-5"
9772,720575940634118300,right,T2,370,-3,21,13,8,"-3,21"
9773,720575940629015414,right,T2,371,6,-5,-9,4,"6,-5"
9774,720575940629236486,right,T2,372,1,-2,-2,0,"1,-2"
9775,720575940636509559,right,T2,373,1,-21,-12,-9,"1,-21"
9776,720575940645010798,right,T2,375,-6,7,9,-2,"-6,7"
9777,720575940643958472,right,T2,376,-7,-10,2,-12,"-7,-10"
9778,720575940642181851,right,T2,377,0,7,3,4,"0,7"
9779,720575940630239102,right,T2,378,-3,18,12,6,"-3,18"
9780,720575940614682110,right,T2,379,3,-17,-12,-5,"3,-17"
9781,720575940632061255,right,T2,380,-1,29,15,14,"-1,29"
9782,720575940627184765,right,T2,381,-8,-9,3,-12,"-8,-9"
9783,720575940616797301,right,T2,382,3,-6,-6,0,"3,-6"
9784,720575940623522708,right,T2,383,-6,11,11,0,"-6,11"
9785,720575940623330963,right,T2,384,-6,-2,5,-7,"-6,-2"
9786,720575940646574883,right,T2,385,-3,-18,-6,-12,"-3,-18"
9787,720575940622145574,right,T2,386,-6,19,15,4,"-6,19"
9788,720575940612382437,right,T2,387,-1,-15,-7,-8,"-1,-15"
9789,720575940633192365,right,T2,388,3,19,6,13,"3,19"
9790,720575940613298915,right,T2,389,-6,-16,-2,-14,"-6,-16"
9791,720575940632891449,right,T2,390,-6,-9,1,-10,"-6,-9"
9792,720575940622611848,right,T2,391,4,-3,-6,3,"4,-3"
9793,720575940628276329,right,T2,392,-4,7,7,0,"-4,7"
9794,720575940623316173,right,T2,393,-1,22,12,10,"-1,22"
9795,720575940635155391,right,T2,394,-7,-8,3,-11,"-7,-8"
9796,720575940623244824,right,T2,395,0,-22,-11,-11,"0,-22"
9797,720575940628214149,right,T2,396,-1,10,6,4,"-1,10"
9798,720575940630808284,right,T2,397,-3,-19,-7,-12,"-3,-19"
9799,720575940636513655,right,T2,398,-3,22,14,8,"-3,22"
9800,720575940620531648,right,T2,399,-4,-24,-8,-16,"-4,-24"
9801,720575940626327177,right,T2,400,1,-29,-16,-13,"1,-29"
9802,720575940626686851,right,T2,401,-2,-19,-8,-11,"-2,-19"
9803,720575940625974832,right,T2,402,3,26,10,16,"3,26"
9804,720575940613615638,right,T2,403,-2,-12,-4,-8,"-2,-12"
9805,720575940631895247,right,T2,404,-1,20,11,9,"-1,20"
9806,720575940608327435,right,T2,405,3,10,2,8,"3,10"
9807,720575940620777552,right,T2,406,1,-25,-14,-11,"1,-25"
9808,720575940612217002,right,T2,408,-6,-4,4,-8,"-6,-4"
9809,720575940631169700,right,T2,409,0,-3,-2,-1,"0,-3"
9810,720575940637638889,right,T2,410,-2,-2,1,-3,"-2,-2"
9811,720575940614461351,right,T2,411,-5,-19,-5,-14,"-5,-19"
9812,720575940629539710,right,T2,412,-6,21,16,5,"-6,21"
9813,720575940628940367,right,T2,413,-2,-7,-2,-5,"-2,-7"
9814,720575940629451515,right,T2,414,4,21,6,15,"4,21"
9815,720575940627784945,right,T2,415,6,12,0,12,"6,12"
9816,720575940607381257,right,T2,416,3,-8,-7,-1,"3,-8"
9817,720575940626091778,right,T2,417,-6,-10,1,-11,"-6,-10"
9818,720575940627320378,right,T2,418,-2,15,9,6,"-2,15"
9819,720575940631794755,right,T2,419,-3,-11,-3,-8,"-3,-11"
9820,720575940627189523,right,T2,421,-1,12,7,5,"-1,12"
9821,720575940626264348,right,T2,422,-7,-4,5,-9,"-7,-4"
9822,720575940621296816,right,T2,423,3,-18,-12,-6,"3,-18"
9823,720575940619525592,right,T2,424,-3,-2,2,-4,"-3,-2"
9824,720575940623935743,right,T2,426,-3,0,3,-3,"-3,0"
9825,720575940612547481,right,T2,427,5,-18,-14,-4,"5,-18"
9826,720575940609347140,right,T2,428,-2,23,13,10,"-2,23"
9827,720575940621286593,right,T2,429,-2,14,9,5,"-2,14"
9828,720575940612385765,right,T2,430,-3,-7,-1,-6,"-3,-7"
9829,720575940632582760,right,T2,431,-2,-10,-3,-7,"-2,-10"
9830,720575940639426648,right,T2,432,-5,7,8,-1,"-5,7"
9831,720575940612484778,right,T2,433,0,-8,-4,-4,"0,-8"
9832,720575940617524125,right,T2,434,-3,7,6,1,"-3,7"
9833,720575940625288265,right,T2,435,5,-17,-14,-3,"5,-17"
9834,720575940621793797,right,T2,436,0,-15,-8,-7,"0,-15"
9835,720575940622628632,right,T2,437,-3,12,9,3,"-3,12"
9836,720575940637473358,right,T2,438,2,27,11,16,"2,27"
9837,720575940604646368,right,T2,439,-3,-9,-2,-7,"-3,-9"
9838,720575940628230652,right,T2,440,1,23,10,13,"1,23"
9839,720575940612218163,right,T2,441,3,-16,-11,-5,"3,-16"
9840,720575940619137812,right,T2,442,-5,25,17,8,"-5,25"
9841,720575940618348155,right,T2,443,-6,4,8,-4,"-6,4"
9842,720575940625900080,right,T2,444,4,-10,-9,-1,"4,-10"
9843,720575940614864095,right,T2,445,-2,8,6,2,"-2,8"
9844,720575940626900239,right,T2,446,2,-14,-9,-5,"2,-14"
9845,720575940611297266,right,T2,447,-1,2,2,0,"-1,2"
9846,720575940630010494,right,T2,448,0,30,15,15,"0,30"
9847,720575940624285111,right,T2,449,6,-16,-14,-2,"6,-16"
9848,720575940638049855,right,T2,450,2,-9,-7,-2,"2,-9"
9849,720575940632038095,right,T2,451,4,20,6,14,"4,20"
9850,720575940630079744,right,T2,452,1,-9,-6,-3,"1,-9"
9851,720575940622033791,right,T2,453,3,25,9,16,"3,25"
9852,720575940627080975,right,T2,454,5,-12,-11,-1,"5,-12"
9853,720575940624713708,right,T2,456,0,21,10,11,"0,21"
9854,720575940626370622,right,T2,457,-2,17,10,7,"-2,17"
9855,720575940613006358,right,T2,458,5,0,-5,5,"5,0"
9856,720575940616030694,right,T2,459,5,-3,-7,4,"5,-3"
9857,720575940617915170,right,T2,460,-3,-20,-7,-13,"-3,-20"
9858,720575940628910159,right,T2,461,7,-5,-10,5,"7,-5"
9859,720575940605545504,right,T2,462,-1,18,10,8,"-1,18"
9860,720575940621690239,right,T2,463,5,17,3,14,"5,17"
9861,720575940627859855,right,T2,464,4,0,-4,4,"4,0"
9862,720575940628325319,right,T2,465,3,0,-3,3,"3,0"
9863,720575940627016762,right,T2,466,1,14,6,8,"1,14"
9864,720575940660264833,right,T2,467,-2,-20,-8,-12,"-2,-20"
9865,720575940632578861,right,T2,468,-3,11,8,3,"-3,11"
9866,720575940608252427,right,T2,469,-7,13,13,0,"-7,13"
9867,720575940622494028,right,T2,470,4,-9,-9,0,"4,-9"
9868,720575940639519677,right,T2,471,3,-26,-16,-10,"3,-26"
9869,720575940625271629,right,T2,472,1,25,11,14,"1,25"
9870,720575940611502968,right,T2,473,-4,23,15,8,"-4,23"
9871,720575940621245616,right,T2,475,-4,-1,3,-4,"-4,-1"
9872,720575940621769293,right,T2,476,-1,15,8,7,"-1,15"
9873,720575940623493559,right,T2,477,-3,2,4,-2,"-3,2"
9874,720575940632557281,right,T2,478,-7,16,15,1,"-7,16"
9875,720575940628099197,right,T2,479,-2,10,7,3,"-2,10"
9876,720575940605823264,right,T2,480,3,-19,-13,-6,"3,-19"
9877,720575940612297690,right,T2,481,4,-8,-8,0,"4,-8"
9878,720575940627576904,right,T2,482,1,17,7,10,"1,17"
9879,720575940620558154,right,T2,483,2,-7,-6,-1,"2,-7"
9880,720575940632006284,right,T2,484,3,-9,-8,-1,"3,-9"
9881,720575940620437638,right,T2,485,-3,-3,1,-4,"-3,-3"
9882,720575940636762766,right,T2,486,0,1,0,1,"0,1"
9883,720575940624996425,right,T2,487,1,-1,-2,1,"1,-1"
9884,720575940605721446,right,T2,488,7,5,-5,10,"7,5"
9885,720575940645009518,right,T2,490,-5,6,8,-2,"-5,6"
9886,720575940613054322,right,T2,491,7,-1,-8,7,"7,-1"
9887,720575940625632656,right,T2,492,-7,-2,6,-8,"-7,-2"
9888,720575940628204550,right,T2,493,-3,23,14,9,"-3,23"
9889,720575940624688688,right,T2,494,0,29,14,15,"0,29"
9890,720575940624102399,right,T2,495,4,5,-2,7,"4,5"
9891,720575940635851828,right,T2,497,6,1,-6,7,"6,1"
9892,720575940612496242,right,T2,498,6,10,-1,11,"6,10"
9893,720575940638220378,right,T2,500,7,-8,-11,3,"7,-8"
9894,720575940620407572,right,T2,501,1,2,0,2,"1,2"
9895,720575940619603928,right,T2,502,5,8,-1,9,"5,8"
9896,720575940622148393,right,T2,504,-2,9,6,3,"-2,9"
9897,720575940640467163,right,T2,507,-5,-12,-1,-11,"-5,-12"
9898,720575940632595342,right,T2,508,-5,11,10,1,"-5,11"
9899,720575940622670263,right,T2,509,-4,10,9,1,"-4,10"
9900,720575940640446939,right,T2,510,-2,11,7,4,"-2,11"
9901,720575940624315465,right,T2,511,5,-11,-11,0,"5,-11"
9902,720575940622092020,right,T2,512,6,0,-6,6,"6,0"
9903,720575940609518859,right,T2,514,-4,-10,-1,-9,"-4,-10"
9904,720575940626550927,right,T2,515,-8,-7,4,-11,"-8,-7"
9905,720575940622002526,right,T2,516,7,-18,-16,-2,"7,-18"
9906,720575940623915527,right,T2,518,-4,22,15,7,"-4,22"
9907,720575940612549349,right,T2,520,-2,-22,-9,-13,"-2,-22"
9908,720575940632950445,right,T2,521,6,-9,-11,2,"6,-9"
9909,720575940628994127,right,T2,522,-4,0,4,-4,"-4,0"
9910,720575940639683456,right,T2,523,2,14,5,9,"2,14"
9911,720575940625158328,right,T2,524,4,-20,-14,-6,"4,-20"
9912,720575940622244393,right,T2,525,-1,-20,-9,-11,"-1,-20"
9913,720575940628591303,right,T2,526,0,-10,-5,-5,"0,-10"
9914,720575940628460292,right,T2,527,-4,-8,0,-8,"-4,-8"
9915,720575940633345361,right,T2,528,2,7,1,6,"2,7"
9916,720575940623504637,right,T2,529,2,-2,-3,1,"2,-2"
9917,720575940617691137,right,T2,530,-3,-13,-4,-9,"-3,-13"
9918,720575940624992039,right,T2,531,1,0,-1,1,"1,0"
9919,720575940619441969,right,T2,532,-8,7,11,-4,"-8,7"
9920,720575940626481764,right,T2,533,0,-16,-8,-8,"0,-16"
9921,720575940610413432,right,T2,534,3,2,-2,4,"3,2"
9922,720575940605564640,right,T2,536,3,4,-1,5,"3,4"
9923,720575940608389724,right,T2,537,0,-23,-12,-11,"0,-23"
9924,720575940632579667,right,T2,538,-4,1,4,-3,"-4,1"
9925,720575940632016175,right,T2,539,-6,15,13,2,"-6,15"
9926,720575940635986807,right,T2,540,-2,-9,-3,-6,"-2,-9"
9927,720575940620469268,right,T2,541,-4,14,11,3,"-4,14"
9928,720575940626595120,right,T2,542,6,-13,-13,0,"6,-13"
9929,720575940612934627,right,T2,543,-1,-4,-1,-3,"-1,-4"
9930,720575940635271013,right,T2,544,3,-13,-10,-3,"3,-13"
9931,720575940617608633,right,T2,545,5,11,0,11,"5,11"
9932,720575940628063996,right,T2,546,3,6,0,6,"3,6"
9933,720575940621169473,right,T2,547,-1,21,11,10,"-1,21"
9934,720575940614205602,right,T2,548,1,-16,-9,-7,"1,-16"
9935,720575940640052096,right,T2,549,0,-9,-5,-4,"0,-9"
9936,720575940626796114,right,T2,550,-2,3,3,0,"-2,3"
9937,720575940623879146,right,T2,551,-4,-9,-1,-8,"-4,-9"
9938,720575940631964520,right,T2,552,4,-1,-5,4,"4,-1"
9939,720575940614821087,right,T2,553,-3,16,11,5,"-3,16"
9940,720575940604248032,right,T2,554,-9,-3,7,-10,"-9,-3"
9941,720575940619936933,right,T2,555,-4,9,8,1,"-4,9"
9942,720575940632613006,right,T2,556,0,10,5,5,"0,10"
9943,720575940627350799,right,T2,557,6,-10,-11,1,"6,-10"
9944,720575940612937391,right,T2,558,-4,-21,-7,-14,"-4,-21"
9945,720575940639633461,right,T2,559,-6,22,17,5,"-6,22"
9946,720575940612433578,right,T2,560,-7,14,14,0,"-7,14"
9947,720575940628930151,right,T2,561,5,7,-2,9,"5,7"
9948,720575940647366452,right,T2,562,-5,-2,4,-6,"-5,-2"
9949,720575940620536047,right,T2,563,5,-13,-12,-1,"5,-13"
9950,720575940636154804,right,T2,564,3,-23,-15,-8,"3,-23"
9951,720575940622273630,right,T2,565,0,-26,-13,-13,"0,-26"
9952,720575940627921156,right,T2,566,5,-8,-9,1,"5,-8"
9953,720575940627987964,right,T2,567,-2,22,13,9,"-2,22"
9954,720575940620102872,right,T2,568,-6,-8,2,-10,"-6,-8"
9955,720575940630739650,right,T2,569,6,6,-3,9,"6,6"
9956,720575940626147717,right,T2,570,2,25,10,15,"2,25"
9957,720575940644292631,right,T2,571,0,-14,-7,-7,"0,-14"
9958,720575940634653079,right,T2,572,-8,3,9,-6,"-8,3"
9959,720575940622531060,right,T2,573,4,14,3,11,"4,14"
9960,720575940622924838,right,T2,574,-6,5,8,-3,"-6,5"
9961,720575940618020637,right,T2,575,6,9,-2,11,"6,9"
9962,720575940605401702,right,T2,576,0,28,14,14,"0,28"
9963,720575940612848849,right,T2,577,5,-14,-12,-2,"5,-14"
9964,720575940608315740,right,T2,579,-3,-10,-2,-8,"-3,-10"
9965,720575940617182425,right,T2,580,-2,-23,-10,-13,"-2,-23"
9966,720575940635410356,right,T2,581,3,9,1,8,"3,9"
9967,720575940616931131,right,T2,582,-1,23,12,11,"-1,23"
9968,720575940623690122,right,T2,583,3,-25,-16,-9,"3,-25"
9969,720575940624780361,right,T2,584,4,23,7,16,"4,23"
9970,720575940631041989,right,T2,585,-1,-23,-11,-12,"-1,-23"
9971,720575940621699693,right,T2,586,2,18,7,11,"2,18"
9972,720575940631105567,right,T2,588,1,4,1,3,"1,4"
9973,720575940625883267,right,T2,589,-1,-5,-2,-3,"-1,-5"
9974,720575940628157205,right,T2,590,1,9,3,6,"1,9"
9975,720575940608675797,right,T2,591,3,-3,-5,2,"3,-3"
9976,720575940618851613,right,T2,593,3,-14,-10,-4,"3,-14"
9977,720575940609154517,right,T2,594,7,-16,-15,-1,"7,-16"
9978,720575940602922976,right,T2,595,7,-12,-13,1,"7,-12"
9979,720575940633652705,right,T2,596,-4,-16,-4,-12,"-4,-16"
9980,720575940626686845,right,T2,597,4,1,-4,5,"4,1"
9981,720575940622245153,right,T2,598,2,-18,-11,-7,"2,-18"
9982,720575940620906480,right,T2,599,-1,9,5,4,"-1,9"
9983,720575940644010440,right,T2,600,3,-10,-8,-2,"3,-10"
9984,720575940618119169,right,T2,602,4,-2,-5,3,"4,-2"
9985,720575940645176087,right,T2,603,-3,-23,-9,-14,"-3,-23"
9986,720575940623131661,right,T2,604,-6,-17,-3,-14,"-6,-17"
9987,720575940654821025,right,T2,605,3,15,4,11,"3,15"
9988,720575940646405667,right,T2,606,-1,-19,-9,-10,"-1,-19"
9989,720575940619905182,right,T2,607,1,18,8,10,"1,18"
9990,720575940648938873,right,T2,608,1,10,4,6,"1,10"
9991,720575940619912283,right,T2,609,-2,0,2,-2,"-2,0"
9992,720575940620754209,right,T2,610,2,-23,-14,-9,"2,-23"
9993,720575940617700838,right,T2,611,-1,-18,-8,-10,"-1,-18"
9994,720575940626262372,right,T2,612,-3,-26,-10,-16,"-3,-26"
9995,720575940637922111,right,T2,613,-8,-4,6,-10,"-8,-4"
9996,720575940638253022,right,T2,614,-2,-8,-2,-6,"-2,-8"
9997,720575940638150734,right,T2,615,-7,-7,3,-10,"-7,-7"
9998,720575940637154672,right,T2,616,-3,15,10,5,"-3,15"
9999,720575940628987408,right,T2,617,-2,-17,-7,-10,"-2,-17"
10000,720575940626970901,right,T2,618,-1,24,13,11,"-1,24"
10001,720575940608937923,right,T2,619,-4,-19,-6,-13,"-4,-19"
10002,720575940615708831,right,T2,620,7,1,-7,8,"7,1"
10003,720575940625300784,right,T2,621,1,24,11,13,"1,24"
10004,720575940627016281,right,T2,622,-5,20,15,5,"-5,20"
10005,720575940621024577,right,T2,623,1,13,5,8,"1,13"
10006,720575940619938384,right,T2,624,1,-17,-10,-7,"1,-17"
10007,720575940627025738,right,T2,625,-2,24,14,10,"-2,24"
10008,720575940617760596,right,T2,626,-5,-8,1,-9,"-5,-8"
10009,720575940641423824,right,T2,627,0,-1,-1,0,"0,-1"
10010,720575940625802627,right,T2,628,0,0,0,0,"0,0"
10011,720575940620053406,right,T2,629,4,24,8,16,"4,24"
10012,720575940653254902,right,T2,630,4,8,0,8,"4,8"
10013,720575940634849888,right,T2,631,1,26,12,14,"1,26"
10014,720575940624540907,right,T2,632,3,-20,-13,-7,"3,-20"
10015,720575940629425911,right,T2,633,-1,-24,-11,-13,"-1,-24"
10016,720575940624084405,right,T2,634,-3,-15,-5,-10,"-3,-15"
10017,720575940624352041,right,T2,635,6,-6,-9,3,"6,-6"
10018,720575940632213677,right,T2,636,0,6,3,3,"0,6"
10019,720575940629481063,right,T2,637,3,-21,-14,-7,"3,-21"
10020,720575940625852602,right,T2,639,-4,19,13,6,"-4,19"
10021,720575940630731973,right,T2,640,-1,-16,-7,-9,"-1,-16"
10022,720575940630912220,right,T2,641,-8,-5,5,-10,"-8,-5"
10023,720575940632392735,right,T2,642,-5,-11,-1,-10,"-5,-11"
10024,720575940627274298,right,T2,643,6,14,1,13,"6,14"
10025,720575940614499551,right,T2,644,-6,18,15,3,"-6,18"
10026,720575940639831155,right,T2,645,-4,27,17,10,"-4,27"
10027,720575940620658029,right,T2,647,-4,-7,0,-7,"-4,-7"
10028,720575940626326334,right,T2,648,1,7,2,5,"1,7"
10029,720575940622897652,right,T2,649,-1,5,3,2,"-1,5"
10030,720575940632341388,right,T2,650,-3,-25,-10,-15,"-3,-25"
10031,720575940630595415,right,T2,651,-4,-5,1,-6,"-4,-5"
10032,720575940622216012,right,T2,652,-6,-11,0,-11,"-6,-11"
10033,720575940646313507,right,T2,653,-6,-12,0,-12,"-6,-12"
10034,720575940634950239,right,T2,654,-3,8,7,1,"-3,8"
10035,720575940643005325,right,T2,655,6,-1,-7,6,"6,-1"
10036,720575940651975926,right,T2,656,0,-11,-6,-5,"0,-11"
10037,720575940642399989,right,T2,657,-2,-25,-11,-14,"-2,-25"
10038,720575940620611975,right,T2,658,1,20,9,11,"1,20"
10039,720575940623931143,right,T2,659,-4,-6,1,-7,"-4,-6"
10040,720575940618616384,right,T2,660,2,28,12,16,"2,28"
10041,720575940613364338,right,T2,661,-3,14,10,4,"-3,14"
10042,720575940620298223,right,T2,662,2,-1,-3,2,"2,-1"
10043,720575940632574094,right,T2,663,0,8,4,4,"0,8"
10044,720575940642374285,right,T2,664,1,-27,-15,-12,"1,-27"
10045,720575940623253261,right,T2,665,7,-2,-8,6,"7,-2"
10046,720575940642594720,right,T2,666,7,-13,-14,1,"7,-13"
10047,720575940626950148,right,T2,667,1,-28,-15,-13,"1,-28"
10048,720575940632584877,right,T2,668,1,19,8,11,"1,19"
10049,720575940643540168,right,T2,669,4,-16,-12,-4,"4,-16"
10050,720575940630737014,right,T2,671,-4,-23,-8,-15,"-4,-23"
10051,720575940652186102,right,T2,672,-8,11,13,-2,"-8,11"
10052,720575940609470659,right,T2,673,2,5,0,5,"2,5"
10053,720575940620763937,right,T2,674,-4,-14,-3,-11,"-4,-14"
10054,720575940621113782,right,T2,675,-7,19,16,3,"-7,19"
10055,720575940630217436,right,T2,676,-3,-21,-8,-13,"-3,-21"
10056,720575940628138408,right,T2,677,0,11,5,6,"0,11"
10057,720575940622145192,right,T2,678,3,-7,-7,0,"3,-7"
10058,720575940609024451,right,T2,679,4,18,5,13,"4,18"
10059,720575940640046424,right,T2,680,-1,25,13,12,"-1,25"
10060,720575940609852740,right,T2,681,-2,-21,-9,-12,"-2,-21"
10061,720575940627943701,right,T2,682,6,-8,-10,2,"6,-8"
10062,720575940633643033,right,T2,683,2,6,1,5,"2,6"
10063,720575940631185227,right,T2,684,-6,17,14,3,"-6,17"
10064,720575940624195837,right,T2,685,-5,-9,0,-9,"-5,-9"
10065,720575940611780465,right,T2,686,5,-22,-16,-6,"5,-22"
10066,720575940639648829,right,T2,687,-6,-3,4,-7,"-6,-3"
10067,720575940627540241,right,T2,688,-7,10,12,-2,"-7,10"
10068,720575940626681945,right,T2,689,-2,18,11,7,"-2,18"
10069,720575940630434678,right,T2,690,-7,-3,5,-8,"-7,-3"
10070,720575940623978239,right,T2,691,-9,4,11,-7,"-9,4"
10071,720575940625091879,right,T2,692,-4,24,16,8,"-4,24"
10072,720575940611935637,right,T2,693,-3,25,15,10,"-3,25"
10073,720575940623787533,right,T2,694,4,3,-3,6,"4,3"
10074,720575940635206392,right,T2,695,-6,10,11,-1,"-6,10"
10075,720575940617925588,right,T2,696,-2,16,10,6,"-2,16"
10076,720575940617190459,right,T2,697,1,-22,-12,-10,"1,-22"
10077,720575940624872456,right,T2,698,6,-7,-10,3,"6,-7"
10078,720575940617405494,right,T2,699,-5,0,5,-5,"-5,0"
10079,720575940605423282,right,T2,700,5,15,2,13,"5,15"
10080,720575940629533495,right,T2,701,0,-4,-2,-2,"0,-4"
10081,720575940624252308,right,T2,702,-5,23,16,7,"-5,23"
10082,720575940621243045,right,T2,703,-3,1,3,-2,"-3,1"
10083,720575940611560341,right,T2,704,-7,8,11,-3,"-7,8"
10084,720575940615514683,right,T2,705,1,1,-1,2,"1,1"
10085,720575940630444867,right,T2,706,-7,-12,1,-13,"-7,-12"
10086,720575940611924373,right,T2,707,-2,25,14,11,"-2,25"
10087,720575940630838124,right,T2,708,-4,-25,-9,-16,"-4,-25"
10088,720575940638070079,right,T2,709,-2,-24,-10,-14,"-2,-24"
10089,720575940631301932,right,T2,710,4,-25,-17,-8,"4,-25"
10090,720575940617302745,right,T2,711,-1,19,10,9,"-1,19"
10091,720575940621970598,right,T2,712,-7,12,13,-1,"-7,12"
10092,720575940612229349,right,T2,713,-6,16,14,2,"-6,16"
10093,720575940611329230,right,T2,714,5,12,1,11,"5,12"
10094,720575940635766896,right,T2,717,2,-22,-13,-9,"2,-22"
10095,720575940630685241,right,T2,718,-5,24,17,7,"-5,24"
10096,720575940634180377,right,T2,719,1,27,12,15,"1,27"
10097,720575940625309001,right,T2,723,-2,-11,-4,-7,"-2,-11"
10098,720575940632015171,right,T2,724,4,2,-3,5,"4,2"
10099,720575940622375638,right,T2,725,-3,-24,-9,-15,"-3,-24"
10100,720575940612592281,right,T2,726,2,-28,-16,-12,"2,-28"
10101,720575940617416148,right,T2,728,7,12,-1,13,"7,12"
10102,720575940615541590,right,T2,729,-3,29,17,12,"-3,29"
10103,720575940635266740,right,T2,731,-6,9,10,-1,"-6,9"
10104,720575940605735345,right,T2,732,-3,6,6,0,"-3,6"
10105,720575940631094031,right,T2,733,-5,-17,-4,-13,"-5,-17"
10106,720575940625961817,right,T2,734,2,0,-2,2,"2,0"
10107,720575940605028320,right,T2,735,1,-23,-13,-10,"1,-23"
10108,720575940616622849,right,T2,736,-8,1,8,-7,"-8,1"
10109,720575940616486668,right,T2,737,0,19,9,10,"0,19"
10110,720575940623270122,right,T2,738,-3,13,9,4,"-3,13"
10111,720575940620030191,right,T2,739,-7,2,8,-6,"-7,2"
10112,720575940633608674,right,T2,740,2,-8,-6,-2,"2,-8"
10113,720575940612381925,right,T2,741,-2,-14,-5,-9,"-2,-14"
10114,720575940629417342,right,T2,742,-4,11,9,2,"-4,11"
10115,720575940627082511,right,T2,743,6,-19,-16,-3,"6,-19"
10116,720575940655155105,right,T2,744,-4,25,16,9,"-4,25"
10117,720575940628859900,right,T2,745,0,13,6,7,"0,13"
10118,720575940625071132,right,T2,746,-3,3,4,-1,"-3,3"
10119,720575940635579839,right,T2,747,0,2,1,1,"0,2"
10120,720575940610908122,right,T2,750,4,-24,-16,-8,"4,-24"
10121,720575940614861378,right,T2,751,1,6,2,4,"1,6"
10122,720575940632665764,right,T2,752,-2,7,5,2,"-2,7"
10123,720575940629043499,right,T2,753,-3,24,15,9,"-3,24"
10124,720575940640919797,right,T2,755,4,19,5,14,"4,19"
10125,720575940624301641,right,T2,756,5,20,5,15,"5,20"
10126,720575940639913936,right,T2,757,0,-6,-3,-3,"0,-6"
10127,720575940613681778,right,T2,758,5,-1,-6,5,"5,-1"
10128,720575940615686749,right,T2,759,7,14,0,14,"7,14"
10129,720575940611926195,right,T2,760,0,17,8,9,"0,17"
10130,720575940637683775,right,T2,761,-4,-18,-5,-13,"-4,-18"
10131,720575940626721054,right,T2,762,0,14,7,7,"0,14"
10132,720575940629949495,right,T2,763,-5,14,12,2,"-5,14"
10133,720575940640013427,right,T2,764,-8,-6,5,-11,"-8,-6"
10134,720575940638948515,right,T2,765,-3,9,7,2,"-3,9"
10135,720575940619845568,right,T2,766,2,-4,-4,0,"2,-4"
10136,720575940637086576,right,T2,767,1,28,13,15,"1,28"
10137,720575940639251645,right,T2,768,3,5,-1,6,"3,5"
10138,720575940624191669,right,T2,770,5,4,-3,7,"5,4"
10139,720575940625474637,right,T2,771,3,-27,-17,-10,"3,-27"
10140,720575940622563524,right,T2,773,5,-19,-15,-4,"5,-19"
10141,720575940627883367,right,T2,774,-8,6,11,-5,"-8,6"
10142,720575940654906529,right,T2,775,5,22,6,16,"5,22"
10143,720575940612766170,right,T2,776,5,21,5,16,"5,21"
10144,720575940624294729,right,T2,777,6,20,4,16,"6,20"
10145,720575940636908645,right,T2,778,4,25,8,17,"4,25"
10146,720575940621528496,right,T2,780,-6,25,18,7,"-6,25"
10147,720575940621840222,right,T2,781,-5,26,18,8,"-5,26"
10148,720575940618509893,right,T2,783,-4,28,18,10,"-4,28"
10149,720575940646616355,right,T2,785,-3,30,18,12,"-3,30"
10150,720575940638057818,right,T2,786,-2,30,17,13,"-2,30"
10151,720575940624201545,right,T2,787,3,28,11,17,"3,28"
10152,720575940624218665,right,T2,789,-3,-27,-11,-16,"-3,-27"
10153,720575940644243104,right,T2,790,-2,-27,-12,-15,"-2,-27"
10154,720575940660259457,right,T2,791,-1,-28,-13,-15,"-1,-28"
10155,720575940604610225,right,T2,792,8,2,-7,9,"8,2"
10156,720575940638497368,right,T2,794,5,-26,-18,-8,"5,-26"
10157,720575940615465578,right,T2,796,4,26,9,17,"4,26"
10158,720575940617232825,right,T2a,1,-6,13,12,1,"-6,13"
10159,720575940626644111,right,T2a,2,-8,2,9,-7,"-8,2"
10160,720575940620366795,right,T2a,3,6,-12,-12,0,"6,-12"
10161,720575940615327906,right,T2a,4,-5,-21,-6,-15,"-5,-21"
10162,720575940614124967,right,T2a,5,-1,16,9,7,"-1,16"
10163,720575940619653278,right,T2a,6,-2,-4,0,-4,"-2,-4"
10164,720575940624253882,right,T2a,7,-6,-6,3,-9,"-6,-6"
10165,720575940630734244,right,T2a,8,-4,26,17,9,"-4,26"
10166,720575940628772763,right,T2a,9,4,9,0,9,"4,9"
10167,720575940614393297,right,T2a,10,5,-15,-13,-2,"5,-15"
10168,720575940620353520,right,T2a,11,7,-14,-14,0,"7,-14"
10169,720575940627537832,right,T2a,12,-7,9,11,-2,"-7,9"
10170,720575940631600938,right,T2a,13,-1,-26,-12,-14,"-1,-26"
10171,720575940608755977,right,T2a,14,0,-27,-14,-13,"0,-27"
10172,720575940635660399,right,T2a,15,2,-3,-4,1,"2,-3"
10173,720575940622297980,right,T2a,16,-2,-16,-6,-10,"-2,-16"
10174,720575940626270666,right,T2a,17,1,-5,-4,-1,"1,-5"
10175,720575940611133650,right,T2a,18,5,-16,-13,-3,"5,-16"
10176,720575940623798316,right,T2a,19,-7,17,15,2,"-7,17"
10177,720575940640877008,right,T2a,20,3,-11,-9,-2,"3,-11"
10178,720575940624421268,right,T2a,21,-2,19,11,8,"-2,19"
10179,720575940620129857,right,T2a,22,-1,3,2,1,"-1,3"
10180,720575940619058205,right,T2a,23,-3,-16,-5,-11,"-3,-16"
10181,720575940644710510,right,T2a,24,-1,-10,-4,-6,"-1,-10"
10182,720575940622356950,right,T2a,25,-9,3,10,-7,"-9,3"
10183,720575940621521601,right,T2a,26,1,-3,-3,0,"1,-3"
10184,720575940622478716,right,T2a,27,0,-25,-13,-12,"0,-25"
10185,720575940608389385,right,T2a,28,5,6,-2,8,"5,6"
10186,720575940604585504,right,T2a,29,-1,-3,-1,-2,"-1,-3"
10187,720575940636733156,right,T2a,31,0,16,8,8,"0,16"
10188,720575940628021834,right,T2a,32,0,12,6,6,"0,12"
10189,720575940624414205,right,T2a,33,3,18,6,12,"3,18"
10190,720575940616464214,right,T2a,34,6,18,3,15,"6,18"
10191,720575940636503159,right,T2a,35,1,-24,-13,-11,"1,-24"
10192,720575940619451339,right,T2a,36,6,8,-2,10,"6,8"
10193,720575940604415148,right,T2a,37,1,5,1,4,"1,5"
10194,720575940636791438,right,T2a,38,0,-2,-1,-1,"0,-2"
10195,720575940613032434,right,T2a,39,0,20,10,10,"0,20"
10196,720575940612000218,right,T2a,40,-2,-6,-1,-5,"-2,-6"
10197,720575940628007144,right,T2a,41,-3,28,17,11,"-3,28"
10198,720575940626442904,right,T2a,42,-1,14,8,6,"-1,14"
10199,720575940622903309,right,T2a,43,-5,18,14,4,"-5,18"
10200,720575940619078454,right,T2a,44,5,-10,-10,0,"5,-10"
10201,720575940628569243,right,T2a,45,-5,-1,4,-5,"-5,-1"
10202,720575940637644004,right,T2a,46,-5,15,12,3,"-5,15"
10203,720575940629007259,right,T2a,47,-9,-1,8,-9,"-9,-1"
10204,720575940619657381,right,T2a,48,-4,-22,-7,-15,"-4,-22"
10205,720575940627676971,right,T2a,49,4,-4,-6,2,"4,-4"
10206,720575940617427897,right,T2a,50,-2,21,12,9,"-2,21"
10207,720575940615380898,right,T2a,51,0,-19,-10,-9,"0,-19"
10208,720575940623149021,right,T2a,52,-1,-22,-10,-12,"-1,-22"
10209,720575940634452631,right,T2a,53,5,14,2,12,"5,14"
10210,720575940616366709,right,T2a,54,-4,3,5,-2,"-4,3"
10211,720575940624932366,right,T2a,55,-4,-11,-2,-9,"-4,-11"
10212,720575940620925934,right,T2a,56,1,-13,-8,-5,"1,-13"
10213,720575940634199321,right,T2a,57,6,-11,-12,1,"6,-11"
10214,720575940617034589,right,T2a,58,3,12,3,9,"3,12"
10215,720575940619969300,right,T2a,59,-2,2,3,-1,"-2,2"
10216,720575940630842199,right,T2a,60,-8,8,12,-4,"-8,8"
10217,720575940630890344,right,T2a,61,-4,-4,2,-6,"-4,-4"
10218,720575940612727770,right,T2a,63,4,12,2,10,"4,12"
10219,720575940621362452,right,T2a,65,-1,28,15,13,"-1,28"
10220,720575940621375728,right,T2a,66,2,15,5,10,"2,15"
10221,720575940620658091,right,T2a,67,-2,-13,-5,-8,"-2,-13"
10222,720575940606974386,right,T2a,68,3,16,5,11,"3,16"
10223,720575940610492339,right,T2a,69,1,8,3,5,"1,8"
10224,720575940633525134,right,T2a,70,-4,21,14,7,"-4,21"
10225,720575940619579216,right,T2a,71,-2,-3,0,-3,"-2,-3"
10226,720575940630101559,right,T2a,72,0,-28,-14,-14,"0,-28"
10227,720575940616169845,right,T2a,73,2,2,-1,3,"2,2"
10228,720575940619120293,right,T2a,74,-1,-9,-4,-5,"-1,-9"
10229,720575940628289423,right,T2a,75,-6,14,13,1,"-6,14"
10230,720575940635741808,right,T2a,76,-3,-4,1,-5,"-3,-4"
10231,720575940622945515,right,T2a,77,2,-5,-5,0,"2,-5"
10232,720575940625208126,right,T2a,78,2,20,8,12,"2,20"
10233,720575940607930889,right,T2a,79,2,1,-2,3,"2,1"
10234,720575940638145087,right,T2a,80,4,13,2,11,"4,13"
10235,720575940640296576,right,T2a,81,6,-2,-7,5,"6,-2"
10236,720575940620443014,right,T2a,82,-7,7,10,-3,"-7,7"
10237,720575940612082602,right,T2a,83,2,-21,-13,-8,"2,-21"
10238,720575940622120998,right,T2a,84,-2,12,8,4,"-2,12"
10239,720575940605799712,right,T2a,85,4,-22,-15,-7,"4,-22"
10240,720575940620248769,right,T2a,87,1,11,4,7,"1,11"
10241,720575940622501069,right,T2a,88,7,4,-5,9,"7,4"
10242,720575940621020993,right,T2a,90,-4,5,6,-1,"-4,5"
10243,720575940622581801,right,T2a,91,-1,6,4,2,"-1,6"
10244,720575940631363651,right,T2a,92,0,9,4,5,"0,9"
10245,720575940627675983,right,T2a,93,-6,3,7,-4,"-6,3"
10246,720575940628233468,right,T2a,94,5,18,4,14,"5,18"
10247,720575940617421110,right,T2a,95,4,-21,-15,-6,"4,-21"
10248,720575940630980311,right,T2a,96,1,-10,-6,-4,"1,-10"
10249,720575940604336049,right,T2a,97,-5,2,6,-4,"-5,2"
10250,720575940621985089,right,T2a,98,-1,-12,-5,-7,"-1,-12"
10251,720575940633667923,right,T2a,100,2,-10,-7,-3,"2,-10"
10252,720575940635531956,right,T2a,101,-7,6,10,-4,"-7,6"
10253,720575940627315989,right,T2a,102,3,13,3,10,"3,13"
10254,720575940623195085,right,T2a,104,-1,-27,-13,-14,"-1,-27"
10255,720575940638148698,right,T2a,105,3,22,8,14,"3,22"
10256,720575940633371859,right,T2a,106,-7,11,12,-1,"-7,11"
10257,720575940620275220,right,T2a,107,8,-2,-9,7,"8,-2"
10258,720575940636748766,right,T2a,108,-3,-12,-3,-9,"-3,-12"
10259,720575940608742923,right,T2a,109,4,-5,-7,2,"4,-5"
10260,720575940613738035,right,T2a,110,-7,0,7,-7,"-7,0"
10261,720575940625288323,right,T2a,111,2,-24,-14,-10,"2,-24"
10262,720575940624253939,right,T2a,112,-6,1,6,-5,"-6,1"
10263,720575940632209038,right,T2a,113,-2,4,4,0,"-2,4"
10264,720575940627013465,right,T2a,114,2,-13,-9,-4,"2,-13"
10265,720575940626640659,right,T2a,115,-4,2,5,-3,"-4,2"
10266,720575940639771776,right,T2a,116,-1,-8,-3,-5,"-1,-8"
10267,720575940626009274,right,T2a,117,-8,-2,7,-9,"-8,-2"
10268,720575940639352893,right,T2a,118,3,1,-3,4,"3,1"
10269,720575940609070531,right,T2a,119,-2,6,5,1,"-2,6"
10270,720575940609313860,right,T2a,120,-1,-1,0,-1,"-1,-1"
10271,720575940620042886,right,T2a,121,-8,4,10,-6,"-8,4"
10272,720575940645803287,right,T2a,122,-5,9,9,0,"-5,9"
10273,720575940614111711,right,T2a,123,-8,10,13,-3,"-8,10"
10274,720575940629938220,right,T2a,124,1,-7,-5,-2,"1,-7"
10275,720575940630504279,right,T2a,125,5,9,-1,10,"5,9"
10276,720575940621723004,right,T2a,126,3,11,2,9,"3,11"
10277,720575940632375950,right,T2a,127,0,15,7,8,"0,15"
10278,720575940605823422,right,T2a,128,3,-22,-14,-8,"3,-22"
10279,720575940628504326,right,T2a,129,0,-13,-7,-6,"0,-13"
10280,720575940622631448,right,T2a,130,2,12,4,8,"2,12"
10281,720575940639864739,right,T2a,131,-6,20,16,4,"-6,20"
10282,720575940626711427,right,T2a,132,2,4,0,4,"2,4"
10283,720575940626897964,right,T2a,133,-3,20,13,7,"-3,20"
10284,720575940610140878,right,T2a,134,-5,-18,-4,-14,"-5,-18"
10285,720575940626504476,right,T2a,135,-3,-22,-8,-14,"-3,-22"
10286,720575940616890708,right,T2a,136,0,3,1,2,"0,3"
10287,720575940633340589,right,T2a,137,5,-7,-9,2,"5,-7"
10288,720575940630604860,right,T2a,138,0,27,13,14,"0,27"
10289,720575940622810506,right,T2a,139,1,-14,-8,-6,"1,-14"
10290,720575940630568535,right,T2a,140,3,8,1,7,"3,8"
10291,720575940640513907,right,T2a,142,-2,-18,-7,-11,"-2,-18"
10292,720575940629705577,right,T2a,143,-4,16,12,4,"-4,16"
10293,720575940644574756,right,T2a,144,7,-11,-13,2,"7,-11"
10294,720575940619234353,right,T2a,145,0,4,2,2,"0,4"
10295,720575940620848110,right,T2a,146,1,-6,-4,-2,"1,-6"
10296,720575940646535203,right,T2a,147,1,21,9,12,"1,21"
10297,720575940635183002,right,T2a,149,6,-14,-13,-1,"6,-14"
10298,720575940620335270,right,T2a,150,-8,5,10,-5,"-8,5"
10299,720575940634877039,right,T2a,151,-3,-14,-4,-10,"-3,-14"
10300,720575940619250590,right,T2a,152,3,-15,-11,-4,"3,-15"
10301,720575940620571819,right,T2a,153,8,0,-8,8,"8,0"
10302,720575940631704271,right,T2a,154,-8,0,8,-8,"-8,0"
10303,720575940620729510,right,T2a,155,-8,13,14,-1,"-8,13"
10304,720575940614046114,right,T2a,156,-9,1,9,-8,"-9,1"
10305,720575940631750727,right,T2a,157,-1,-7,-3,-4,"-1,-7"
10306,720575940620218862,right,T2a,158,3,-5,-6,1,"3,-5"
10307,720575940614624146,right,T2a,159,7,7,-4,11,"7,7"
10308,720575940609782997,right,T2a,160,-2,20,12,8,"-2,20"
10309,720575940626942077,right,T2a,161,4,-14,-11,-3,"4,-14"
10310,720575940622347755,right,T2a,162,-4,-2,3,-5,"-4,-2"
10311,720575940636070519,right,T2a,163,-9,7,12,-5,"-9,7"
10312,720575940626771143,right,T2a,164,-1,-2,0,-2,"-1,-2"
10313,720575940618526262,right,T2a,165,4,16,4,12,"4,16"
10314,720575940628310121,right,T2a,166,0,18,9,9,"0,18"
10315,720575940611495214,right,T2a,167,0,-17,-9,-8,"0,-17"
10316,720575940619740481,right,T2a,168,-1,17,9,8,"-1,17"
10317,720575940623171085,right,T2a,169,0,-18,-9,-9,"0,-18"
10318,720575940626156419,right,T2a,170,-5,1,5,-4,"-5,1"
10319,720575940621411649,right,T2a,172,1,22,10,12,"1,22"
10320,720575940611857138,right,T2a,173,2,-25,-15,-10,"2,-25"
10321,720575940626981647,right,T2a,174,4,-15,-12,-3,"4,-15"
10322,720575940626381570,right,T2a,175,-6,-7,2,-9,"-6,-7"
10323,720575940626168965,right,T2a,176,-2,13,8,5,"-2,13"
10324,720575940623381941,right,T2a,177,-2,-1,1,-2,"-2,-1"
10325,720575940631227599,right,T2a,178,2,11,3,8,"2,11"
10326,720575940622127871,right,T2a,179,-5,-16,-3,-13,"-5,-16"
10327,720575940624333385,right,T2a,180,2,-27,-16,-11,"2,-27"
10328,720575940623780877,right,T2a,181,1,-4,-3,-1,"1,-4"
10329,720575940628385866,right,T2a,183,-5,-15,-3,-12,"-5,-15"
10330,720575940630327547,right,T2a,184,-6,-5,3,-8,"-6,-5"
10331,720575940610689326,right,T2a,185,2,-11,-8,-3,"2,-11"
10332,720575940630337591,right,T2a,186,-1,26,14,12,"-1,26"
10333,720575940629016791,right,T2a,187,3,21,7,14,"3,21"
10334,720575940624642803,right,T2a,188,-5,17,13,4,"-5,17"
10335,720575940610712930,right,T2a,189,6,13,0,13,"6,13"
10336,720575940616226747,right,T2a,190,-3,-5,0,-5,"-3,-5"
10337,720575940623929863,right,T2a,191,-1,-11,-5,-6,"-1,-11"
10338,720575940627192164,right,T2a,192,7,10,-2,12,"7,10"
10339,720575940607972956,right,T2a,193,-5,4,7,-3,"-5,4"
10340,720575940621160468,right,T2a,194,0,-5,-3,-2,"0,-5"
10341,720575940616920347,right,T2a,195,-3,-1,2,-3,"-3,-1"
10342,720575940643507764,right,T2a,196,-1,8,5,3,"-1,8"
10343,720575940623228184,right,T2a,197,0,-20,-10,-10,"0,-20"
10344,720575940617654673,right,T2a,198,6,2,-5,7,"6,2"
10345,720575940623209677,right,T2a,199,0,-12,-6,-6,"0,-12"
10346,720575940627305833,right,T2a,200,-5,12,11,1,"-5,12"
10347,720575940619951342,right,T2a,201,-8,9,12,-3,"-8,9"
10348,720575940620602351,right,T2a,202,-1,27,14,13,"-1,27"
10349,720575940643512372,right,T2a,203,3,-1,-4,3,"3,-1"
10350,720575940619075566,right,T2a,204,5,-2,-6,4,"5,-2"
10351,720575940618277456,right,T2a,205,5,-6,-8,2,"5,-6"
10352,720575940628836908,right,T2a,206,-3,5,5,0,"-3,5"
10353,720575940632165944,right,T2a,207,1,29,13,16,"1,29"
10354,720575940621391087,right,T2a,208,5,-21,-16,-5,"5,-21"
10355,720575940619436337,right,T2a,209,-3,-8,-1,-7,"-3,-8"
10356,720575940612293273,right,T2a,210,-6,8,10,-2,"-6,8"
10357,720575940641114676,right,T2a,211,-7,-1,6,-7,"-7,-1"
10358,720575940615466911,right,T2a,212,2,-16,-10,-6,"2,-16"
10359,720575940635444398,right,T2a,213,3,-4,-5,1,"3,-4"
10360,720575940659975297,right,T2a,214,-5,3,6,-3,"-5,3"
10361,720575940634470114,right,T2a,215,6,7,-3,10,"6,7"
10362,720575940618555321,right,T2a,216,2,19,7,12,"2,19"
10363,720575940617523746,right,T2a,217,6,15,1,14,"6,15"
10364,720575940624293961,right,T2a,218,2,10,3,7,"2,10"
10365,720575940634720248,right,T2a,219,6,-4,-8,4,"6,-4"
10366,720575940632831775,right,T2a,220,2,-6,-5,-1,"2,-6"
10367,720575940614696242,right,T2a,221,-7,3,8,-5,"-7,3"
10368,720575940606129854,right,T2a,222,-3,26,16,10,"-3,26"
10369,720575940623194504,right,T2a,223,-2,26,15,11,"-2,26"
10370,720575940624204984,right,T2a,224,0,5,2,3,"0,5"
10371,720575940612124785,right,T2a,225,2,-26,-15,-11,"2,-26"
10372,720575940630675474,right,T2a,226,5,19,4,15,"5,19"
10373,720575940638597941,right,T2a,227,-7,5,9,-4,"-7,5"
10374,720575940629369026,right,T2a,228,-7,1,7,-6,"-7,1"
10375,720575940637251703,right,T2a,229,5,2,-4,6,"5,2"
10376,720575940623658461,right,T2a,230,2,9,2,7,"2,9"
10377,720575940620336549,right,T2a,231,4,-12,-10,-2,"4,-12"
10378,720575940625154568,right,T2a,232,-4,13,10,3,"-4,13"
10379,720575940650015609,right,T2a,233,4,-13,-11,-2,"4,-13"
10380,720575940620971696,right,T2a,234,1,3,0,3,"1,3"
10381,720575940616684082,right,T2a,235,4,11,1,10,"4,11"
10382,720575940638505038,right,T2a,236,-1,4,3,1,"-1,4"
10383,720575940635120223,right,T2a,237,-2,27,15,12,"-2,27"
10384,720575940617904614,right,T2a,238,-8,-3,6,-9,"-8,-3"
10385,720575940620666704,right,T2a,239,-6,6,9,-3,"-6,6"
10386,720575940635458040,right,T2a,240,-4,-3,2,-5,"-4,-3"
10387,720575940626986014,right,T2a,241,2,-17,-11,-6,"2,-17"
10388,720575940604013926,right,T2a,242,-4,6,7,-1,"-4,6"
10389,720575940630582777,right,T2a,243,-1,-21,-10,-11,"-1,-21"
10390,720575940633210323,right,T2a,244,-4,-12,-2,-10,"-4,-12"
10391,720575940635143263,right,T2a,245,-5,-3,3,-6,"-5,-3"
10392,720575940622199164,right,T2a,246,-4,15,11,4,"-4,15"
10393,720575940624970168,right,T2a,247,-4,-15,-4,-11,"-4,-15"
10394,720575940632063116,right,T2a,248,-6,0,6,-6,"-6,0"
10395,720575940634604442,right,T2a,249,2,-12,-8,-4,"2,-12"
10396,720575940615187250,right,T2a,250,-1,1,1,0,"-1,1"
10397,720575940624591177,right,T2a,251,-1,-14,-6,-8,"-1,-14"
10398,720575940615750047,right,T2a,252,3,23,8,15,"3,23"
10399,720575940615121986,right,T2a,253,5,16,3,13,"5,16"
10400,720575940621657441,right,T2a,254,3,-24,-15,-9,"3,-24"
10401,720575940629337082,right,T2a,255,-6,-13,-1,-12,"-6,-13"
10402,720575940631912519,right,T2a,257,2,21,8,13,"2,21"
10403,720575940627543061,right,T2a,258,-4,-17,-5,-12,"-4,-17"
10404,720575940635162475,right,T2a,259,-7,-5,4,-9,"-7,-5"
10405,720575940645587566,right,T2a,260,-3,19,12,7,"-3,19"
10406,720575940620191168,right,T2a,261,-1,13,7,6,"-1,13"
10407,720575940630908631,right,T2a,262,1,-11,-7,-4,"1,-11"
10408,720575940628570186,right,T2a,263,-3,4,5,-1,"-3,4"
10409,720575940630983223,right,T2a,264,-1,-6,-2,-4,"-1,-6"
10410,720575940617334758,right,T2a,265,-6,-1,5,-6,"-6,-1"
10411,720575940622581226,right,T2a,266,-1,-25,-12,-13,"-1,-25"
10412,720575940618050880,right,T2a,267,-6,2,7,-5,"-6,2"
10413,720575940646347299,right,T2a,268,7,-6,-10,4,"7,-6"
10414,720575940615862459,right,T2a,269,2,-19,-12,-7,"2,-19"
10415,720575940623541483,right,T2a,270,1,-8,-5,-3,"1,-8"
10416,720575940620273946,right,T2a,271,4,6,-1,7,"4,6"
10417,720575940641328692,right,T2a,272,3,-2,-4,2,"3,-2"
10418,720575940611601250,right,T2a,273,-6,23,17,6,"-6,23"
10419,720575940619049125,right,T2a,274,6,4,-4,8,"6,4"
10420,720575940615697314,right,T2a,275,-8,-1,7,-8,"-8,-1"
10421,720575940627044358,right,T2a,276,2,3,-1,4,"2,3"
10422,720575940614444967,right,T2a,277,7,-3,-9,6,"7,-3"
10423,720575940621744508,right,T2a,278,-5,10,10,0,"-5,10"
10424,720575940628440698,right,T2a,279,-4,8,8,0,"-4,8"
10425,720575940627430202,right,T2a,280,-6,-14,-1,-13,"-6,-14"
10426,720575940615982965,right,T2a,281,-9,2,10,-8,"-9,2"
10427,720575940609973060,right,T2a,282,0,26,13,13,"0,26"
10428,720575940628745063,right,T2a,283,-4,4,6,-2,"-4,4"
10429,720575940626404807,right,T2a,284,0,25,12,13,"0,25"
10430,720575940646276387,right,T2a,285,6,-18,-15,-3,"6,-18"
10431,720575940632594084,right,T2a,286,0,-24,-12,-12,"0,-24"
10432,720575940633858958,right,T2a,287,-5,13,11,2,"-5,13"
10433,720575940632066834,right,T2a,288,-1,30,16,14,"-1,30"
10434,720575940635207781,right,T2a,289,-1,11,6,5,"-1,11"
10435,720575940621277044,right,T2a,290,5,-24,-17,-7,"5,-24"
10436,720575940623082595,right,T2a,291,7,2,-6,8,"7,2"
10437,720575940635602783,right,T2a,292,-4,18,13,5,"-4,18"
10438,720575940632366675,right,T2a,293,4,-17,-13,-4,"4,-17"
10439,720575940623647256,right,T2a,294,1,-20,-11,-9,"1,-20"
10440,720575940617065522,right,T2a,295,-2,29,16,13,"-2,29"
10441,720575940618370885,right,T2a,296,1,-18,-10,-8,"1,-18"
10442,720575940643586868,right,T2a,298,-5,5,7,-2,"-5,5"
10443,720575940633858446,right,T2a,299,-4,12,10,2,"-4,12"
10444,720575940613909475,right,T2a,300,4,-18,-13,-5,"4,-18"
10445,720575940621832197,right,T2a,301,-5,16,13,3,"-5,16"
10446,720575940645194606,right,T2a,302,2,17,6,11,"2,17"
10447,720575940607278345,right,T2a,303,-5,22,16,6,"-5,22"
10448,720575940623631031,right,T2a,304,6,5,-4,9,"6,5"
10449,720575940634024599,right,T2a,305,-7,4,9,-5,"-7,4"
10450,720575940616891707,right,T2a,306,3,7,0,7,"3,7"
10451,720575940619807793,right,T2a,307,5,-25,-18,-7,"5,-25"
10452,720575940622346590,right,T2a,308,-5,8,9,-1,"-5,8"
10453,720575940630225377,right,T2a,309,-6,12,12,0,"-6,12"
10454,720575940633532898,right,T2a,310,2,22,9,13,"2,22"
10455,720575940603333804,right,T2a,311,-7,15,14,1,"-7,15"
10456,720575940616001804,right,T2a,312,4,-7,-8,1,"4,-7"
10457,720575940617017305,right,T2a,313,7,3,-6,9,"7,3"
10458,720575940632313675,right,T2a,314,-9,5,11,-6,"-9,5"
10459,720575940613776435,right,T2a,315,-3,-6,0,-6,"-3,-6"
10460,720575940615709762,right,T2a,316,5,-4,-7,3,"5,-4"
10461,720575940629251194,right,T2a,317,-5,-4,3,-7,"-5,-4"
10462,720575940619821677,right,T2a,318,4,-19,-14,-5,"4,-19"
10463,720575940623428681,right,T2a,319,-2,5,4,1,"-2,5"
10464,720575940610902226,right,T2a,320,-2,-5,-1,-4,"-2,-5"
10465,720575940624107144,right,T2a,321,8,4,-6,10,"8,4"
10466,720575940623714794,right,T2a,322,2,26,11,15,"2,26"
10467,720575940622994884,right,T2a,323,-7,-13,0,-13,"-7,-13"
10468,720575940622036044,right,T2a,324,3,24,9,15,"3,24"
10469,720575940613428195,right,T2a,325,5,1,-5,6,"5,1"
10470,720575940635134576,right,T2a,326,2,16,6,10,"2,16"
10471,720575940617402139,right,T2a,327,5,3,-4,7,"5,3"
10472,720575940624752364,right,T2a,328,5,-9,-10,1,"5,-9"
10473,720575940613288857,right,T2a,329,0,24,12,12,"0,24"
10474,720575940635207092,right,T2a,330,3,3,-2,5,"3,3"
10475,720575940626925583,right,T2a,331,1,-15,-9,-6,"1,-15"
10476,720575940634510176,right,T2a,332,4,-26,-17,-9,"4,-26"
10477,720575940628717073,right,T2a,333,0,-21,-11,-10,"0,-21"
10478,720575940627918611,right,T2a,334,1,-26,-14,-12,"1,-26"
10479,720575940628810139,right,T2a,335,2,8,2,6,"2,8"
10480,720575940634896480,right,T2a,336,0,23,11,12,"0,23"
10481,720575940606973826,right,T2a,337,-5,-6,2,-8,"-5,-6"
10482,720575940613384913,right,T2a,338,-1,0,1,-1,"-1,0"
10483,720575940627520455,right,T2a,339,6,11,-1,12,"6,11"
10484,720575940623748813,right,T2a,340,-4,17,12,5,"-4,17"
10485,720575940622941464,right,T2a,341,6,-17,-15,-2,"6,-17"
10486,720575940618165661,right,T2a,342,2,-15,-10,-5,"2,-15"
10487,720575940631105956,right,T2a,343,-3,27,16,11,"-3,27"
10488,720575940620698704,right,T2a,344,-2,-15,-6,-9,"-2,-15"
10489,720575940605483977,right,T2a,345,3,-12,-9,-3,"3,-12"
10490,720575940623860477,right,T2a,346,-7,-9,2,-11,"-7,-9"
10491,720575940624018939,right,T2a,347,-5,-13,-2,-11,"-5,-13"
10492,720575940625572901,right,T2a,348,3,14,4,10,"3,14"
10493,720575940630412842,right,T2a,349,-5,-14,-2,-12,"-5,-14"
10494,720575940638801597,right,T2a,350,1,15,6,9,"1,15"
10495,720575940611089618,right,T2a,351,-1,-17,-8,-9,"-1,-17"
10496,720575940632433747,right,T2a,352,-2,28,16,12,"-2,28"
10497,720575940620803499,right,T2a,353,2,24,10,14,"2,24"
10498,720575940615320482,right,T2a,354,-2,-26,-11,-15,"-2,-26"
10499,720575940616972486,right,T2a,355,-7,-6,4,-10,"-7,-6"
10500,720575940614651298,right,T2a,356,0,22,11,11,"0,22"
10501,720575940628600143,right,T2a,357,4,17,4,13,"4,17"
10502,720575940630979279,right,T2a,358,-3,17,11,6,"-3,17"
10503,720575940626928968,right,T2a,359,2,23,9,14,"2,23"
10504,720575940627089801,right,T2a,360,-5,19,14,5,"-5,19"
10505,720575940627310394,right,T2a,361,0,-7,-4,-3,"0,-7"
10506,720575940625108412,right,T2a,363,7,-4,-9,5,"7,-4"
10507,720575940628902120,right,T2a,364,4,4,-2,6,"4,4"
10508,720575940619684288,right,T2a,365,4,7,-1,8,"4,7"
10509,720575940615905036,right,T2a,366,-5,-20,-5,-15,"-5,-20"
10510,720575940615607362,right,T2a,367,-6,-15,-2,-13,"-6,-15"
10511,720575940629188967,right,T2a,368,-4,-20,-6,-14,"-4,-20"
10512,720575940632628644,right,T2a,369,5,-5,-8,3,"5,-5"
10513,720575940629756663,right,T2a,370,-3,21,13,8,"-3,21"
10514,720575940645067316,right,T2a,371,6,-5,-9,4,"6,-5"
10515,720575940619604756,right,T2a,372,1,-2,-2,0,"1,-2"
10516,720575940623768781,right,T2a,373,1,-21,-12,-9,"1,-21"
10517,720575940644599063,right,T2a,374,2,13,4,9,"2,13"
10518,720575940622150614,right,T2a,375,-6,7,9,-2,"-6,7"
10519,720575940626937602,right,T2a,376,-7,-10,2,-12,"-7,-10"
10520,720575940639495512,right,T2a,377,0,7,3,4,"0,7"
10521,720575940633793249,right,T2a,378,-3,18,12,6,"-3,18"
10522,720575940628371671,right,T2a,379,3,-17,-12,-5,"3,-17"
10523,720575940629125675,right,T2a,380,-1,29,15,14,"-1,29"
10524,720575940631960633,right,T2a,381,-8,-9,3,-12,"-8,-9"
10525,720575940614793122,right,T2a,382,3,-6,-6,0,"3,-6"
10526,720575940627046931,right,T2a,383,-6,11,11,0,"-6,11"
10527,720575940624614292,right,T2a,384,-6,-2,5,-7,"-6,-2"
10528,720575940620692318,right,T2a,385,-3,-18,-6,-12,"-3,-18"
10529,720575940620418987,right,T2a,386,-6,19,15,4,"-6,19"
10530,720575940635263156,right,T2a,387,-1,-15,-7,-8,"-1,-15"
10531,720575940630902469,right,T2a,388,3,19,6,13,"3,19"
10532,720575940630751183,right,T2a,389,-6,-16,-2,-14,"-6,-16"
10533,720575940626618895,right,T2a,390,-6,-9,1,-10,"-6,-9"
10534,720575940632487213,right,T2a,391,4,-3,-6,3,"4,-3"
10535,720575940621648019,right,T2a,392,-4,7,7,0,"-4,7"
10536,720575940643554852,right,T2a,393,-1,22,12,10,"-1,22"
10537,720575940660628609,right,T2a,394,-7,-8,3,-11,"-7,-8"
10538,720575940641363701,right,T2a,395,0,-22,-11,-11,"0,-22"
10539,720575940627088940,right,T2a,396,-1,10,6,4,"-1,10"
10540,720575940609069507,right,T2a,397,-3,-19,-7,-12,"-3,-19"
10541,720575940627089033,right,T2a,398,-3,22,14,8,"-3,22"
10542,720575940637979226,right,T2a,399,-4,-24,-8,-16,"-4,-24"
10543,720575940628457018,right,T2a,400,1,-29,-16,-13,"1,-29"
10544,720575940631895400,right,T2a,402,3,26,10,16,"3,26"
10545,720575940619858928,right,T2a,403,-2,-12,-4,-8,"-2,-12"
10546,720575940626914092,right,T2a,404,-1,20,11,9,"-1,20"
10547,720575940625414288,right,T2a,405,3,10,2,8,"3,10"
10548,720575940635671220,right,T2a,406,1,-25,-14,-11,"1,-25"
10549,720575940626372354,right,T2a,407,-5,-10,0,-10,"-5,-10"
10550,720575940638265577,right,T2a,408,-6,-4,4,-8,"-6,-4"
10551,720575940639007039,right,T2a,409,0,-3,-2,-1,"0,-3"
10552,720575940620631990,right,T2a,410,-2,-2,1,-3,"-2,-2"
10553,720575940625647768,right,T2a,411,-5,-19,-5,-14,"-5,-19"
10554,720575940620458004,right,T2a,412,-6,21,16,5,"-6,21"
10555,720575940614520999,right,T2a,413,-2,-7,-2,-5,"-2,-7"
10556,720575940660049537,right,T2a,414,4,21,6,15,"4,21"
10557,720575940633887955,right,T2a,415,6,12,0,12,"6,12"
10558,720575940628572521,right,T2a,416,3,-8,-7,-1,"3,-8"
10559,720575940626659343,right,T2a,417,-6,-10,1,-11,"-6,-10"
10560,720575940623407812,right,T2a,418,-2,15,9,6,"-2,15"
10561,720575940608992469,right,T2a,419,-3,-11,-3,-8,"-3,-11"
10562,720575940612263321,right,T2a,420,6,-3,-8,5,"6,-3"
10563,720575940627088684,right,T2a,421,-1,12,7,5,"-1,12"
10564,720575940622784717,right,T2a,422,-7,-4,5,-9,"-7,-4"
10565,720575940636647822,right,T2a,423,3,-18,-12,-6,"3,-18"
10566,720575940627249541,right,T2a,424,-3,-2,2,-4,"-3,-2"
10567,720575940628290033,right,T2a,425,3,20,7,13,"3,20"
10568,720575940630356956,right,T2a,426,-3,0,3,-3,"-3,0"
10569,720575940627289449,right,T2a,427,5,-18,-14,-4,"5,-18"
10570,720575940615151722,right,T2a,428,-2,23,13,10,"-2,23"
10571,720575940617236665,right,T2a,429,-2,14,9,5,"-2,14"
10572,720575940614593170,right,T2a,430,-3,-7,-1,-6,"-3,-7"
10573,720575940608534281,right,T2a,431,-2,-10,-3,-7,"-2,-10"
10574,720575940625703098,right,T2a,432,-5,7,8,-1,"-5,7"
10575,720575940620091216,right,T2a,433,0,-8,-4,-4,"0,-8"
10576,720575940632666276,right,T2a,434,-3,7,6,1,"-3,7"
10577,720575940639692659,right,T2a,435,5,-17,-14,-3,"5,-17"
10578,720575940618782800,right,T2a,436,0,-15,-8,-7,"0,-15"
10579,720575940609623253,right,T2a,437,-3,12,9,3,"-3,12"
10580,720575940624167176,right,T2a,438,2,27,11,16,"2,27"
10581,720575940631781945,right,T2a,439,-3,-9,-2,-7,"-3,-9"
10582,720575940622029960,right,T2a,440,1,23,10,13,"1,23"
10583,720575940613480367,right,T2a,441,3,-16,-11,-5,"3,-16"
10584,720575940635398551,right,T2a,442,-5,25,17,8,"-5,25"
10585,720575940632666020,right,T2a,443,-6,4,8,-4,"-6,4"
10586,720575940623423880,right,T2a,444,4,-10,-9,-1,"4,-10"
10587,720575940611993523,right,T2a,445,-2,8,6,2,"-2,8"
10588,720575940635276698,right,T2a,446,2,-14,-9,-5,"2,-14"
10589,720575940616825062,right,T2a,447,-1,2,2,0,"-1,2"
10590,720575940621019501,right,T2a,449,6,-16,-14,-2,"6,-16"
10591,720575940623494697,right,T2a,450,2,-9,-7,-2,"2,-9"
10592,720575940622763997,right,T2a,451,4,20,6,14,"4,20"
10593,720575940632215251,right,T2a,452,1,-9,-6,-3,"1,-9"
10594,720575940617333307,right,T2a,453,3,25,9,16,"3,25"
10595,720575940641187829,right,T2a,454,5,-12,-11,-1,"5,-12"
10596,720575940629773306,right,T2a,455,7,-7,-11,4,"7,-7"
10597,720575940612035697,right,T2a,456,0,21,10,11,"0,21"
10598,720575940626730268,right,T2a,457,-2,17,10,7,"-2,17"
10599,720575940623640247,right,T2a,458,5,0,-5,5,"5,0"
10600,720575940619794598,right,T2a,459,5,-3,-7,4,"5,-3"
10601,720575940615212511,right,T2a,460,-3,-20,-7,-13,"-3,-20"
10602,720575940610268017,right,T2a,461,7,-5,-10,5,"7,-5"
10603,720575940632409230,right,T2a,462,-1,18,10,8,"-1,18"
10604,720575940647803524,right,T2a,463,5,17,3,14,"5,17"
10605,720575940639585112,right,T2a,464,4,0,-4,4,"4,0"
10606,720575940618863153,right,T2a,465,3,0,-3,3,"3,0"
10607,720575940621353972,right,T2a,466,1,14,6,8,"1,14"
10608,720575940636709231,right,T2a,467,-2,-20,-8,-12,"-2,-20"
10609,720575940604508960,right,T2a,468,-3,11,8,3,"-3,11"
10610,720575940633210846,right,T2a,469,-7,13,13,0,"-7,13"
10611,720575940621303535,right,T2a,470,4,-9,-9,0,"4,-9"
10612,720575940632356367,right,T2a,471,3,-26,-16,-10,"3,-26"
10613,720575940638291263,right,T2a,472,1,25,11,14,"1,25"
10614,720575940621362753,right,T2a,473,-4,23,15,8,"-4,23"
10615,720575940624280555,right,T2a,474,-3,-17,-6,-11,"-3,-17"
10616,720575940613149146,right,T2a,475,-4,-1,3,-4,"-4,-1"
10617,720575940622145037,right,T2a,476,-1,15,8,7,"-1,15"
10618,720575940613127976,right,T2a,477,-3,2,4,-2,"-3,2"
10619,720575940608857557,right,T2a,478,-7,16,15,1,"-7,16"
10620,720575940629657687,right,T2a,479,-2,10,7,3,"-2,10"
10621,720575940624253163,right,T2a,480,3,-19,-13,-6,"3,-19"
10622,720575940635197547,right,T2a,481,4,-8,-8,0,"4,-8"
10623,720575940623682997,right,T2a,482,1,17,7,10,"1,17"
10624,720575940638349631,right,T2a,483,2,-7,-6,-1,"2,-7"
10625,720575940622224884,right,T2a,484,3,-9,-8,-1,"3,-9"
10626,720575940614526119,right,T2a,485,-3,-3,1,-4,"-3,-3"
10627,720575940623879916,right,T2a,486,0,1,0,1,"0,1"
10628,720575940620551777,right,T2a,487,1,-1,-2,1,"1,-1"
10629,720575940640854656,right,T2a,488,7,5,-5,10,"7,5"
10630,720575940624980467,right,T2a,489,-3,10,8,2,"-3,10"
10631,720575940613860915,right,T2a,490,-5,6,8,-2,"-5,6"
10632,720575940638102106,right,T2a,491,7,-1,-8,7,"7,-1"
10633,720575940632416543,right,T2a,492,-7,-2,6,-8,"-7,-2"
10634,720575940620665990,right,T2a,493,-3,23,14,9,"-3,23"
10635,720575940614747810,right,T2a,494,0,29,14,15,"0,29"
10636,720575940613428451,right,T2a,495,4,5,-2,7,"4,5"
10637,720575940627272325,right,T2a,496,7,8,-3,11,"7,8"
10638,720575940616990837,right,T2a,497,6,1,-6,7,"6,1"
10639,720575940620191425,right,T2a,498,6,10,-1,11,"6,10"
10640,720575940645138632,right,T2a,499,5,10,0,10,"5,10"
10641,720575940614242257,right,T2a,500,7,-8,-11,3,"7,-8"
10642,720575940624067367,right,T2a,501,1,2,0,2,"1,2"
10643,720575940632719244,right,T2a,502,5,8,-1,9,"5,8"
10644,720575940619120088,right,T2a,503,3,17,5,12,"3,17"
10645,720575940630013822,right,T2a,504,-2,9,6,3,"-2,9"
10646,720575940627761210,right,T2a,505,6,-22,-17,-5,"6,-22"
10647,720575940625892912,right,T2a,506,1,-12,-7,-5,"1,-12"
10648,720575940640149813,right,T2a,507,-5,-12,-1,-11,"-5,-12"
10649,720575940639582627,right,T2a,508,-5,11,10,1,"-5,11"
10650,720575940633852046,right,T2a,509,-4,10,9,1,"-4,10"
10651,720575940621020598,right,T2a,510,-2,11,7,4,"-2,11"
10652,720575940626425700,right,T2a,511,5,-11,-11,0,"5,-11"
10653,720575940606860721,right,T2a,512,6,0,-6,6,"6,0"
10654,720575940610946266,right,T2a,513,-4,-13,-3,-10,"-4,-13"
10655,720575940629411966,right,T2a,514,-4,-10,-1,-9,"-4,-10"
10656,720575940618968222,right,T2a,515,-8,-7,4,-11,"-8,-7"
10657,720575940624702222,right,T2a,516,7,-18,-16,-2,"7,-18"
10658,720575940617712273,right,T2a,517,6,3,-5,8,"6,3"
10659,720575940607081161,right,T2a,518,-4,22,15,7,"-4,22"
10660,720575940630771564,right,T2a,519,-5,-5,2,-7,"-5,-5"
10661,720575940629703939,right,T2a,520,-2,-22,-9,-13,"-2,-22"
10662,720575940627013721,right,T2a,521,6,-9,-11,2,"6,-9"
10663,720575940631289155,right,T2a,522,-4,0,4,-4,"-4,0"
10664,720575940634453655,right,T2a,523,2,14,5,9,"2,14"
10665,720575940632699565,right,T2a,524,4,-20,-14,-6,"4,-20"
10666,720575940647573300,right,T2a,525,-1,-20,-9,-11,"-1,-20"
10667,720575940607987330,right,T2a,526,0,-10,-5,-5,"0,-10"
10668,720575940646768180,right,T2a,527,-4,-8,0,-8,"-4,-8"
10669,720575940617751581,right,T2a,528,2,7,1,6,"2,7"
10670,720575940641274676,right,T2a,529,2,-2,-3,1,"2,-2"
10671,720575940636073579,right,T2a,530,-3,-13,-4,-9,"-3,-13"
10672,720575940636775342,right,T2a,531,1,0,-1,1,"1,0"
10673,720575940628238577,right,T2a,532,-8,7,11,-4,"-8,7"
10674,720575940624569085,right,T2a,533,0,-16,-8,-8,"0,-16"
10675,720575940626661660,right,T2a,534,3,2,-2,4,"3,2"
10676,720575940639600829,right,T2a,535,8,-4,-10,6,"8,-4"
10677,720575940630243431,right,T2a,536,3,4,-1,5,"3,4"
10678,720575940631189199,right,T2a,537,0,-23,-12,-11,"0,-23"
10679,720575940627759753,right,T2a,538,-4,1,4,-3,"-4,1"
10680,720575940622044698,right,T2a,539,-6,15,13,2,"-6,15"
10681,720575940624151303,right,T2a,540,-2,-9,-3,-6,"-2,-9"
10682,720575940626139932,right,T2a,541,-4,14,11,3,"-4,14"
10683,720575940617761510,right,T2a,542,6,-13,-13,0,"6,-13"
10684,720575940613576367,right,T2a,543,-1,-4,-1,-3,"-1,-4"
10685,720575940620759534,right,T2a,544,3,-13,-10,-3,"3,-13"
10686,720575940631842700,right,T2a,545,5,11,0,11,"5,11"
10687,720575940617528065,right,T2a,546,3,6,0,6,"3,6"
10688,720575940637611109,right,T2a,547,-1,21,11,10,"-1,21"
10689,720575940624331755,right,T2a,548,1,-16,-9,-7,"1,-16"
10690,720575940623438377,right,T2a,549,0,-9,-5,-4,"0,-9"
10691,720575940604218028,right,T2a,550,-2,3,3,0,"-2,3"
10692,720575940635452596,right,T2a,551,-4,-9,-1,-8,"-4,-9"
10693,720575940620139399,right,T2a,552,4,-1,-5,4,"4,-1"
10694,720575940634356124,right,T2a,553,-3,16,11,5,"-3,16"
10695,720575940620528038,right,T2a,554,-9,-3,7,-10,"-9,-3"
10696,720575940646565684,right,T2a,555,-4,9,8,1,"-4,9"
10697,720575940616895627,right,T2a,556,0,10,5,5,"0,10"
10698,720575940612915478,right,T2a,557,6,-10,-11,1,"6,-10"
10699,720575940620858221,right,T2a,559,-6,22,17,5,"-6,22"
10700,720575940631940895,right,T2a,560,-7,14,14,0,"-7,14"
10701,720575940621813748,right,T2a,561,5,7,-2,9,"5,7"
10702,720575940620073711,right,T2a,562,-5,-2,4,-6,"-5,-2"
10703,720575940626366526,right,T2a,563,5,-13,-12,-1,"5,-13"
10704,720575940624389193,right,T2a,564,3,-23,-15,-8,"3,-23"
10705,720575940624374601,right,T2a,565,0,-26,-13,-13,"0,-26"
10706,720575940627305487,right,T2a,566,5,-8,-9,1,"5,-8"
10707,720575940638314462,right,T2a,567,-2,22,13,9,"-2,22"
10708,720575940617339353,right,T2a,568,-6,-8,2,-10,"-6,-8"
10709,720575940621413766,right,T2a,569,6,6,-3,9,"6,6"
10710,720575940635294560,right,T2a,570,2,25,10,15,"2,25"
10711,720575940622351338,right,T2a,571,0,-14,-7,-7,"0,-14"
10712,720575940633052314,right,T2a,572,-8,3,9,-6,"-8,3"
10713,720575940626820604,right,T2a,573,4,14,3,11,"4,14"
10714,720575940639661952,right,T2a,574,-6,5,8,-3,"-6,5"
10715,720575940621999393,right,T2a,575,6,9,-2,11,"6,9"
10716,720575940622244009,right,T2a,576,0,28,14,14,"0,28"
10717,720575940640518797,right,T2a,577,5,-14,-12,-2,"5,-14"
10718,720575940621558000,right,T2a,578,4,-11,-10,-1,"4,-11"
10719,720575940620915809,right,T2a,579,-3,-10,-2,-8,"-3,-10"
10720,720575940632738095,right,T2a,580,-2,-23,-10,-13,"-2,-23"
10721,720575940631366979,right,T2a,581,3,9,1,8,"3,9"
10722,720575940621879792,right,T2a,582,-1,23,12,11,"-1,23"
10723,720575940633262509,right,T2a,583,3,-25,-16,-9,"3,-25"
10724,720575940628589329,right,T2a,584,4,23,7,16,"4,23"
10725,720575940623325951,right,T2a,585,-1,-23,-11,-12,"-1,-23"
10726,720575940629179898,right,T2a,586,2,18,7,11,"2,18"
10727,720575940613178265,right,T2a,588,1,4,1,3,"1,4"
10728,720575940639165493,right,T2a,589,-1,-5,-2,-3,"-1,-5"
10729,720575940643084488,right,T2a,590,1,9,3,6,"1,9"
10730,720575940619180923,right,T2a,591,3,-3,-5,2,"3,-3"
10731,720575940626949647,right,T2a,593,3,-14,-10,-4,"3,-14"
10732,720575940623252521,right,T2a,594,7,-16,-15,-1,"7,-16"
10733,720575940628814391,right,T2a,595,7,-12,-13,1,"7,-12"
10734,720575940612857651,right,T2a,596,-4,-16,-4,-12,"-4,-16"
10735,720575940632881709,right,T2a,597,4,1,-4,5,"4,1"
10736,720575940602572768,right,T2a,598,2,-18,-11,-7,"2,-18"
10737,720575940605759776,right,T2a,599,-1,9,5,4,"-1,9"
10738,720575940631695315,right,T2a,600,3,-10,-8,-2,"3,-10"
10739,720575940626398252,right,T2a,601,1,16,7,9,"1,16"
10740,720575940613192173,right,T2a,602,4,-2,-5,3,"4,-2"
10741,720575940632994989,right,T2a,603,-3,-23,-9,-14,"-3,-23"
10742,720575940606056126,right,T2a,604,-6,-17,-3,-14,"-6,-17"
10743,720575940636568943,right,T2a,605,3,15,4,11,"3,15"
10744,720575940616989627,right,T2a,606,-1,-19,-9,-10,"-1,-19"
10745,720575940627336530,right,T2a,607,1,18,8,10,"1,18"
10746,720575940610694314,right,T2a,608,1,10,4,6,"1,10"
10747,720575940632233517,right,T2a,609,-2,0,2,-2,"-2,0"
10748,720575940630958732,right,T2a,611,-1,-18,-8,-10,"-1,-18"
10749,720575940632607652,right,T2a,612,-3,-26,-10,-16,"-3,-26"
10750,720575940631270444,right,T2a,613,-8,-4,6,-10,"-8,-4"
10751,720575940612429018,right,T2a,614,-2,-8,-2,-6,"-2,-8"
10752,720575940609269771,right,T2a,615,-7,-7,3,-10,"-7,-7"
10753,720575940612560537,right,T2a,616,-3,15,10,5,"-3,15"
10754,720575940618728277,right,T2a,617,-2,-17,-7,-10,"-2,-17"
10755,720575940617134011,right,T2a,618,-1,24,13,11,"-1,24"
10756,720575940625442649,right,T2a,619,-4,-19,-6,-13,"-4,-19"
10757,720575940620200283,right,T2a,620,7,1,-7,8,"7,1"
10758,720575940613976301,right,T2a,621,1,24,11,13,"1,24"
10759,720575940643855304,right,T2a,622,-5,20,15,5,"-5,20"
10760,720575940614682986,right,T2a,623,1,13,5,8,"1,13"
10761,720575940619955915,right,T2a,624,1,-17,-10,-7,"1,-17"
10762,720575940618198811,right,T2a,625,-2,24,14,10,"-2,24"
10763,720575940630118144,right,T2a,626,-5,-8,1,-9,"-5,-8"
10764,720575940621067525,right,T2a,627,0,-1,-1,0,"0,-1"
10765,720575940623862676,right,T2a,628,0,0,0,0,"0,0"
10766,720575940623182349,right,T2a,629,4,24,8,16,"4,24"
10767,720575940606684802,right,T2a,630,4,8,0,8,"4,8"
10768,720575940614833314,right,T2a,631,1,26,12,14,"1,26"
10769,720575940626765693,right,T2a,632,3,-20,-13,-7,"3,-20"
10770,720575940618378333,right,T2a,633,-1,-24,-11,-13,"-1,-24"
10771,720575940636867440,right,T2a,634,-3,-15,-5,-10,"-3,-15"
10772,720575940616835701,right,T2a,635,6,-6,-9,3,"6,-6"
10773,720575940608730379,right,T2a,636,0,6,3,3,"0,6"
10774,720575940611407843,right,T2a,637,3,-21,-14,-7,"3,-21"
10775,720575940623443469,right,T2a,638,-1,7,4,3,"-1,7"
10776,720575940628402929,right,T2a,639,-4,19,13,6,"-4,19"
10777,720575940628693839,right,T2a,640,-1,-16,-7,-9,"-1,-16"
10778,720575940625043179,right,T2a,641,-8,-5,5,-10,"-8,-5"
10779,720575940626490908,right,T2a,642,-5,-11,-1,-10,"-5,-11"
10780,720575940612166835,right,T2a,643,6,14,1,13,"6,14"
10781,720575940632365383,right,T2a,644,-6,18,15,3,"-6,18"
10782,720575940614688766,right,T2a,645,-4,27,17,10,"-4,27"
10783,720575940628943463,right,T2a,647,-4,-7,0,-7,"-4,-7"
10784,720575940632616078,right,T2a,648,1,7,2,5,"1,7"
10785,720575940621589836,right,T2a,649,-1,5,3,2,"-1,5"
10786,720575940615721845,right,T2a,651,-4,-5,1,-6,"-4,-5"
10787,720575940629954876,right,T2a,652,-6,-11,0,-11,"-6,-11"
10788,720575940630902957,right,T2a,653,-6,-12,0,-12,"-6,-12"
10789,720575940613235123,right,T2a,654,-3,8,7,1,"-3,8"
10790,720575940632515553,right,T2a,655,6,-1,-7,6,"6,-1"
10791,720575940624508819,right,T2a,656,0,-11,-6,-5,"0,-11"
10792,720575940626227504,right,T2a,657,-2,-25,-11,-14,"-2,-25"
10793,720575940622758071,right,T2a,658,1,20,9,11,"1,20"
10794,720575940640143744,right,T2a,659,-4,-6,1,-7,"-4,-6"
10795,720575940614628007,right,T2a,660,2,28,12,16,"2,28"
10796,720575940646110852,right,T2a,661,-3,14,10,4,"-3,14"
10797,720575940627244561,right,T2a,662,2,-1,-3,2,"2,-1"
10798,720575940637770473,right,T2a,663,0,8,4,4,"0,8"
10799,720575940627215891,right,T2a,664,1,-27,-15,-12,"1,-27"
10800,720575940620343489,right,T2a,665,7,-2,-8,6,"7,-2"
10801,720575940612322417,right,T2a,666,7,-13,-14,1,"7,-13"
10802,720575940632529962,right,T2a,667,1,-28,-15,-13,"1,-28"
10803,720575940610329976,right,T2a,668,1,19,8,11,"1,19"
10804,720575940609496782,right,T2a,669,4,-16,-12,-4,"4,-16"
10805,720575940620330832,right,T2a,670,5,5,-3,8,"5,5"
10806,720575940617938077,right,T2a,671,-4,-23,-8,-15,"-4,-23"
10807,720575940611248760,right,T2a,672,-8,11,13,-2,"-8,11"
10808,720575940638331206,right,T2a,673,2,5,0,5,"2,5"
10809,720575940624878119,right,T2a,674,-4,-14,-3,-11,"-4,-14"
10810,720575940615263199,right,T2a,675,-7,19,16,3,"-7,19"
10811,720575940631220495,right,T2a,676,-3,-21,-8,-13,"-3,-21"
10812,720575940633123228,right,T2a,677,0,11,5,6,"0,11"
10813,720575940628656231,right,T2a,678,3,-7,-7,0,"3,-7"
10814,720575940623000269,right,T2a,679,4,18,5,13,"4,18"
10815,720575940617893981,right,T2a,680,-1,25,13,12,"-1,25"
10816,720575940618547897,right,T2a,681,-2,-21,-9,-12,"-2,-21"
10817,720575940632583588,right,T2a,682,6,-8,-10,2,"6,-8"
10818,720575940639385149,right,T2a,683,2,6,1,5,"2,6"
10819,720575940629709438,right,T2a,684,-6,17,14,3,"-6,17"
10820,720575940625982792,right,T2a,685,-5,-9,0,-9,"-5,-9"
10821,720575940604952544,right,T2a,686,5,-22,-16,-6,"5,-22"
10822,720575940638316084,right,T2a,687,-6,-3,4,-7,"-6,-3"
10823,720575940626428179,right,T2a,688,-7,10,12,-2,"-7,10"
10824,720575940613720239,right,T2a,689,-2,18,11,7,"-2,18"
10825,720575940628075281,right,T2a,690,-7,-3,5,-8,"-7,-3"
10826,720575940631821871,right,T2a,691,-9,4,11,-7,"-9,4"
10827,720575940619132726,right,T2a,692,-4,24,16,8,"-4,24"
10828,720575940617732820,right,T2a,693,-3,25,15,10,"-3,25"
10829,720575940621693633,right,T2a,694,4,3,-3,6,"4,3"
10830,720575940624633639,right,T2a,695,-6,10,11,-1,"-6,10"
10831,720575940625314352,right,T2a,696,-2,16,10,6,"-2,16"
10832,720575940642564749,right,T2a,698,6,-7,-10,3,"6,-7"
10833,720575940613617002,right,T2a,699,-5,0,5,-5,"-5,0"
10834,720575940617656404,right,T2a,700,5,15,2,13,"5,15"
10835,720575940628456574,right,T2a,701,0,-4,-2,-2,"0,-4"
10836,720575940614845330,right,T2a,702,-5,23,16,7,"-5,23"
10837,720575940614660511,right,T2a,703,-3,1,3,-2,"-3,1"
10838,720575940620570989,right,T2a,704,-7,8,11,-3,"-7,8"
10839,720575940659819137,right,T2a,705,1,1,-1,2,"1,1"
10840,720575940629354737,right,T2a,706,-7,-12,1,-13,"-7,-12"
10841,720575940627505746,right,T2a,707,-2,25,14,11,"-2,25"
10842,720575940643689160,right,T2a,710,4,-25,-17,-8,"4,-25"
10843,720575940636717742,right,T2a,711,-1,19,10,9,"-1,19"
10844,720575940630418683,right,T2a,712,-7,12,13,-1,"-7,12"
10845,720575940623066153,right,T2a,713,-6,16,14,2,"-6,16"
10846,720575940625688250,right,T2a,714,5,12,1,11,"5,12"
10847,720575940616027714,right,T2a,715,4,10,1,9,"4,10"
10848,720575940619844811,right,T2a,716,4,-6,-7,1,"4,-6"
10849,720575940635715508,right,T2a,717,2,-22,-13,-9,"2,-22"
10850,720575940621984589,right,T2a,718,-5,24,17,7,"-5,24"
10851,720575940622663548,right,T2a,719,1,27,12,15,"1,27"
10852,720575940622024013,right,T2a,720,-5,21,15,6,"-5,21"
10853,720575940623276046,right,T2a,721,5,13,1,12,"5,13"
10854,720575940627725957,right,T2a,722,6,-15,-14,-1,"6,-15"
10855,720575940624758986,right,T2a,723,-2,-11,-4,-7,"-2,-11"
10856,720575940627336553,right,T2a,724,4,2,-3,5,"4,2"
10857,720575940627457850,right,T2a,725,-3,-24,-9,-15,"-3,-24"
10858,720575940638098404,right,T2a,726,2,-28,-16,-12,"2,-28"
10859,720575940622180684,right,T2a,728,7,12,-1,13,"7,12"
10860,720575940625157875,right,T2a,729,-3,29,17,12,"-3,29"
10861,720575940623432682,right,T2a,730,7,0,-7,7,"7,0"
10862,720575940624980723,right,T2a,731,-6,9,10,-1,"-6,9"
10863,720575940634856555,right,T2a,732,-3,6,6,0,"-3,6"
10864,720575940627425157,right,T2a,733,-5,-17,-4,-13,"-5,-17"
10865,720575940634948856,right,T2a,734,2,0,-2,2,"2,0"
10866,720575940634785119,right,T2a,735,1,-23,-13,-10,"1,-23"
10867,720575940624686060,right,T2a,736,-8,1,8,-7,"-8,1"
10868,720575940626418819,right,T2a,737,0,19,9,10,"0,19"
10869,720575940640760960,right,T2a,738,-3,13,9,4,"-3,13"
10870,720575940617066708,right,T2a,739,-7,2,8,-6,"-7,2"
10871,720575940625731842,right,T2a,740,2,-8,-6,-2,"2,-8"
10872,720575940605682976,right,T2a,741,-2,-14,-5,-9,"-2,-14"
10873,720575940624578062,right,T2a,742,-4,11,9,2,"-4,11"
10874,720575940607265410,right,T2a,744,-4,25,16,9,"-4,25"
10875,720575940608943369,right,T2a,745,0,13,6,7,"0,13"
10876,720575940611745962,right,T2a,746,-3,3,4,-1,"-3,3"
10877,720575940614740546,right,T2a,747,0,2,1,1,"0,2"
10878,720575940622118313,right,T2a,748,-4,20,14,6,"-4,20"
10879,720575940616908033,right,T2a,749,-2,1,2,-1,"-2,1"
10880,720575940630698044,right,T2a,750,4,-24,-16,-8,"4,-24"
10881,720575940625394064,right,T2a,751,1,6,2,4,"1,6"
10882,720575940627927300,right,T2a,752,-2,7,5,2,"-2,7"
10883,720575940633501326,right,T2a,753,-3,24,15,9,"-3,24"
10884,720575940624838636,right,T2a,754,-1,-13,-6,-7,"-1,-13"
10885,720575940622946282,right,T2a,755,4,19,5,14,"4,19"
10886,720575940621759356,right,T2a,756,5,20,5,15,"5,20"
10887,720575940622832734,right,T2a,757,0,-6,-3,-3,"0,-6"
10888,720575940617461538,right,T2a,758,5,-1,-6,5,"5,-1"
10889,720575940646488372,right,T2a,759,7,14,0,14,"7,14"
10890,720575940617192081,right,T2a,760,0,17,8,9,"0,17"
10891,720575940624154887,right,T2a,761,-4,-18,-5,-13,"-4,-18"
10892,720575940628350632,right,T2a,762,0,14,7,7,"0,14"
10893,720575940633857934,right,T2a,763,-5,14,12,2,"-5,14"
10894,720575940630281436,right,T2a,764,-8,-6,5,-11,"-8,-6"
10895,720575940631910979,right,T2a,765,-3,9,7,2,"-3,9"
10896,720575940626816649,right,T2a,766,2,-4,-4,0,"2,-4"
10897,720575940605760945,right,T2a,767,1,28,13,15,"1,28"
10898,720575940632335780,right,T2a,768,3,5,-1,6,"3,5"
10899,720575940620135504,right,T2a,770,5,4,-3,7,"5,4"
10900,720575940617750562,right,T2a,771,3,-27,-17,-10,"3,-27"
10901,720575940625003341,right,T2a,772,1,12,5,7,"1,12"
10902,720575940626026298,right,T2a,773,5,-19,-15,-4,"5,-19"
10903,720575940642187680,right,T2a,774,-8,6,11,-5,"-8,6"
10904,720575940613757736,right,T2a,775,5,22,6,16,"5,22"
10905,720575940639506083,right,T2a,776,5,21,5,16,"5,21"
10906,720575940621758588,right,T2a,777,6,20,4,16,"6,20"
10907,720575940617847675,right,T2a,778,4,25,8,17,"4,25"
10908,720575940616452914,right,T2a,780,-6,25,18,7,"-6,25"
10909,720575940618219009,right,T2a,781,-5,26,18,8,"-5,26"
10910,720575940620319309,right,T2a,782,-5,27,18,9,"-5,27"
10911,720575940612820850,right,T2a,783,-4,28,18,10,"-4,28"
10912,720575940618400837,right,T2a,784,-4,29,18,11,"-4,29"
10913,720575940640402851,right,T2a,785,-3,30,18,12,"-3,30"
10914,720575940639926643,right,T2a,786,-2,30,17,13,"-2,30"
10915,720575940630714332,right,T2a,787,3,28,11,17,"3,28"
10916,720575940617703261,right,T2a,788,3,27,10,17,"3,27"
10917,720575940628401285,right,T2a,790,-2,-27,-12,-15,"-2,-27"
10918,720575940635496087,right,T2a,791,-1,-28,-13,-15,"-1,-28"
10919,720575940636375988,right,T2a,792,8,2,-7,9,"8,2"
10920,720575940613625128,right,T2a,794,5,-26,-18,-8,"5,-26"
10921,720575940617643665,right,T2a,795,6,-21,-17,-4,"6,-21"
10922,720575940632131403,right,T2a,796,4,26,9,17,"4,26"
10923,720575940634792858,right,T3,1,-6,13,12,1,"-6,13"
10924,720575940626807098,right,T3,2,-8,2,9,-7,"-8,2"
10925,720575940628083016,right,T3,3,6,-12,-12,0,"6,-12"
10926,720575940619450072,right,T3,4,-5,-21,-6,-15,"-5,-21"
10927,720575940642463373,right,T3,5,-1,16,9,7,"-1,16"
10928,720575940640052864,right,T3,6,-2,-4,0,-4,"-2,-4"
10929,720575940629794304,right,T3,7,-6,-6,3,-9,"-6,-6"
10930,720575940630112768,right,T3,8,-4,26,17,9,"-4,26"
10931,720575940605384992,right,T3,9,4,9,0,9,"4,9"
10932,720575940614385960,right,T3,10,5,-15,-13,-2,"5,-15"
10933,720575940618286420,right,T3,11,7,-14,-14,0,"7,-14"
10934,720575940642561243,right,T3,12,-7,9,11,-2,"-7,9"
10935,720575940617477561,right,T3,13,-1,-26,-12,-14,"-1,-26"
10936,720575940615611531,right,T3,14,0,-27,-14,-13,"0,-27"
10937,720575940636903401,right,T3,15,2,-3,-4,1,"2,-3"
10938,720575940604519014,right,T3,16,-2,-16,-6,-10,"-2,-16"
10939,720575940626491032,right,T3,17,1,-5,-4,-1,"1,-5"
10940,720575940613188835,right,T3,18,5,-16,-13,-3,"5,-16"
10941,720575940622890189,right,T3,19,-7,17,15,2,"-7,17"
10942,720575940619896779,right,T3,20,3,-11,-9,-2,"3,-11"
10943,720575940622908916,right,T3,21,-2,19,11,8,"-2,19"
10944,720575940630333381,right,T3,22,-1,3,2,1,"-1,3"
10945,720575940628249799,right,T3,23,-3,-16,-5,-11,"-3,-16"
10946,720575940615111318,right,T3,24,-1,-10,-4,-6,"-1,-10"
10947,720575940605270816,right,T3,25,-9,3,10,-7,"-9,3"
10948,720575940619085642,right,T3,26,1,-3,-3,0,"1,-3"
10949,720575940626333370,right,T3,27,0,-25,-13,-12,"0,-25"
10950,720575940632881453,right,T3,28,5,6,-2,8,"5,6"
10951,720575940626885501,right,T3,29,-1,-3,-1,-2,"-1,-3"
10952,720575940618172224,right,T3,31,0,16,8,8,"0,16"
10953,720575940622944588,right,T3,32,0,12,6,6,"0,12"
10954,720575940639912536,right,T3,33,3,18,6,12,"3,18"
10955,720575940627547665,right,T3,34,6,18,3,15,"6,18"
10956,720575940617805969,right,T3,35,1,-24,-13,-11,"1,-24"
10957,720575940622545629,right,T3,36,6,8,-2,10,"6,8"
10958,720575940622342499,right,T3,37,1,5,1,4,"1,5"
10959,720575940628735899,right,T3,38,0,-2,-1,-1,"0,-2"
10960,720575940606454705,right,T3,39,0,20,10,10,"0,20"
10961,720575940635973743,right,T3,40,-2,-6,-1,-5,"-2,-6"
10962,720575940628382026,right,T3,41,-3,28,17,11,"-3,28"
10963,720575940633343457,right,T3,42,-1,14,8,6,"-1,14"
10964,720575940627525246,right,T3,43,-5,18,14,4,"-5,18"
10965,720575940625998925,right,T3,44,5,-10,-10,0,"5,-10"
10966,720575940639357136,right,T3,45,-5,-1,4,-5,"-5,-1"
10967,720575940631688515,right,T3,46,-5,15,12,3,"-5,15"
10968,720575940640733043,right,T3,48,-4,-22,-7,-15,"-4,-22"
10969,720575940615047166,right,T3,49,4,-4,-6,2,"4,-4"
10970,720575940627456901,right,T3,50,-2,21,12,9,"-2,21"
10971,720575940628673871,right,T3,51,0,-19,-10,-9,"0,-19"
10972,720575940607182466,right,T3,52,-1,-22,-10,-12,"-1,-22"
10973,720575940630179287,right,T3,53,5,14,2,12,"5,14"
10974,720575940614546578,right,T3,54,-4,3,5,-2,"-4,3"
10975,720575940604968108,right,T3,55,-4,-11,-2,-9,"-4,-11"
10976,720575940626995471,right,T3,56,1,-13,-8,-5,"1,-13"
10977,720575940630344748,right,T3,57,6,-11,-12,1,"6,-11"
10978,720575940618904653,right,T3,58,3,12,3,9,"3,12"
10979,720575940617040418,right,T3,59,-2,2,3,-1,"-2,2"
10980,720575940622379594,right,T3,61,-4,-4,2,-6,"-4,-4"
10981,720575940612634341,right,T3,63,4,12,2,10,"4,12"
10982,720575940622159348,right,T3,64,4,-23,-16,-7,"4,-23"
10983,720575940629333403,right,T3,65,-1,28,15,13,"-1,28"
10984,720575940629112394,right,T3,66,2,15,5,10,"2,15"
10985,720575940605072300,right,T3,67,-2,-13,-5,-8,"-2,-13"
10986,720575940620225473,right,T3,68,3,16,5,11,"3,16"
10987,720575940622744327,right,T3,69,1,8,3,5,"1,8"
10988,720575940617277401,right,T3,70,-4,21,14,7,"-4,21"
10989,720575940642471988,right,T3,71,-2,-3,0,-3,"-2,-3"
10990,720575940631770639,right,T3,72,0,-28,-14,-14,"0,-28"
10991,720575940642958132,right,T3,73,2,2,-1,3,"2,2"
10992,720575940627051535,right,T3,74,-1,-9,-4,-5,"-1,-9"
10993,720575940624236296,right,T3,75,-6,14,13,1,"-6,14"
10994,720575940619843486,right,T3,76,-3,-4,1,-5,"-3,-4"
10995,720575940637432944,right,T3,77,2,-5,-5,0,"2,-5"
10996,720575940614720296,right,T3,78,2,20,8,12,"2,20"
10997,720575940629569018,right,T3,79,2,1,-2,3,"2,1"
10998,720575940608071004,right,T3,80,4,13,2,11,"4,13"
10999,720575940626512412,right,T3,81,6,-2,-7,5,"6,-2"
11000,720575940626972478,right,T3,82,-7,7,10,-3,"-7,7"
11001,720575940616884619,right,T3,83,2,-21,-13,-8,"2,-21"
11002,720575940610938586,right,T3,84,-2,12,8,4,"-2,12"
11003,720575940632716088,right,T3,85,4,-22,-15,-7,"4,-22"
11004,720575940621145204,right,T3,86,-5,-7,1,-8,"-5,-7"
11005,720575940622980393,right,T3,87,1,11,4,7,"1,11"
11006,720575940635150443,right,T3,88,7,4,-5,9,"7,4"
11007,720575940630801090,right,T3,89,1,-19,-11,-8,"1,-19"
11008,720575940619965643,right,T3,90,-4,5,6,-1,"-4,5"
11009,720575940616677830,right,T3,91,-1,6,4,2,"-1,6"
11010,720575940626444844,right,T3,92,0,9,4,5,"0,9"
11011,720575940638701877,right,T3,93,-6,3,7,-4,"-6,3"
11012,720575940638704454,right,T3,95,4,-21,-15,-6,"4,-21"
11013,720575940631194386,right,T3,96,1,-10,-6,-4,"1,-10"
11014,720575940635098743,right,T3,97,-5,2,6,-4,"-5,2"
11015,720575940622178940,right,T3,98,-1,-12,-5,-7,"-1,-12"
11016,720575940623782985,right,T3,99,4,15,3,12,"4,15"
11017,720575940609928260,right,T3,100,2,-10,-7,-3,"2,-10"
11018,720575940644331031,right,T3,101,-7,6,10,-4,"-7,6"
11019,720575940618198336,right,T3,102,3,13,3,10,"3,13"
11020,720575940615342239,right,T3,103,7,9,-3,12,"7,9"
11021,720575940636266341,right,T3,106,-7,11,12,-1,"-7,11"
11022,720575940630601723,right,T3,107,8,-2,-9,7,"8,-2"
11023,720575940627474490,right,T3,108,-3,-12,-3,-9,"-3,-12"
11024,720575940615873036,right,T3,109,4,-5,-7,2,"4,-5"
11025,720575940628304656,right,T3,110,-7,0,7,-7,"-7,0"
11026,720575940625042675,right,T3,111,2,-24,-14,-10,"2,-24"
11027,720575940623053715,right,T3,112,-6,1,6,-5,"-6,1"
11028,720575940616371771,right,T3,113,-2,4,4,0,"-2,4"
11029,720575940626979855,right,T3,114,2,-13,-9,-4,"2,-13"
11030,720575940622641159,right,T3,115,-4,2,5,-3,"-4,2"
11031,720575940632615711,right,T3,116,-1,-8,-3,-5,"-1,-8"
11032,720575940639288637,right,T3,117,-8,-2,7,-9,"-8,-2"
11033,720575940618090821,right,T3,118,3,1,-3,4,"3,1"
11034,720575940630677323,right,T3,119,-2,6,5,1,"-2,6"
11035,720575940638480948,right,T3,120,-1,-1,0,-1,"-1,-1"
11036,720575940627221036,right,T3,121,-8,4,10,-6,"-8,4"
11037,720575940633908110,right,T3,122,-5,9,9,0,"-5,9"
11038,720575940627579665,right,T3,123,-8,10,13,-3,"-8,10"
11039,720575940637516685,right,T3,124,1,-7,-5,-2,"1,-7"
11040,720575940628777731,right,T3,125,5,9,-1,10,"5,9"
11041,720575940624541623,right,T3,126,3,11,2,9,"3,11"
11042,720575940626716824,right,T3,127,0,15,7,8,"0,15"
11043,720575940640997517,right,T3,128,3,-22,-14,-8,"3,-22"
11044,720575940619822171,right,T3,129,0,-13,-7,-6,"0,-13"
11045,720575940628324201,right,T3,130,2,12,4,8,"2,12"
11046,720575940609040597,right,T3,131,-6,20,16,4,"-6,20"
11047,720575940622935293,right,T3,132,2,4,0,4,"2,4"
11048,720575940624301320,right,T3,133,-3,20,13,7,"-3,20"
11049,720575940630480911,right,T3,134,-5,-18,-4,-14,"-5,-18"
11050,720575940619283510,right,T3,135,-3,-22,-8,-14,"-3,-22"
11051,720575940623877052,right,T3,136,0,3,1,2,"0,3"
11052,720575940620627547,right,T3,137,5,-7,-9,2,"5,-7"
11053,720575940630201978,right,T3,138,0,27,13,14,"0,27"
11054,720575940627058703,right,T3,139,1,-14,-8,-6,"1,-14"
11055,720575940623641351,right,T3,140,3,8,1,7,"3,8"
11056,720575940635245759,right,T3,141,5,-23,-17,-6,"5,-23"
11057,720575940622651357,right,T3,142,-2,-18,-7,-11,"-2,-18"
11058,720575940636472542,right,T3,143,-4,16,12,4,"-4,16"
11059,720575940620130865,right,T3,144,7,-11,-13,2,"7,-11"
11060,720575940620776959,right,T3,145,0,4,2,2,"0,4"
11061,720575940646151715,right,T3,146,1,-6,-4,-2,"1,-6"
11062,720575940630293303,right,T3,147,1,21,9,12,"1,21"
11063,720575940628829443,right,T3,148,-7,-11,1,-12,"-7,-11"
11064,720575940625520217,right,T3,149,6,-14,-13,-1,"6,-14"
11065,720575940629602108,right,T3,150,-8,5,10,-5,"-8,5"
11066,720575940626193470,right,T3,151,-3,-14,-4,-10,"-3,-14"
11067,720575940626917903,right,T3,152,3,-15,-11,-4,"3,-15"
11068,720575940626269989,right,T3,153,8,0,-8,8,"8,0"
11069,720575940622411021,right,T3,154,-8,0,8,-8,"-8,0"
11070,720575940627046671,right,T3,157,-1,-7,-3,-4,"-1,-7"
11071,720575940636480174,right,T3,158,3,-5,-6,1,"3,-5"
11072,720575940608004035,right,T3,159,7,7,-4,11,"7,7"
11073,720575940627753020,right,T3,160,-2,20,12,8,"-2,20"
11074,720575940626979087,right,T3,161,4,-14,-11,-3,"4,-14"
11075,720575940605775294,right,T3,162,-4,-2,3,-5,"-4,-2"
11076,720575940624296230,right,T3,164,-1,-2,0,-2,"-1,-2"
11077,720575940619758215,right,T3,165,4,16,4,12,"4,16"
11078,720575940628357126,right,T3,166,0,18,9,9,"0,18"
11079,720575940619302278,right,T3,167,0,-17,-9,-8,"0,-17"
11080,720575940630984267,right,T3,168,-1,17,9,8,"-1,17"
11081,720575940627829781,right,T3,169,0,-18,-9,-9,"0,-18"
11082,720575940611739571,right,T3,170,-5,1,5,-4,"-5,1"
11083,720575940621597167,right,T3,171,6,-20,-16,-4,"6,-20"
11084,720575940609042901,right,T3,172,1,22,10,12,"1,22"
11085,720575940638716230,right,T3,174,4,-15,-12,-3,"4,-15"
11086,720575940623971509,right,T3,175,-6,-7,2,-9,"-6,-7"
11087,720575940625281771,right,T3,176,-2,13,8,5,"-2,13"
11088,720575940643260360,right,T3,177,-2,-1,1,-2,"-2,-1"
11089,720575940606709890,right,T3,178,2,11,3,8,"2,11"
11090,720575940621339568,right,T3,179,-5,-16,-3,-13,"-5,-16"
11091,720575940608674908,right,T3,180,2,-27,-16,-11,"2,-27"
11092,720575940637639822,right,T3,181,1,-4,-3,-1,"1,-4"
11093,720575940618657616,right,T3,182,7,-10,-12,2,"7,-10"
11094,720575940630159404,right,T3,184,-6,-5,3,-8,"-6,-5"
11095,720575940621025389,right,T3,185,2,-11,-8,-3,"2,-11"
11096,720575940624864007,right,T3,186,-1,26,14,12,"-1,26"
11097,720575940627860808,right,T3,187,3,21,7,14,"3,21"
11098,720575940620244139,right,T3,188,-5,17,13,4,"-5,17"
11099,720575940620343089,right,T3,189,6,13,0,13,"6,13"
11100,720575940623905287,right,T3,190,-3,-5,0,-5,"-3,-5"
11101,720575940635204975,right,T3,191,-1,-11,-5,-6,"-1,-11"
11102,720575940623865614,right,T3,192,7,10,-2,12,"7,10"
11103,720575940637521641,right,T3,193,-5,4,7,-3,"-5,4"
11104,720575940631282681,right,T3,194,0,-5,-3,-2,"0,-5"
11105,720575940628759596,right,T3,195,-3,-1,2,-3,"-3,-1"
11106,720575940616993885,right,T3,196,-1,8,5,3,"-1,8"
11107,720575940636693678,right,T3,197,0,-20,-10,-10,"0,-20"
11108,720575940637309303,right,T3,198,6,2,-5,7,"6,2"
11109,720575940627054095,right,T3,199,0,-12,-6,-6,"0,-12"
11110,720575940613014243,right,T3,200,-5,12,11,1,"-5,12"
11111,720575940631013071,right,T3,202,-1,27,14,13,"-1,27"
11112,720575940614742322,right,T3,203,3,-1,-4,3,"3,-1"
11113,720575940624119846,right,T3,204,5,-2,-6,4,"5,-2"
11114,720575940627400250,right,T3,205,5,-6,-8,2,"5,-6"
11115,720575940629162695,right,T3,206,-3,5,5,0,"-3,5"
11116,720575940639690659,right,T3,208,5,-21,-16,-5,"5,-21"
11117,720575940619738827,right,T3,209,-3,-8,-1,-7,"-3,-8"
11118,720575940633928078,right,T3,210,-6,8,10,-2,"-6,8"
11119,720575940619712085,right,T3,211,-7,-1,6,-7,"-7,-1"
11120,720575940640514419,right,T3,212,2,-16,-10,-6,"2,-16"
11121,720575940626540828,right,T3,213,3,-4,-5,1,"3,-4"
11122,720575940618206021,right,T3,214,-5,3,6,-3,"-5,3"
11123,720575940629624446,right,T3,215,6,7,-3,10,"6,7"
11124,720575940616832373,right,T3,216,2,19,7,12,"2,19"
11125,720575940614153026,right,T3,217,6,15,1,14,"6,15"
11126,720575940627177004,right,T3,218,2,10,3,7,"2,10"
11127,720575940622153084,right,T3,219,6,-4,-8,4,"6,-4"
11128,720575940643739552,right,T3,220,2,-6,-5,-1,"2,-6"
11129,720575940606741682,right,T3,221,-7,3,8,-5,"-7,3"
11130,720575940633787873,right,T3,222,-3,26,16,10,"-3,26"
11131,720575940633740569,right,T3,223,-2,26,15,11,"-2,26"
11132,720575940632543886,right,T3,224,0,5,2,3,"0,5"
11133,720575940638430271,right,T3,225,2,-26,-15,-11,"2,-26"
11134,720575940605353062,right,T3,226,5,19,4,15,"5,19"
11135,720575940625525054,right,T3,227,-7,5,9,-4,"-7,5"
11136,720575940614723234,right,T3,228,-7,1,7,-6,"-7,1"
11137,720575940642773044,right,T3,229,5,2,-4,6,"5,2"
11138,720575940623149692,right,T3,230,2,9,2,7,"2,9"
11139,720575940632960045,right,T3,231,4,-12,-10,-2,"4,-12"
11140,720575940628888731,right,T3,232,-4,13,10,3,"-4,13"
11141,720575940622302335,right,T3,233,4,-13,-11,-2,"4,-13"
11142,720575940619651894,right,T3,234,1,3,0,3,"1,3"
11143,720575940621637470,right,T3,235,4,11,1,10,"4,11"
11144,720575940619611096,right,T3,236,-1,4,3,1,"-1,4"
11145,720575940631625258,right,T3,237,-2,27,15,12,"-2,27"
11146,720575940630741241,right,T3,238,-8,-3,6,-9,"-8,-3"
11147,720575940633938574,right,T3,239,-6,6,9,-3,"-6,6"
11148,720575940626341916,right,T3,240,-4,-3,2,-5,"-4,-3"
11149,720575940634723007,right,T3,241,2,-17,-11,-6,"2,-17"
11150,720575940633802638,right,T3,242,-4,6,7,-1,"-4,6"
11151,720575940607614933,right,T3,243,-1,-21,-10,-11,"-1,-21"
11152,720575940622209574,right,T3,244,-4,-12,-2,-10,"-4,-12"
11153,720575940635252831,right,T3,245,-5,-3,3,-6,"-5,-3"
11154,720575940634517017,right,T3,246,-4,15,11,4,"-4,15"
11155,720575940626833234,right,T3,247,-4,-15,-4,-11,"-4,-15"
11156,720575940617337089,right,T3,248,-6,0,6,-6,"-6,0"
11157,720575940627059471,right,T3,249,2,-12,-8,-4,"2,-12"
11158,720575940619702955,right,T3,250,-1,1,1,0,"-1,1"
11159,720575940613021810,right,T3,252,3,23,8,15,"3,23"
11160,720575940637091758,right,T3,254,3,-24,-15,-9,"3,-24"
11161,720575940633721058,right,T3,255,-6,-13,-1,-12,"-6,-13"
11162,720575940624097357,right,T3,256,5,-20,-15,-5,"5,-20"
11163,720575940645124388,right,T3,257,2,21,8,13,"2,21"
11164,720575940631755320,right,T3,258,-4,-17,-5,-12,"-4,-17"
11165,720575940652333814,right,T3,260,-3,19,12,7,"-3,19"
11166,720575940620165285,right,T3,261,-1,13,7,6,"-1,13"
11167,720575940632096583,right,T3,262,1,-11,-7,-4,"1,-11"
11168,720575940635811184,right,T3,263,-3,4,5,-1,"-3,4"
11169,720575940626903311,right,T3,264,-1,-6,-2,-4,"-1,-6"
11170,720575940627319683,right,T3,265,-6,-1,5,-6,"-6,-1"
11171,720575940639371317,right,T3,266,-1,-25,-12,-13,"-1,-25"
11172,720575940609475140,right,T3,267,-6,2,7,-5,"-6,2"
11173,720575940626085157,right,T3,268,7,-6,-10,4,"7,-6"
11174,720575940616032710,right,T3,269,2,-19,-12,-7,"2,-19"
11175,720575940618518969,right,T3,270,1,-8,-5,-3,"1,-8"
11176,720575940632527149,right,T3,271,4,6,-1,7,"4,6"
11177,720575940627033993,right,T3,272,3,-2,-4,2,"3,-2"
11178,720575940631730499,right,T3,273,-6,23,17,6,"-6,23"
11179,720575940643647028,right,T3,274,6,4,-4,8,"6,4"
11180,720575940619298520,right,T3,275,-8,-1,7,-8,"-8,-1"
11181,720575940639720253,right,T3,276,2,3,-1,4,"2,3"
11182,720575940605666662,right,T3,277,7,-3,-9,6,"7,-3"
11183,720575940621476336,right,T3,278,-5,10,10,0,"-5,10"
11184,720575940629496954,right,T3,279,-4,8,8,0,"-4,8"
11185,720575940611701978,right,T3,281,-9,2,10,-8,"-9,2"
11186,720575940610782766,right,T3,282,0,26,13,13,"0,26"
11187,720575940624452685,right,T3,283,-4,4,6,-2,"-4,4"
11188,720575940624688056,right,T3,284,0,25,12,13,"0,25"
11189,720575940633715667,right,T3,285,6,-18,-15,-3,"6,-18"
11190,720575940634096496,right,T3,286,0,-24,-12,-12,"0,-24"
11191,720575940611895770,right,T3,287,-5,13,11,2,"-5,13"
11192,720575940620367854,right,T3,289,-1,11,6,5,"-1,11"
11193,720575940625720778,right,T3,291,7,2,-6,8,"7,2"
11194,720575940613453458,right,T3,292,-4,18,13,5,"-4,18"
11195,720575940623000456,right,T3,293,4,-17,-13,-4,"4,-17"
11196,720575940621723909,right,T3,294,1,-20,-11,-9,"1,-20"
11197,720575940619466587,right,T3,295,-2,29,16,13,"-2,29"
11198,720575940624204237,right,T3,296,1,-18,-10,-8,"1,-18"
11199,720575940613610346,right,T3,298,-5,5,7,-2,"-5,5"
11200,720575940625906253,right,T3,299,-4,12,10,2,"-4,12"
11201,720575940617282777,right,T3,300,4,-18,-13,-5,"4,-18"
11202,720575940613490026,right,T3,301,-5,16,13,3,"-5,16"
11203,720575940611092946,right,T3,302,2,17,6,11,"2,17"
11204,720575940627059608,right,T3,303,-5,22,16,6,"-5,22"
11205,720575940622265162,right,T3,304,6,5,-4,9,"6,5"
11206,720575940624158100,right,T3,305,-7,4,9,-5,"-7,4"
11207,720575940633386721,right,T3,306,3,7,0,7,"3,7"
11208,720575940640198864,right,T3,308,-5,8,9,-1,"-5,8"
11209,720575940631428419,right,T3,309,-6,12,12,0,"-6,12"
11210,720575940620395456,right,T3,310,2,22,9,13,"2,22"
11211,720575940608991957,right,T3,311,-7,15,14,1,"-7,15"
11212,720575940628104135,right,T3,312,4,-7,-8,1,"4,-7"
11213,720575940632750623,right,T3,313,7,3,-6,9,"7,3"
11214,720575940630841431,right,T3,314,-9,5,11,-6,"-9,5"
11215,720575940605706686,right,T3,315,-3,-6,0,-6,"-3,-6"
11216,720575940619296960,right,T3,316,5,-4,-7,3,"5,-4"
11217,720575940628985387,right,T3,317,-5,-4,3,-7,"-5,-4"
11218,720575940623604458,right,T3,318,4,-19,-14,-5,"4,-19"
11219,720575940642942004,right,T3,319,-2,5,4,1,"-2,5"
11220,720575940638628669,right,T3,320,-2,-5,-1,-4,"-2,-5"
11221,720575940639396174,right,T3,323,-7,-13,0,-13,"-7,-13"
11222,720575940632017208,right,T3,324,3,24,9,15,"3,24"
11223,720575940626081466,right,T3,325,5,1,-5,6,"5,1"
11224,720575940621638750,right,T3,326,2,16,6,10,"2,16"
11225,720575940606099377,right,T3,327,5,3,-4,7,"5,3"
11226,720575940605717792,right,T3,328,5,-9,-10,1,"5,-9"
11227,720575940621278273,right,T3,329,0,24,12,12,"0,24"
11228,720575940622442495,right,T3,330,3,3,-2,5,"3,3"
11229,720575940621292208,right,T3,331,1,-15,-9,-6,"1,-15"
11230,720575940630335223,right,T3,332,4,-26,-17,-9,"4,-26"
11231,720575940613138328,right,T3,333,0,-21,-11,-10,"0,-21"
11232,720575940653463798,right,T3,334,1,-26,-14,-12,"1,-26"
11233,720575940629562873,right,T3,335,2,8,2,6,"2,8"
11234,720575940609042645,right,T3,336,0,23,11,12,"0,23"
11235,720575940606803401,right,T3,337,-5,-6,2,-8,"-5,-6"
11236,720575940614526431,right,T3,338,-1,0,1,-1,"-1,0"
11237,720575940619848533,right,T3,340,-4,17,12,5,"-4,17"
11238,720575940623125518,right,T3,341,6,-17,-15,-2,"6,-17"
11239,720575940626972687,right,T3,342,2,-15,-10,-5,"2,-15"
11240,720575940642285453,right,T3,343,-3,27,16,11,"-3,27"
11241,720575940606999497,right,T3,344,-2,-15,-6,-9,"-2,-15"
11242,720575940619396998,right,T3,345,3,-12,-9,-3,"3,-12"
11243,720575940636420270,right,T3,346,-7,-9,2,-11,"-7,-9"
11244,720575940615255618,right,T3,347,-5,-13,-2,-11,"-5,-13"
11245,720575940626010826,right,T3,348,3,14,4,10,"3,14"
11246,720575940617293785,right,T3,350,1,15,6,9,"1,15"
11247,720575940606488510,right,T3,351,-1,-17,-8,-9,"-1,-17"
11248,720575940624143916,right,T3,352,-2,28,16,12,"-2,28"
11249,720575940627394181,right,T3,353,2,24,10,14,"2,24"
11250,720575940621276609,right,T3,354,-2,-26,-11,-15,"-2,-26"
11251,720575940630316538,right,T3,355,-7,-6,4,-10,"-7,-6"
11252,720575940611801720,right,T3,356,0,22,11,11,"0,22"
11253,720575940641233115,right,T3,357,4,17,4,13,"4,17"
11254,720575940634897503,right,T3,358,-3,17,11,6,"-3,17"
11255,720575940624065357,right,T3,359,2,23,9,14,"2,23"
11256,720575940624750887,right,T3,360,-5,19,14,5,"-5,19"
11257,720575940627784264,right,T3,361,0,-7,-4,-3,"0,-7"
11258,720575940620917357,right,T3,362,2,-20,-12,-8,"2,-20"
11259,720575940617402229,right,T3,363,7,-4,-9,5,"7,-4"
11260,720575940612225194,right,T3,364,4,4,-2,6,"4,4"
11261,720575940618651446,right,T3,365,4,7,-1,8,"4,7"
11262,720575940635388046,right,T3,368,-4,-20,-6,-14,"-4,-20"
11263,720575940625856381,right,T3,369,5,-5,-8,3,"5,-5"
11264,720575940612489625,right,T3,370,-3,21,13,8,"-3,21"
11265,720575940631407179,right,T3,371,6,-5,-9,4,"6,-5"
11266,720575940645661731,right,T3,372,1,-2,-2,0,"1,-2"
11267,720575940618101465,right,T3,373,1,-21,-12,-9,"1,-21"
11268,720575940626970387,right,T3,374,2,13,4,9,"2,13"
11269,720575940632665508,right,T3,375,-6,7,9,-2,"-6,7"
11270,720575940624289516,right,T3,377,0,7,3,4,"0,7"
11271,720575940605783840,right,T3,378,-3,18,12,6,"-3,18"
11272,720575940620926317,right,T3,379,3,-17,-12,-5,"3,-17"
11273,720575940612778213,right,T3,380,-1,29,15,14,"-1,29"
11274,720575940639038542,right,T3,381,-8,-9,3,-12,"-8,-9"
11275,720575940631418666,right,T3,382,3,-6,-6,0,"3,-6"
11276,720575940615379778,right,T3,383,-6,11,11,0,"-6,11"
11277,720575940628940623,right,T3,384,-6,-2,5,-7,"-6,-2"
11278,720575940624601126,right,T3,385,-3,-18,-6,-12,"-3,-18"
11279,720575940634873054,right,T3,386,-6,19,15,4,"-6,19"
11280,720575940627964181,right,T3,387,-1,-15,-7,-8,"-1,-15"
11281,720575940631185782,right,T3,388,3,19,6,13,"3,19"
11282,720575940611604082,right,T3,389,-6,-16,-2,-14,"-6,-16"
11283,720575940614095667,right,T3,390,-6,-9,1,-10,"-6,-9"
11284,720575940620153816,right,T3,391,4,-3,-6,3,"4,-3"
11285,720575940626586645,right,T3,392,-4,7,7,0,"-4,7"
11286,720575940626818348,right,T3,393,-1,22,12,10,"-1,22"
11287,720575940629183985,right,T3,394,-7,-8,3,-11,"-7,-8"
11288,720575940612541081,right,T3,395,0,-22,-11,-11,"0,-22"
11289,720575940644582423,right,T3,396,-1,10,6,4,"-1,10"
11290,720575940627768853,right,T3,397,-3,-19,-7,-12,"-3,-19"
11291,720575940623500070,right,T3,398,-3,22,14,8,"-3,22"
11292,720575940635850608,right,T3,400,1,-29,-16,-13,"1,-29"
11293,720575940602401214,right,T3,401,-2,-19,-8,-11,"-2,-19"
11294,720575940616483487,right,T3,402,3,26,10,16,"3,26"
11295,720575940641349840,right,T3,403,-2,-12,-4,-8,"-2,-12"
11296,720575940623413995,right,T3,404,-1,20,11,9,"-1,20"
11297,720575940632293191,right,T3,405,3,10,2,8,"3,10"
11298,720575940620880987,right,T3,406,1,-25,-14,-11,"1,-25"
11299,720575940614098995,right,T3,407,-5,-10,0,-10,"-5,-10"
11300,720575940623246550,right,T3,408,-6,-4,4,-8,"-6,-4"
11301,720575940641331764,right,T3,409,0,-3,-2,-1,"0,-3"
11302,720575940623915271,right,T3,410,-2,-2,1,-3,"-2,-2"
11303,720575940621299120,right,T3,412,-6,21,16,5,"-6,21"
11304,720575940617370297,right,T3,413,-2,-7,-2,-5,"-2,-7"
11305,720575940617374950,right,T3,414,4,21,6,15,"4,21"
11306,720575940619562968,right,T3,416,3,-8,-7,-1,"3,-8"
11307,720575940639799203,right,T3,417,-6,-10,1,-11,"-6,-10"
11308,720575940632505683,right,T3,418,-2,15,9,6,"-2,15"
11309,720575940630951484,right,T3,419,-3,-11,-3,-8,"-3,-11"
11310,720575940627661711,right,T3,420,6,-3,-8,5,"6,-3"
11311,720575940617744798,right,T3,421,-1,12,7,5,"-1,12"
11312,720575940623329535,right,T3,423,3,-18,-12,-6,"3,-18"
11313,720575940628484092,right,T3,424,-3,-2,2,-4,"-3,-2"
11314,720575940610760824,right,T3,425,3,20,7,13,"3,20"
11315,720575940620319727,right,T3,426,-3,0,3,-3,"-3,0"
11316,720575940627148047,right,T3,427,5,-18,-14,-4,"5,-18"
11317,720575940627794449,right,T3,428,-2,23,13,10,"-2,23"
11318,720575940638903869,right,T3,429,-2,14,9,5,"-2,14"
11319,720575940628004072,right,T3,430,-3,-7,-1,-6,"-3,-7"
11320,720575940623906567,right,T3,431,-2,-10,-3,-7,"-2,-10"
11321,720575940622857909,right,T3,432,-5,7,8,-1,"-5,7"
11322,720575940612241370,right,T3,433,0,-8,-4,-4,"0,-8"
11323,720575940615051158,right,T3,434,-3,7,6,1,"-3,7"
11324,720575940626980623,right,T3,435,5,-17,-14,-3,"5,-17"
11325,720575940623267210,right,T3,436,0,-15,-8,-7,"0,-15"
11326,720575940617689428,right,T3,437,-3,12,9,3,"-3,12"
11327,720575940626871596,right,T3,438,2,27,11,16,"2,27"
11328,720575940622512342,right,T3,439,-3,-9,-2,-7,"-3,-9"
11329,720575940626290732,right,T3,440,1,23,10,13,"1,23"
11330,720575940626930191,right,T3,441,3,-16,-11,-5,"3,-16"
11331,720575940606913481,right,T3,442,-5,25,17,8,"-5,25"
11332,720575940608085513,right,T3,443,-6,4,8,-4,"-6,4"
11333,720575940640149376,right,T3,444,4,-10,-9,-1,"4,-10"
11334,720575940633232610,right,T3,445,-2,8,6,2,"-2,8"
11335,720575940621065933,right,T3,446,2,-14,-9,-5,"2,-14"
11336,720575940620925311,right,T3,447,-1,2,2,0,"-1,2"
11337,720575940621847832,right,T3,449,6,-16,-14,-2,"6,-16"
11338,720575940637975386,right,T3,450,2,-9,-7,-2,"2,-9"
11339,720575940605479870,right,T3,451,4,20,6,14,"4,20"
11340,720575940627784520,right,T3,452,1,-9,-6,-3,"1,-9"
11341,720575940627877735,right,T3,453,3,25,9,16,"3,25"
11342,720575940620642182,right,T3,454,5,-12,-11,-1,"5,-12"
11343,720575940627007896,right,T3,455,7,-7,-11,4,"7,-7"
11344,720575940626965292,right,T3,456,0,21,10,11,"0,21"
11345,720575940625757328,right,T3,457,-2,17,10,7,"-2,17"
11346,720575940608313948,right,T3,458,5,0,-5,5,"5,0"
11347,720575940627734788,right,T3,459,5,-3,-7,4,"5,-3"
11348,720575940635086617,right,T3,460,-3,-20,-7,-13,"-3,-20"
11349,720575940635712119,right,T3,461,7,-5,-10,5,"7,-5"
11350,720575940635129963,right,T3,462,-1,18,10,8,"-1,18"
11351,720575940630952844,right,T3,464,4,0,-4,4,"4,0"
11352,720575940632638884,right,T3,465,3,0,-3,3,"3,0"
11353,720575940634918591,right,T3,466,1,14,6,8,"1,14"
11354,720575940605671358,right,T3,467,-2,-20,-8,-12,"-2,-20"
11355,720575940639374243,right,T3,468,-3,11,8,3,"-3,11"
11356,720575940623168297,right,T3,470,4,-9,-9,0,"4,-9"
11357,720575940622426906,right,T3,471,3,-26,-16,-10,"3,-26"
11358,720575940613005078,right,T3,472,1,25,11,14,"1,25"
11359,720575940629191939,right,T3,473,-4,23,15,8,"-4,23"
11360,720575940613145767,right,T3,474,-3,-17,-6,-11,"-3,-17"
11361,720575940625742780,right,T3,475,-4,-1,3,-4,"-4,-1"
11362,720575940633174815,right,T3,476,-1,15,8,7,"-1,15"
11363,720575940627854217,right,T3,477,-3,2,4,-2,"-3,2"
11364,720575940627143994,right,T3,478,-7,16,15,1,"-7,16"
11365,720575940652371446,right,T3,479,-2,10,7,3,"-2,10"
11366,720575940626104613,right,T3,480,3,-19,-13,-6,"3,-19"
11367,720575940622253857,right,T3,481,4,-8,-8,0,"4,-8"
11368,720575940620312048,right,T3,482,1,17,7,10,"1,17"
11369,720575940637536141,right,T3,483,2,-7,-6,-1,"2,-7"
11370,720575940626094885,right,T3,484,3,-9,-8,-1,"3,-9"
11371,720575940623697101,right,T3,485,-3,-3,1,-4,"-3,-3"
11372,720575940622403976,right,T3,486,0,1,0,1,"0,1"
11373,720575940621324833,right,T3,487,1,-1,-2,1,"1,-1"
11374,720575940612983011,right,T3,488,7,5,-5,10,"7,5"
11375,720575940621611132,right,T3,489,-3,10,8,2,"-3,10"
11376,720575940617422849,right,T3,490,-5,6,8,-2,"-5,6"
11377,720575940615644319,right,T3,491,7,-1,-8,7,"7,-1"
11378,720575940629516282,right,T3,492,-7,-2,6,-8,"-7,-2"
11379,720575940610668920,right,T3,493,-3,23,14,9,"-3,23"
11380,720575940623267208,right,T3,494,0,29,14,15,"0,29"
11381,720575940624670648,right,T3,495,4,5,-2,7,"4,5"
11382,720575940640054144,right,T3,496,7,8,-3,11,"7,8"
11383,720575940616890944,right,T3,497,6,1,-6,7,"6,1"
11384,720575940628424811,right,T3,498,6,10,-1,11,"6,10"
11385,720575940615090079,right,T3,499,5,10,0,10,"5,10"
11386,720575940627314703,right,T3,500,7,-8,-11,3,"7,-8"
11387,720575940634636514,right,T3,501,1,2,0,2,"1,2"
11388,720575940617828609,right,T3,502,5,8,-1,9,"5,8"
11389,720575940622310621,right,T3,503,3,17,5,12,"3,17"
11390,720575940614745450,right,T3,504,-2,9,6,3,"-2,9"
11391,720575940636415966,right,T3,506,1,-12,-7,-5,"1,-12"
11392,720575940628602371,right,T3,507,-5,-12,-1,-11,"-5,-12"
11393,720575940617285332,right,T3,508,-5,11,10,1,"-5,11"
11394,720575940622190276,right,T3,509,-4,10,9,1,"-4,10"
11395,720575940617036812,right,T3,510,-2,11,7,4,"-2,11"
11396,720575940627316751,right,T3,511,5,-11,-11,0,"5,-11"
11397,720575940627541265,right,T3,512,6,0,-6,6,"6,0"
11398,720575940648594297,right,T3,513,-4,-13,-3,-10,"-4,-13"
11399,720575940627006345,right,T3,514,-4,-10,-1,-9,"-4,-10"
11400,720575940631329361,right,T3,515,-8,-7,4,-11,"-8,-7"
11401,720575940621043532,right,T3,516,7,-18,-16,-2,"7,-18"
11402,720575940638903605,right,T3,517,6,3,-5,8,"6,3"
11403,720575940632310087,right,T3,518,-4,22,15,7,"-4,22"
11404,720575940622028577,right,T3,519,-5,-5,2,-7,"-5,-5"
11405,720575940608382556,right,T3,520,-2,-22,-9,-13,"-2,-22"
11406,720575940636664432,right,T3,521,6,-9,-11,2,"6,-9"
11407,720575940639383896,right,T3,522,-4,0,4,-4,"-4,0"
11408,720575940616843579,right,T3,523,2,14,5,9,"2,14"
11409,720575940631479909,right,T3,524,4,-20,-14,-6,"4,-20"
11410,720575940646468387,right,T3,525,-1,-20,-9,-11,"-1,-20"
11411,720575940627036943,right,T3,526,0,-10,-5,-5,"0,-10"
11412,720575940614676018,right,T3,527,-4,-8,0,-8,"-4,-8"
11413,720575940632584334,right,T3,528,2,7,1,6,"2,7"
11414,720575940636801135,right,T3,529,2,-2,-3,1,"2,-2"
11415,720575940622728662,right,T3,530,-3,-13,-4,-9,"-3,-13"
11416,720575940605111230,right,T3,531,1,0,-1,1,"1,0"
11417,720575940619865441,right,T3,532,-8,7,11,-4,"-8,7"
11418,720575940620267655,right,T3,533,0,-16,-8,-8,"0,-16"
11419,720575940624132488,right,T3,534,3,2,-2,4,"3,2"
11420,720575940639619645,right,T3,535,8,-4,-10,6,"8,-4"
11421,720575940643899808,right,T3,536,3,4,-1,5,"3,4"
11422,720575940636995561,right,T3,537,0,-23,-12,-11,"0,-23"
11423,720575940632561633,right,T3,538,-4,1,4,-3,"-4,1"
11424,720575940623615751,right,T3,539,-6,15,13,2,"-6,15"
11425,720575940616161979,right,T3,540,-2,-9,-3,-6,"-2,-9"
11426,720575940608549385,right,T3,541,-4,14,11,3,"-4,14"
11427,720575940613474710,right,T3,542,6,-13,-13,0,"6,-13"
11428,720575940630325366,right,T3,543,-1,-4,-1,-3,"-1,-4"
11429,720575940619232448,right,T3,544,3,-13,-10,-3,"3,-13"
11430,720575940628247659,right,T3,545,5,11,0,11,"5,11"
11431,720575940633483998,right,T3,546,3,6,0,6,"3,6"
11432,720575940620579777,right,T3,547,-1,21,11,10,"-1,21"
11433,720575940632827219,right,T3,548,1,-16,-9,-7,"1,-16"
11434,720575940616785420,right,T3,549,0,-9,-5,-4,"0,-9"
11435,720575940635600247,right,T3,550,-2,3,3,0,"-2,3"
11436,720575940622823962,right,T3,551,-4,-9,-1,-8,"-4,-9"
11437,720575940643512884,right,T3,552,4,-1,-5,4,"4,-1"
11438,720575940632408206,right,T3,553,-3,16,11,5,"-3,16"
11439,720575940627127866,right,T3,555,-4,9,8,1,"-4,9"
11440,720575940617657684,right,T3,556,0,10,5,5,"0,10"
11441,720575940610519364,right,T3,557,6,-10,-11,1,"6,-10"
11442,720575940633969520,right,T3,558,-4,-21,-7,-14,"-4,-21"
11443,720575940626362776,right,T3,560,-7,14,14,0,"-7,14"
11444,720575940626425116,right,T3,561,5,7,-2,9,"5,7"
11445,720575940621765503,right,T3,562,-5,-2,4,-6,"-5,-2"
11446,720575940627352591,right,T3,563,5,-13,-12,-1,"5,-13"
11447,720575940623522186,right,T3,564,3,-23,-15,-8,"3,-23"
11448,720575940637263790,right,T3,565,0,-26,-13,-13,"0,-26"
11449,720575940627275023,right,T3,566,5,-8,-9,1,"5,-8"
11450,720575940640725080,right,T3,567,-2,22,13,9,"-2,22"
11451,720575940629481835,right,T3,569,6,6,-3,9,"6,6"
11452,720575940627490179,right,T3,571,0,-14,-7,-7,"0,-14"
11453,720575940615629398,right,T3,572,-8,3,9,-6,"-8,3"
11454,720575940637757929,right,T3,573,4,14,3,11,"4,14"
11455,720575940625037607,right,T3,574,-6,5,8,-3,"-6,5"
11456,720575940616061627,right,T3,575,6,9,-2,11,"6,9"
11457,720575940623545565,right,T3,576,0,28,14,14,"0,28"
11458,720575940635604984,right,T3,577,5,-14,-12,-2,"5,-14"
11459,720575940619200670,right,T3,578,4,-11,-10,-1,"4,-11"
11460,720575940638374589,right,T3,579,-3,-10,-2,-8,"-3,-10"
11461,720575940641271285,right,T3,580,-2,-23,-10,-13,"-2,-23"
11462,720575940649439097,right,T3,581,3,9,1,8,"3,9"
11463,720575940624160008,right,T3,582,-1,23,12,11,"-1,23"
11464,720575940633253971,right,T3,584,4,23,7,16,"4,23"
11465,720575940618965918,right,T3,585,-1,-23,-11,-12,"-1,-23"
11466,720575940623647159,right,T3,586,2,18,7,11,"2,18"
11467,720575940626954109,right,T3,587,4,22,7,15,"4,22"
11468,720575940629697835,right,T3,588,1,4,1,3,"1,4"
11469,720575940627849896,right,T3,589,-1,-5,-2,-3,"-1,-5"
11470,720575940644806600,right,T3,590,1,9,3,6,"1,9"
11471,720575940622719237,right,T3,591,3,-3,-5,2,"3,-3"
11472,720575940629932818,right,T3,593,3,-14,-10,-4,"3,-14"
11473,720575940635105375,right,T3,594,7,-16,-15,-1,"7,-16"
11474,720575940627362831,right,T3,595,7,-12,-13,1,"7,-12"
11475,720575940636688526,right,T3,596,-4,-16,-4,-12,"-4,-16"
11476,720575940622033228,right,T3,597,4,1,-4,5,"4,1"
11477,720575940636030575,right,T3,598,2,-18,-11,-7,"2,-18"
11478,720575940629902018,right,T3,599,-1,9,5,4,"-1,9"
11479,720575940612472217,right,T3,600,3,-10,-8,-2,"3,-10"
11480,720575940622965542,right,T3,601,1,16,7,9,"1,16"
11481,720575940626090242,right,T3,602,4,-2,-5,3,"4,-2"
11482,720575940614551806,right,T3,603,-3,-23,-9,-14,"-3,-23"
11483,720575940619123870,right,T3,604,-6,-17,-3,-14,"-6,-17"
11484,720575940612544790,right,T3,605,3,15,4,11,"3,15"
11485,720575940631140764,right,T3,606,-1,-19,-9,-10,"-1,-19"
11486,720575940633550562,right,T3,607,1,18,8,10,"1,18"
11487,720575940644604183,right,T3,608,1,10,4,6,"1,10"
11488,720575940629341484,right,T3,609,-2,0,2,-2,"-2,0"
11489,720575940628037141,right,T3,610,2,-23,-14,-9,"2,-23"
11490,720575940634344217,right,T3,611,-1,-18,-8,-10,"-1,-18"
11491,720575940629956624,right,T3,612,-3,-26,-10,-16,"-3,-26"
11492,720575940612630963,right,T3,613,-8,-4,6,-10,"-8,-4"
11493,720575940609043413,right,T3,614,-2,-8,-2,-6,"-2,-8"
11494,720575940639578182,right,T3,615,-7,-7,3,-10,"-7,-7"
11495,720575940634743544,right,T3,616,-3,15,10,5,"-3,15"
11496,720575940630373591,right,T3,617,-2,-17,-7,-10,"-2,-17"
11497,720575940626836780,right,T3,618,-1,24,13,11,"-1,24"
11498,720575940619360680,right,T3,620,7,1,-7,8,"7,1"
11499,720575940616527617,right,T3,621,1,24,11,13,"1,24"
11500,720575940620693953,right,T3,622,-5,20,15,5,"-5,20"
11501,720575940617078673,right,T3,623,1,13,5,8,"1,13"
11502,720575940626747663,right,T3,624,1,-17,-10,-7,"1,-17"
11503,720575940629483855,right,T3,625,-2,24,14,10,"-2,24"
11504,720575940629140327,right,T3,626,-5,-8,1,-9,"-5,-8"
11505,720575940616888203,right,T3,627,0,-1,-1,0,"0,-1"
11506,720575940624347978,right,T3,628,0,0,0,0,"0,0"
11507,720575940643026212,right,T3,629,4,24,8,16,"4,24"
11508,720575940608687964,right,T3,630,4,8,0,8,"4,8"
11509,720575940630007290,right,T3,631,1,26,12,14,"1,26"
11510,720575940624240324,right,T3,632,3,-20,-13,-7,"3,-20"
11511,720575940616721083,right,T3,633,-1,-24,-11,-13,"-1,-24"
11512,720575940631419695,right,T3,634,-3,-15,-5,-10,"-3,-15"
11513,720575940622102298,right,T3,635,6,-6,-9,3,"6,-6"
11514,720575940625397434,right,T3,636,0,6,3,3,"0,6"
11515,720575940605942718,right,T3,637,3,-21,-14,-7,"3,-21"
11516,720575940616895883,right,T3,638,-1,7,4,3,"-1,7"
11517,720575940620689390,right,T3,639,-4,19,13,6,"-4,19"
11518,720575940631258788,right,T3,640,-1,-16,-7,-9,"-1,-16"
11519,720575940629129692,right,T3,641,-8,-5,5,-10,"-8,-5"
11520,720575940623916807,right,T3,642,-5,-11,-1,-10,"-5,-11"
11521,720575940628126571,right,T3,643,6,14,1,13,"6,14"
11522,720575940620429183,right,T3,644,-6,18,15,3,"-6,18"
11523,720575940633206476,right,T3,645,-4,27,17,10,"-4,27"
11524,720575940611492984,right,T3,647,-4,-7,0,-7,"-4,-7"
11525,720575940635562906,right,T3,648,1,7,2,5,"1,7"
11526,720575940623697589,right,T3,649,-1,5,3,2,"-1,5"
11527,720575940605998513,right,T3,651,-4,-5,1,-6,"-4,-5"
11528,720575940618885243,right,T3,652,-6,-11,0,-11,"-6,-11"
11529,720575940617557945,right,T3,653,-6,-12,0,-12,"-6,-12"
11530,720575940630081244,right,T3,654,-3,8,7,1,"-3,8"
11531,720575940643373216,right,T3,655,6,-1,-7,6,"6,-1"
11532,720575940627035663,right,T3,656,0,-11,-6,-5,"0,-11"
11533,720575940630949394,right,T3,658,1,20,9,11,"1,20"
11534,720575940623791613,right,T3,659,-4,-6,1,-7,"-4,-6"
11535,720575940629996076,right,T3,660,2,28,12,16,"2,28"
11536,720575940631348444,right,T3,661,-3,14,10,4,"-3,14"
11537,720575940633101741,right,T3,662,2,-1,-3,2,"2,-1"
11538,720575940627811015,right,T3,663,0,8,4,4,"0,8"
11539,720575940637435504,right,T3,665,7,-2,-8,6,"7,-2"
11540,720575940627700040,right,T3,667,1,-28,-15,-13,"1,-28"
11541,720575940632012136,right,T3,668,1,19,8,11,"1,19"
11542,720575940612886898,right,T3,669,4,-16,-12,-4,"4,-16"
11543,720575940639331443,right,T3,670,5,5,-3,8,"5,5"
11544,720575940630995340,right,T3,671,-4,-23,-8,-15,"-4,-23"
11545,720575940640398043,right,T3,672,-8,11,13,-2,"-8,11"
11546,720575940642858036,right,T3,673,2,5,0,5,"2,5"
11547,720575940623440836,right,T3,674,-4,-14,-3,-11,"-4,-14"
11548,720575940617866385,right,T3,676,-3,-21,-8,-13,"-3,-21"
11549,720575940626323075,right,T3,677,0,11,5,6,"0,11"
11550,720575940637545869,right,T3,678,3,-7,-7,0,"3,-7"
11551,720575940617194129,right,T3,679,4,18,5,13,"4,18"
11552,720575940620284245,right,T3,680,-1,25,13,12,"-1,25"
11553,720575940617750848,right,T3,681,-2,-21,-9,-12,"-2,-21"
11554,720575940627363343,right,T3,682,6,-8,-10,2,"6,-8"
11555,720575940633974355,right,T3,683,2,6,1,5,"2,6"
11556,720575940617488313,right,T3,684,-6,17,14,3,"-6,17"
11557,720575940618180123,right,T3,685,-5,-9,0,-9,"-5,-9"
11558,720575940626390044,right,T3,686,5,-22,-16,-6,"5,-22"
11559,720575940632647249,right,T3,687,-6,-3,4,-7,"-6,-3"
11560,720575940622369869,right,T3,688,-7,10,12,-2,"-7,10"
11561,720575940643396000,right,T3,689,-2,18,11,7,"-2,18"
11562,720575940617914881,right,T3,690,-7,-3,5,-8,"-7,-3"
11563,720575940621285552,right,T3,691,-9,4,11,-7,"-9,4"
11564,720575940624907815,right,T3,692,-4,24,16,8,"-4,24"
11565,720575940626802476,right,T3,693,-3,25,15,10,"-3,25"
11566,720575940620831879,right,T3,694,4,3,-3,6,"4,3"
11567,720575940608133042,right,T3,695,-6,10,11,-1,"-6,10"
11568,720575940635018335,right,T3,696,-2,16,10,6,"-2,16"
11569,720575940617808569,right,T3,697,1,-22,-12,-10,"1,-22"
11570,720575940631091653,right,T3,698,6,-7,-10,3,"6,-7"
11571,720575940633190369,right,T3,699,-5,0,5,-5,"-5,0"
11572,720575940614552588,right,T3,701,0,-4,-2,-2,"0,-4"
11573,720575940620200525,right,T3,702,-5,23,16,7,"-5,23"
11574,720575940636955870,right,T3,703,-3,1,3,-2,"-3,1"
11575,720575940620048660,right,T3,704,-7,8,11,-3,"-7,8"
11576,720575940610388434,right,T3,705,1,1,-1,2,"1,1"
11577,720575940630283642,right,T3,706,-7,-12,1,-13,"-7,-12"
11578,720575940609888324,right,T3,707,-2,25,14,11,"-2,25"
11579,720575940613839218,right,T3,709,-2,-24,-10,-14,"-2,-24"
11580,720575940622441129,right,T3,710,4,-25,-17,-8,"4,-25"
11581,720575940621756148,right,T3,711,-1,19,10,9,"-1,19"
11582,720575940626802460,right,T3,712,-7,12,13,-1,"-7,12"
11583,720575940619401607,right,T3,713,-6,16,14,2,"-6,16"
11584,720575940632524063,right,T3,714,5,12,1,11,"5,12"
11585,720575940617504001,right,T3,715,4,10,1,9,"4,10"
11586,720575940632403539,right,T3,716,4,-6,-7,1,"4,-6"
11587,720575940621170036,right,T3,717,2,-22,-13,-9,"2,-22"
11588,720575940635043738,right,T3,719,1,27,12,15,"1,27"
11589,720575940622214576,right,T3,720,-5,21,15,6,"-5,21"
11590,720575940625829988,right,T3,721,5,13,1,12,"5,13"
11591,720575940622396284,right,T3,722,6,-15,-14,-1,"6,-15"
11592,720575940632323941,right,T3,723,-2,-11,-4,-7,"-2,-11"
11593,720575940622314205,right,T3,724,4,2,-3,5,"4,2"
11594,720575940627693906,right,T3,725,-3,-24,-9,-15,"-3,-24"
11595,720575940660660865,right,T3,726,2,-28,-16,-12,"2,-28"
11596,720575940622079913,right,T3,727,7,6,-4,10,"7,6"
11597,720575940628962923,right,T3,728,7,12,-1,13,"7,12"
11598,720575940638055002,right,T3,729,-3,29,17,12,"-3,29"
11599,720575940603767980,right,T3,730,7,0,-7,7,"7,0"
11600,720575940620720475,right,T3,731,-6,9,10,-1,"-6,9"
11601,720575940627027018,right,T3,732,-3,6,6,0,"-3,6"
11602,720575940646400547,right,T3,733,-5,-17,-4,-13,"-5,-17"
11603,720575940638869557,right,T3,734,2,0,-2,2,"2,0"
11604,720575940630751788,right,T3,735,1,-23,-13,-10,"1,-23"
11605,720575940623592842,right,T3,737,0,19,9,10,"0,19"
11606,720575940623917319,right,T3,738,-3,13,9,4,"-3,13"
11607,720575940623635785,right,T3,739,-7,2,8,-6,"-7,2"
11608,720575940621885168,right,T3,740,2,-8,-6,-2,"2,-8"
11609,720575940605682022,right,T3,741,-2,-14,-5,-9,"-2,-14"
11610,720575940617376310,right,T3,742,-4,11,9,2,"-4,11"
11611,720575940632103499,right,T3,743,6,-19,-16,-3,"6,-19"
11612,720575940628438769,right,T3,744,-4,25,16,9,"-4,25"
11613,720575940629176314,right,T3,745,0,13,6,7,"0,13"
11614,720575940612020453,right,T3,746,-3,3,4,-1,"-3,3"
11615,720575940653998497,right,T3,747,0,2,1,1,"0,2"
11616,720575940639855704,right,T3,748,-4,20,14,6,"-4,20"
11617,720575940623878124,right,T3,749,-2,1,2,-1,"-2,1"
11618,720575940630152503,right,T3,750,4,-24,-16,-8,"4,-24"
11619,720575940617519873,right,T3,751,1,6,2,4,"1,6"
11620,720575940604923616,right,T3,752,-2,7,5,2,"-2,7"
11621,720575940631654095,right,T3,753,-3,24,15,9,"-3,24"
11622,720575940614501073,right,T3,754,-1,-13,-6,-7,"-1,-13"
11623,720575940628251142,right,T3,755,4,19,5,14,"4,19"
11624,720575940618487109,right,T3,757,0,-6,-3,-3,"0,-6"
11625,720575940632651212,right,T3,758,5,-1,-6,5,"5,-1"
11626,720575940655969441,right,T3,759,7,14,0,14,"7,14"
11627,720575940630482519,right,T3,760,0,17,8,9,"0,17"
11628,720575940628726787,right,T3,761,-4,-18,-5,-13,"-4,-18"
11629,720575940637856233,right,T3,762,0,14,7,7,"0,14"
11630,720575940618076957,right,T3,763,-5,14,12,2,"-5,14"
11631,720575940628900507,right,T3,765,-3,9,7,2,"-3,9"
11632,720575940614792354,right,T3,766,2,-4,-4,0,"2,-4"
11633,720575940626829868,right,T3,767,1,28,13,15,"1,28"
11634,720575940632779565,right,T3,768,3,5,-1,6,"3,5"
11635,720575940645818734,right,T3,769,4,-27,-18,-9,"4,-27"
11636,720575940615071906,right,T3,770,5,4,-3,7,"5,4"
11637,720575940634974615,right,T3,771,3,-27,-17,-10,"3,-27"
11638,720575940627206188,right,T3,772,1,12,5,7,"1,12"
11639,720575940618616630,right,T3,773,5,-19,-15,-4,"5,-19"
11640,720575940624037611,right,T3,774,-8,6,11,-5,"-8,6"
11641,720575940628001362,right,T3,775,5,22,6,16,"5,22"
11642,720575940637814494,right,T3,778,4,25,8,17,"4,25"
11643,720575940614932630,right,T3,780,-6,25,18,7,"-6,25"
11644,720575940636576869,right,T3,781,-5,26,18,8,"-5,26"
11645,720575940621582507,right,T3,783,-4,28,18,10,"-4,28"
11646,720575940627944979,right,T3,784,-4,29,18,11,"-4,29"
11647,720575940630024976,right,T3,790,-2,-27,-12,-15,"-2,-27"
11648,720575940621024862,right,T3,791,-1,-28,-13,-15,"-1,-28"
11649,720575940624253675,right,T3,792,8,2,-7,9,"8,2"
11650,720575940612657010,right,T3,796,4,26,9,17,"4,26"
11651,720575940604828849,right,T4a,1,-6,13,12,1,"-6,13"
11652,720575940638598709,right,T4a,2,-8,2,9,-7,"-8,2"
11653,720575940632444431,right,T4a,3,6,-12,-12,0,"6,-12"
11654,720575940633877087,right,T4a,4,-5,-21,-6,-15,"-5,-21"
11655,720575940623290343,right,T4a,5,-1,16,9,7,"-1,16"
11656,720575940606181762,right,T4a,6,-2,-4,0,-4,"-2,-4"
11657,720575940620419207,right,T4a,8,-4,26,17,9,"-4,26"
11658,720575940628947459,right,T4a,9,4,9,0,9,"4,9"
11659,720575940625910576,right,T4a,10,5,-15,-13,-2,"5,-15"
11660,720575940632299335,right,T4a,11,7,-14,-14,0,"7,-14"
11661,720575940630812231,right,T4a,12,-7,9,11,-2,"-7,9"
11662,720575940615078831,right,T4a,13,-1,-26,-12,-14,"-1,-26"
11663,720575940619710293,right,T4a,14,0,-27,-14,-13,"0,-27"
11664,720575940621002108,right,T4a,15,2,-3,-4,1,"2,-3"
11665,720575940624257021,right,T4a,16,-2,-16,-6,-10,"-2,-16"
11666,720575940625877552,right,T4a,17,1,-5,-4,-1,"1,-5"
11667,720575940615794738,right,T4a,18,5,-16,-13,-3,"5,-16"
11668,720575940632490527,right,T4a,19,-7,17,15,2,"-7,17"
11669,720575940630524631,right,T4a,20,3,-11,-9,-2,"3,-11"
11670,720575940621243672,right,T4a,21,-2,19,11,8,"-2,19"
11671,720575940635213157,right,T4a,22,-1,3,2,1,"-1,3"
11672,720575940623504359,right,T4a,24,-1,-10,-4,-6,"-1,-10"
11673,720575940635031447,right,T4a,26,1,-3,-3,0,"1,-3"
11674,720575940615911583,right,T4a,27,0,-25,-13,-12,"0,-25"
11675,720575940609751138,right,T4a,28,5,6,-2,8,"5,6"
11676,720575940655109793,right,T4a,29,-1,-3,-1,-2,"-1,-3"
11677,720575940641000181,right,T4a,30,6,16,2,14,"6,16"
11678,720575940620496913,right,T4a,31,0,16,8,8,"0,16"
11679,720575940617306068,right,T4a,32,0,12,6,6,"0,12"
11680,720575940618066715,right,T4a,33,3,18,6,12,"3,18"
11681,720575940629178923,right,T4a,34,6,18,3,15,"6,18"
11682,720575940633496545,right,T4a,35,1,-24,-13,-11,"1,-24"
11683,720575940621618209,right,T4a,36,6,8,-2,10,"6,8"
11684,720575940623261418,right,T4a,37,1,5,1,4,"1,5"
11685,720575940627870151,right,T4a,38,0,-2,-1,-1,"0,-2"
11686,720575940604836012,right,T4a,39,0,20,10,10,"0,20"
11687,720575940626091706,right,T4a,40,-2,-6,-1,-5,"-2,-6"
11688,720575940610367044,right,T4a,41,-3,28,17,11,"-3,28"
11689,720575940624750268,right,T4a,42,-1,14,8,6,"-1,14"
11690,720575940634254748,right,T4a,43,-5,18,14,4,"-5,18"
11691,720575940608391691,right,T4a,44,5,-10,-10,0,"5,-10"
11692,720575940618444155,right,T4a,45,-5,-1,4,-5,"-5,-1"
11693,720575940620611866,right,T4a,46,-5,15,12,3,"-5,15"
11694,720575940626654864,right,T4a,48,-4,-22,-7,-15,"-4,-22"
11695,720575940617975586,right,T4a,49,4,-4,-6,2,"4,-4"
11696,720575940609420043,right,T4a,50,-2,21,12,9,"-2,21"
11697,720575940616084948,right,T4a,51,0,-19,-10,-9,"0,-19"
11698,720575940637980762,right,T4a,52,-1,-22,-10,-12,"-1,-22"
11699,720575940617416660,right,T4a,53,5,14,2,12,"5,14"
11700,720575940637467102,right,T4a,54,-4,3,5,-2,"-4,3"
11701,720575940614791645,right,T4a,55,-4,-11,-2,-9,"-4,-11"
11702,720575940632611615,right,T4a,56,1,-13,-8,-5,"1,-13"
11703,720575940627066364,right,T4a,57,6,-11,-12,1,"6,-11"
11704,720575940616228725,right,T4a,58,3,12,3,9,"3,12"
11705,720575940637099236,right,T4a,59,-2,2,3,-1,"-2,2"
11706,720575940624928333,right,T4a,60,-8,8,12,-4,"-8,8"
11707,720575940630834316,right,T4a,61,-4,-4,2,-6,"-4,-4"
11708,720575940625467011,right,T4a,62,0,-29,-15,-14,"0,-29"
11709,720575940616492305,right,T4a,63,4,12,2,10,"4,12"
11710,720575940626623516,right,T4a,64,4,-23,-16,-7,"4,-23"
11711,720575940626211884,right,T4a,65,-1,28,15,13,"-1,28"
11712,720575940620076208,right,T4a,66,2,15,5,10,"2,15"
11713,720575940619354539,right,T4a,67,-2,-13,-5,-8,"-2,-13"
11714,720575940625923770,right,T4a,68,3,16,5,11,"3,16"
11715,720575940622581395,right,T4a,69,1,8,3,5,"1,8"
11716,720575940636387502,right,T4a,70,-4,21,14,7,"-4,21"
11717,720575940630100471,right,T4a,71,-2,-3,0,-3,"-2,-3"
11718,720575940612124851,right,T4a,72,0,-28,-14,-14,"0,-28"
11719,720575940614701836,right,T4a,73,2,2,-1,3,"2,2"
11720,720575940643722184,right,T4a,74,-1,-9,-4,-5,"-1,-9"
11721,720575940637519757,right,T4a,76,-3,-4,1,-5,"-3,-4"
11722,720575940608262106,right,T4a,77,2,-5,-5,0,"2,-5"
11723,720575940610651346,right,T4a,78,2,20,8,12,"2,20"
11724,720575940619090555,right,T4a,79,2,1,-2,3,"2,1"
11725,720575940622566825,right,T4a,80,4,13,2,11,"4,13"
11726,720575940609740381,right,T4a,81,6,-2,-7,5,"6,-2"
11727,720575940635980139,right,T4a,82,-7,7,10,-3,"-7,7"
11728,720575940629660239,right,T4a,83,2,-21,-13,-8,"2,-21"
11729,720575940644596260,right,T4a,84,-2,12,8,4,"-2,12"
11730,720575940639650638,right,T4a,85,4,-22,-15,-7,"4,-22"
11731,720575940626680665,right,T4a,86,-5,-7,1,-8,"-5,-7"
11732,720575940617861649,right,T4a,87,1,11,4,7,"1,11"
11733,720575940654435489,right,T4a,88,7,4,-5,9,"7,4"
11734,720575940625943340,right,T4a,90,-4,5,6,-1,"-4,5"
11735,720575940633770091,right,T4a,91,-1,6,4,2,"-1,6"
11736,720575940629723639,right,T4a,92,0,9,4,5,"0,9"
11737,720575940626534858,right,T4a,93,-6,3,7,-4,"-6,3"
11738,720575940616194677,right,T4a,94,5,18,4,14,"5,18"
11739,720575940637834637,right,T4a,95,4,-21,-15,-6,"4,-21"
11740,720575940630705995,right,T4a,96,1,-10,-6,-4,"1,-10"
11741,720575940617684027,right,T4a,97,-5,2,6,-4,"-5,2"
11742,720575940629305347,right,T4a,98,-1,-12,-5,-7,"-1,-12"
11743,720575940628081226,right,T4a,99,4,15,3,12,"4,15"
11744,720575940622779061,right,T4a,101,-7,6,10,-4,"-7,6"
11745,720575940617803911,right,T4a,102,3,13,3,10,"3,13"
11746,720575940629489602,right,T4a,103,7,9,-3,12,"7,9"
11747,720575940646718004,right,T4a,104,-1,-27,-13,-14,"-1,-27"
11748,720575940619788169,right,T4a,105,3,22,8,14,"3,22"
11749,720575940648109956,right,T4a,106,-7,11,12,-1,"-7,11"
11750,720575940622571213,right,T4a,107,8,-2,-9,7,"8,-2"
11751,720575940614803933,right,T4a,108,-3,-12,-3,-9,"-3,-12"
11752,720575940627730793,right,T4a,109,4,-5,-7,2,"4,-5"
11753,720575940633963949,right,T4a,110,-7,0,7,-7,"-7,0"
11754,720575940615816635,right,T4a,111,2,-24,-14,-10,"2,-24"
11755,720575940626422805,right,T4a,112,-6,1,6,-5,"-6,1"
11756,720575940643830472,right,T4a,113,-2,4,4,0,"-2,4"
11757,720575940608618197,right,T4a,114,2,-13,-9,-4,"2,-13"
11758,720575940629761146,right,T4a,115,-4,2,5,-3,"-4,2"
11759,720575940639337936,right,T4a,116,-1,-8,-3,-5,"-1,-8"
11760,720575940627839656,right,T4a,118,3,1,-3,4,"3,1"
11761,720575940638973824,right,T4a,119,-2,6,5,1,"-2,6"
11762,720575940627561290,right,T4a,120,-1,-1,0,-1,"-1,-1"
11763,720575940619810068,right,T4a,121,-8,4,10,-6,"-8,4"
11764,720575940625522320,right,T4a,122,-5,9,9,0,"-5,9"
11765,720575940631248079,right,T4a,124,1,-7,-5,-2,"1,-7"
11766,720575940624535590,right,T4a,125,5,9,-1,10,"5,9"
11767,720575940645532980,right,T4a,126,3,11,2,9,"3,11"
11768,720575940623278630,right,T4a,127,0,15,7,8,"0,15"
11769,720575940643322509,right,T4a,128,3,-22,-14,-8,"3,-22"
11770,720575940621721838,right,T4a,129,0,-13,-7,-6,"0,-13"
11771,720575940626951877,right,T4a,130,2,12,4,8,"2,12"
11772,720575940628459526,right,T4a,131,-6,20,16,4,"-6,20"
11773,720575940617005639,right,T4a,132,2,4,0,4,"2,4"
11774,720575940627375106,right,T4a,133,-3,20,13,7,"-3,20"
11775,720575940626951549,right,T4a,135,-3,-22,-8,-14,"-3,-22"
11776,720575940626218877,right,T4a,136,0,3,1,2,"0,3"
11777,720575940619209408,right,T4a,137,5,-7,-9,2,"5,-7"
11778,720575940628794615,right,T4a,138,0,27,13,14,"0,27"
11779,720575940622578183,right,T4a,139,1,-14,-8,-6,"1,-14"
11780,720575940631855687,right,T4a,140,3,8,1,7,"3,8"
11781,720575940619171604,right,T4a,143,-4,16,12,4,"-4,16"
11782,720575940636784105,right,T4a,144,7,-11,-13,2,"7,-11"
11783,720575940606964145,right,T4a,145,0,4,2,2,"0,4"
11784,720575940628420551,right,T4a,146,1,-6,-4,-2,"1,-6"
11785,720575940634840683,right,T4a,147,1,21,9,12,"1,21"
11786,720575940633605345,right,T4a,148,-7,-11,1,-12,"-7,-11"
11787,720575940616148330,right,T4a,149,6,-14,-13,-1,"6,-14"
11788,720575940621181678,right,T4a,150,-8,5,10,-5,"-8,5"
11789,720575940611837304,right,T4a,151,-3,-14,-4,-10,"-3,-14"
11790,720575940624163253,right,T4a,152,3,-15,-11,-4,"3,-15"
11791,720575940628811523,right,T4a,153,8,0,-8,8,"8,0"
11792,720575940630325591,right,T4a,154,-8,0,8,-8,"-8,0"
11793,720575940621496609,right,T4a,156,-9,1,9,-8,"-9,1"
11794,720575940638282566,right,T4a,157,-1,-7,-3,-4,"-1,-7"
11795,720575940632336941,right,T4a,158,3,-5,-6,1,"3,-5"
11796,720575940624503531,right,T4a,159,7,7,-4,11,"7,7"
11797,720575940625994506,right,T4a,160,-2,20,12,8,"-2,20"
11798,720575940638467672,right,T4a,161,4,-14,-11,-3,"4,-14"
11799,720575940621169392,right,T4a,162,-4,-2,3,-5,"-4,-2"
11800,720575940620639050,right,T4a,164,-1,-2,0,-2,"-1,-2"
11801,720575940620436912,right,T4a,165,4,16,4,12,"4,16"
11802,720575940641161205,right,T4a,166,0,18,9,9,"0,18"
11803,720575940617554900,right,T4a,167,0,-17,-9,-8,"0,-17"
11804,720575940626217085,right,T4a,168,-1,17,9,8,"-1,17"
11805,720575940619057531,right,T4a,169,0,-18,-9,-9,"0,-18"
11806,720575940628979892,right,T4a,170,-5,1,5,-4,"-5,1"
11807,720575940615800114,right,T4a,171,6,-20,-16,-4,"6,-20"
11808,720575940608623115,right,T4a,172,1,22,10,12,"1,22"
11809,720575940623178189,right,T4a,173,2,-25,-15,-10,"2,-25"
11810,720575940629123175,right,T4a,174,4,-15,-12,-3,"4,-15"
11811,720575940626462768,right,T4a,175,-6,-7,2,-9,"-6,-7"
11812,720575940627160709,right,T4a,176,-2,13,8,5,"-2,13"
11813,720575940613660071,right,T4a,177,-2,-1,1,-2,"-2,-1"
11814,720575940607283977,right,T4a,178,2,11,3,8,"2,11"
11815,720575940622343804,right,T4a,179,-5,-16,-3,-13,"-5,-16"
11816,720575940638057961,right,T4a,180,2,-27,-16,-11,"2,-27"
11817,720575940621551220,right,T4a,181,1,-4,-3,-1,"1,-4"
11818,720575940628259594,right,T4a,182,7,-10,-12,2,"7,-10"
11819,720575940609578702,right,T4a,183,-5,-15,-3,-12,"-5,-15"
11820,720575940622278890,right,T4a,184,-6,-5,3,-8,"-6,-5"
11821,720575940614580689,right,T4a,185,2,-11,-8,-3,"2,-11"
11822,720575940618818462,right,T4a,186,-1,26,14,12,"-1,26"
11823,720575940614187774,right,T4a,187,3,21,7,14,"3,21"
11824,720575940620623469,right,T4a,188,-5,17,13,4,"-5,17"
11825,720575940609803989,right,T4a,189,6,13,0,13,"6,13"
11826,720575940604831456,right,T4a,190,-3,-5,0,-5,"-3,-5"
11827,720575940608720137,right,T4a,191,-1,-11,-5,-6,"-1,-11"
11828,720575940635930987,right,T4a,192,7,10,-2,12,"7,10"
11829,720575940622739725,right,T4a,193,-5,4,7,-3,"-5,4"
11830,720575940620419824,right,T4a,194,0,-5,-3,-2,"0,-5"
11831,720575940615070431,right,T4a,195,-3,-1,2,-3,"-3,-1"
11832,720575940623627667,right,T4a,196,-1,8,5,3,"-1,8"
11833,720575940629890364,right,T4a,197,0,-20,-10,-10,"0,-20"
11834,720575940608363531,right,T4a,198,6,2,-5,7,"6,2"
11835,720575940646150435,right,T4a,199,0,-12,-6,-6,"0,-12"
11836,720575940631507287,right,T4a,200,-5,12,11,1,"-5,12"
11837,720575940633334112,right,T4a,201,-8,9,12,-3,"-8,9"
11838,720575940631929431,right,T4a,202,-1,27,14,13,"-1,27"
11839,720575940619999818,right,T4a,203,3,-1,-4,3,"3,-1"
11840,720575940620530091,right,T4a,204,5,-2,-6,4,"5,-2"
11841,720575940629532657,right,T4a,205,5,-6,-8,2,"5,-6"
11842,720575940623675831,right,T4a,206,-3,5,5,0,"-3,5"
11843,720575940641057744,right,T4a,207,1,29,13,16,"1,29"
11844,720575940637352845,right,T4a,208,5,-21,-16,-5,"5,-21"
11845,720575940617407705,right,T4a,209,-3,-8,-1,-7,"-3,-8"
11846,720575940639584317,right,T4a,210,-6,8,10,-2,"-6,8"
11847,720575940626962746,right,T4a,211,-7,-1,6,-7,"-7,-1"
11848,720575940614564146,right,T4a,212,2,-16,-10,-6,"2,-16"
11849,720575940608257754,right,T4a,213,3,-4,-5,1,"3,-4"
11850,720575940638814286,right,T4a,214,-5,3,6,-3,"-5,3"
11851,720575940612681898,right,T4a,215,6,7,-3,10,"6,7"
11852,720575940624141385,right,T4a,216,2,19,7,12,"2,19"
11853,720575940607463369,right,T4a,217,6,15,1,14,"6,15"
11854,720575940625472002,right,T4a,218,2,10,3,7,"2,10"
11855,720575940627201929,right,T4a,219,6,-4,-8,4,"6,-4"
11856,720575940623328892,right,T4a,220,2,-6,-5,-1,"2,-6"
11857,720575940629228816,right,T4a,222,-3,26,16,10,"-3,26"
11858,720575940623544551,right,T4a,223,-2,26,15,11,"-2,26"
11859,720575940623961101,right,T4a,224,0,5,2,3,"0,5"
11860,720575940622193953,right,T4a,225,2,-26,-15,-11,"2,-26"
11861,720575940633378274,right,T4a,226,5,19,4,15,"5,19"
11862,720575940613492143,right,T4a,227,-7,5,9,-4,"-7,5"
11863,720575940636466032,right,T4a,228,-7,1,7,-6,"-7,1"
11864,720575940617988353,right,T4a,229,5,2,-4,6,"5,2"
11865,720575940610532757,right,T4a,230,2,9,2,7,"2,9"
11866,720575940618865472,right,T4a,231,4,-12,-10,-2,"4,-12"
11867,720575940618459712,right,T4a,232,-4,13,10,3,"-4,13"
11868,720575940641655860,right,T4a,234,1,3,0,3,"1,3"
11869,720575940621938857,right,T4a,235,4,11,1,10,"4,11"
11870,720575940610253410,right,T4a,236,-1,4,3,1,"-1,4"
11871,720575940632894174,right,T4a,237,-2,27,15,12,"-2,27"
11872,720575940639999989,right,T4a,239,-6,6,9,-3,"-6,6"
11873,720575940633497570,right,T4a,240,-4,-3,2,-5,"-4,-3"
11874,720575940625761917,right,T4a,241,2,-17,-11,-6,"2,-17"
11875,720575940612290969,right,T4a,242,-4,6,7,-1,"-4,6"
11876,720575940612858520,right,T4a,243,-1,-21,-10,-11,"-1,-21"
11877,720575940614620381,right,T4a,244,-4,-12,-2,-10,"-4,-12"
11878,720575940614891462,right,T4a,246,-4,15,11,4,"-4,15"
11879,720575940635682159,right,T4a,247,-4,-15,-4,-11,"-4,-15"
11880,720575940629211756,right,T4a,248,-6,0,6,-6,"-6,0"
11881,720575940624541163,right,T4a,249,2,-12,-8,-4,"2,-12"
11882,720575940635997850,right,T4a,250,-1,1,1,0,"-1,1"
11883,720575940646039575,right,T4a,251,-1,-14,-6,-8,"-1,-14"
11884,720575940629366631,right,T4a,252,3,23,8,15,"3,23"
11885,720575940631236772,right,T4a,253,5,16,3,13,"5,16"
11886,720575940633687972,right,T4a,254,3,-24,-15,-9,"3,-24"
11887,720575940625009131,right,T4a,255,-6,-13,-1,-12,"-6,-13"
11888,720575940633401313,right,T4a,256,5,-20,-15,-5,"5,-20"
11889,720575940620986025,right,T4a,257,2,21,8,13,"2,21"
11890,720575940614621661,right,T4a,258,-4,-17,-5,-12,"-4,-17"
11891,720575940623517320,right,T4a,259,-7,-5,4,-9,"-7,-5"
11892,720575940618458176,right,T4a,260,-3,19,12,7,"-3,19"
11893,720575940607321353,right,T4a,261,-1,13,7,6,"-1,13"
11894,720575940622393724,right,T4a,262,1,-11,-7,-4,"1,-11"
11895,720575940626092218,right,T4a,263,-3,4,5,-1,"-3,4"
11896,720575940637542285,right,T4a,264,-1,-6,-2,-4,"-1,-6"
11897,720575940620745242,right,T4a,265,-6,-1,5,-6,"-6,-1"
11898,720575940632070284,right,T4a,266,-1,-25,-12,-13,"-1,-25"
11899,720575940625628772,right,T4a,267,-6,2,7,-5,"-6,2"
11900,720575940603568757,right,T4a,268,7,-6,-10,4,"7,-6"
11901,720575940630175488,right,T4a,269,2,-19,-12,-7,"2,-19"
11902,720575940630084060,right,T4a,270,1,-8,-5,-3,"1,-8"
11903,720575940632718623,right,T4a,271,4,6,-1,7,"4,6"
11904,720575940618097821,right,T4a,272,3,-2,-4,2,"3,-2"
11905,720575940627811132,right,T4a,273,-6,23,17,6,"-6,23"
11906,720575940617128377,right,T4a,274,6,4,-4,8,"6,4"
11907,720575940643217568,right,T4a,275,-8,-1,7,-8,"-8,-1"
11908,720575940627727134,right,T4a,276,2,3,-1,4,"2,3"
11909,720575940631975505,right,T4a,277,7,-3,-9,6,"7,-3"
11910,720575940630520407,right,T4a,278,-5,10,10,0,"-5,10"
11911,720575940631909037,right,T4a,279,-4,8,8,0,"-4,8"
11912,720575940636555877,right,T4a,280,-6,-14,-1,-13,"-6,-14"
11913,720575940624538928,right,T4a,282,0,26,13,13,"0,26"
11914,720575940643963592,right,T4a,283,-4,4,6,-2,"-4,4"
11915,720575940614943455,right,T4a,284,0,25,12,13,"0,25"
11916,720575940626510937,right,T4a,285,6,-18,-15,-3,"6,-18"
11917,720575940634580331,right,T4a,286,0,-24,-12,-12,"0,-24"
11918,720575940621048240,right,T4a,287,-5,13,11,2,"-5,13"
11919,720575940622866836,right,T4a,288,-1,30,16,14,"-1,30"
11920,720575940622647907,right,T4a,289,-1,11,6,5,"-1,11"
11921,720575940621540544,right,T4a,290,5,-24,-17,-7,"5,-24"
11922,720575940638300724,right,T4a,291,7,2,-6,8,"7,2"
11923,720575940615234207,right,T4a,292,-4,18,13,5,"-4,18"
11924,720575940638369252,right,T4a,293,4,-17,-13,-4,"4,-17"
11925,720575940623392214,right,T4a,294,1,-20,-11,-9,"1,-20"
11926,720575940634520683,right,T4a,295,-2,29,16,13,"-2,29"
11927,720575940626097189,right,T4a,296,1,-18,-10,-8,"1,-18"
11928,720575940618910621,right,T4a,297,7,-9,-12,3,"7,-9"
11929,720575940618331456,right,T4a,298,-5,5,7,-2,"-5,5"
11930,720575940619120037,right,T4a,299,-4,12,10,2,"-4,12"
11931,720575940614290897,right,T4a,300,4,-18,-13,-5,"4,-18"
11932,720575940622773530,right,T4a,301,-5,16,13,3,"-5,16"
11933,720575940627806480,right,T4a,302,2,17,6,11,"2,17"
11934,720575940632067665,right,T4a,303,-5,22,16,6,"-5,22"
11935,720575940621275775,right,T4a,304,6,5,-4,9,"6,5"
11936,720575940623240595,right,T4a,306,3,7,0,7,"3,7"
11937,720575940629239772,right,T4a,308,-5,8,9,-1,"-5,8"
11938,720575940637863657,right,T4a,309,-6,12,12,0,"-6,12"
11939,720575940620479038,right,T4a,310,2,22,9,13,"2,22"
11940,720575940634346391,right,T4a,311,-7,15,14,1,"-7,15"
11941,720575940610968562,right,T4a,312,4,-7,-8,1,"4,-7"
11942,720575940615731131,right,T4a,313,7,3,-6,9,"7,3"
11943,720575940617270621,right,T4a,315,-3,-6,0,-6,"-3,-6"
11944,720575940631251919,right,T4a,316,5,-4,-7,3,"5,-4"
11945,720575940616165738,right,T4a,317,-5,-4,3,-7,"-5,-4"
11946,720575940623494925,right,T4a,318,4,-19,-14,-5,"4,-19"
11947,720575940631410060,right,T4a,319,-2,5,4,1,"-2,5"
11948,720575940619387973,right,T4a,320,-2,-5,-1,-4,"-2,-5"
11949,720575940621841833,right,T4a,321,8,4,-6,10,"8,4"
11950,720575940625414448,right,T4a,322,2,26,11,15,"2,26"
11951,720575940631382851,right,T4a,324,3,24,9,15,"3,24"
11952,720575940640037072,right,T4a,325,5,1,-5,6,"5,1"
11953,720575940633096659,right,T4a,326,2,16,6,10,"2,16"
11954,720575940641621812,right,T4a,327,5,3,-4,7,"5,3"
11955,720575940613465581,right,T4a,329,0,24,12,12,"0,24"
11956,720575940616208982,right,T4a,330,3,3,-2,5,"3,3"
11957,720575940621434333,right,T4a,331,1,-15,-9,-6,"1,-15"
11958,720575940628584386,right,T4a,332,4,-26,-17,-9,"4,-26"
11959,720575940605055660,right,T4a,333,0,-21,-11,-10,"0,-21"
11960,720575940623501055,right,T4a,334,1,-26,-14,-12,"1,-26"
11961,720575940614556363,right,T4a,335,2,8,2,6,"2,8"
11962,720575940630484311,right,T4a,336,0,23,11,12,"0,23"
11963,720575940622967832,right,T4a,337,-5,-6,2,-8,"-5,-6"
11964,720575940639190912,right,T4a,338,-1,0,1,-1,"-1,0"
11965,720575940625678606,right,T4a,339,6,11,-1,12,"6,11"
11966,720575940624756408,right,T4a,340,-4,17,12,5,"-4,17"
11967,720575940631999951,right,T4a,341,6,-17,-15,-2,"6,-17"
11968,720575940633177517,right,T4a,342,2,-15,-10,-5,"2,-15"
11969,720575940624564016,right,T4a,343,-3,27,16,11,"-3,27"
11970,720575940604712688,right,T4a,344,-2,-15,-6,-9,"-2,-15"
11971,720575940620687599,right,T4a,345,3,-12,-9,-3,"3,-12"
11972,720575940620968361,right,T4a,348,3,14,4,10,"3,14"
11973,720575940658932097,right,T4a,349,-5,-14,-2,-12,"-5,-14"
11974,720575940632979100,right,T4a,350,1,15,6,9,"1,15"
11975,720575940604745456,right,T4a,351,-1,-17,-8,-9,"-1,-17"
11976,720575940620310208,right,T4a,352,-2,28,16,12,"-2,28"
11977,720575940620890748,right,T4a,353,2,24,10,14,"2,24"
11978,720575940622171416,right,T4a,354,-2,-26,-11,-15,"-2,-26"
11979,720575940620576773,right,T4a,355,-7,-6,4,-10,"-7,-6"
11980,720575940630548055,right,T4a,356,0,22,11,11,"0,22"
11981,720575940617308277,right,T4a,357,4,17,4,13,"4,17"
11982,720575940639952000,right,T4a,358,-3,17,11,6,"-3,17"
11983,720575940631951756,right,T4a,359,2,23,9,14,"2,23"
11984,720575940622534614,right,T4a,360,-5,19,14,5,"-5,19"
11985,720575940623890685,right,T4a,361,0,-7,-4,-3,"0,-7"
11986,720575940637707098,right,T4a,362,2,-20,-12,-8,"2,-20"
11987,720575940617948957,right,T4a,363,7,-4,-9,5,"7,-4"
11988,720575940635997594,right,T4a,364,4,4,-2,6,"4,4"
11989,720575940626548368,right,T4a,365,4,7,-1,8,"4,7"
11990,720575940614579837,right,T4a,368,-4,-20,-6,-14,"-4,-20"
11991,720575940627598852,right,T4a,369,5,-5,-8,3,"5,-5"
11992,720575940639773568,right,T4a,370,-3,21,13,8,"-3,21"
11993,720575940609744733,right,T4a,371,6,-5,-9,4,"6,-5"
11994,720575940634499832,right,T4a,372,1,-2,-2,0,"1,-2"
11995,720575940618038109,right,T4a,373,1,-21,-12,-9,"1,-21"
11996,720575940636224363,right,T4a,374,2,13,4,9,"2,13"
11997,720575940628926467,right,T4a,377,0,7,3,4,"0,7"
11998,720575940617795668,right,T4a,378,-3,18,12,6,"-3,18"
11999,720575940635113919,right,T4a,379,3,-17,-12,-5,"3,-17"
12000,720575940633981921,right,T4a,380,-1,29,15,14,"-1,29"
12001,720575940637284493,right,T4a,382,3,-6,-6,0,"3,-6"
12002,720575940612211826,right,T4a,383,-6,11,11,0,"-6,11"
12003,720575940637995632,right,T4a,384,-6,-2,5,-7,"-6,-2"
12004,720575940619713645,right,T4a,385,-3,-18,-6,-12,"-3,-18"
12005,720575940643758280,right,T4a,386,-6,19,15,4,"-6,19"
12006,720575940614991997,right,T4a,387,-1,-15,-7,-8,"-1,-15"
12007,720575940622126847,right,T4a,388,3,19,6,13,"3,19"
12008,720575940661224065,right,T4a,390,-6,-9,1,-10,"-6,-9"
12009,720575940603491957,right,T4a,391,4,-3,-6,3,"4,-3"
12010,720575940622851511,right,T4a,392,-4,7,7,0,"-4,7"
12011,720575940624046630,right,T4a,393,-1,22,12,10,"-1,22"
12012,720575940628110854,right,T4a,394,-7,-8,3,-11,"-7,-8"
12013,720575940616641058,right,T4a,396,-1,10,6,4,"-1,10"
12014,720575940617614265,right,T4a,397,-3,-19,-7,-12,"-3,-19"
12015,720575940623824713,right,T4a,398,-3,22,14,8,"-3,22"
12016,720575940636434424,right,T4a,400,1,-29,-16,-13,"1,-29"
12017,720575940620128438,right,T4a,401,-2,-19,-8,-11,"-2,-19"
12018,720575940632946340,right,T4a,402,3,26,10,16,"3,26"
12019,720575940599755718,right,T4a,403,-2,-12,-4,-8,"-2,-12"
12020,720575940623458348,right,T4a,404,-1,20,11,9,"-1,20"
12021,720575940637688639,right,T4a,405,3,10,2,8,"3,10"
12022,720575940622300810,right,T4a,406,1,-25,-14,-11,"1,-25"
12023,720575940640283701,right,T4a,407,-5,-10,0,-10,"-5,-10"
12024,720575940634622359,right,T4a,408,-6,-4,4,-8,"-6,-4"
12025,720575940614122646,right,T4a,409,0,-3,-2,-1,"0,-3"
12026,720575940613565849,right,T4a,410,-2,-2,1,-3,"-2,-2"
12027,720575940634696161,right,T4a,411,-5,-19,-5,-14,"-5,-19"
12028,720575940626370947,right,T4a,413,-2,-7,-2,-5,"-2,-7"
12029,720575940632803921,right,T4a,414,4,21,6,15,"4,21"
12030,720575940620765793,right,T4a,415,6,12,0,12,"6,12"
12031,720575940635694328,right,T4a,416,3,-8,-7,-1,"3,-8"
12032,720575940622676464,right,T4a,417,-6,-10,1,-11,"-6,-10"
12033,720575940620785574,right,T4a,418,-2,15,9,6,"-2,15"
12034,720575940635232180,right,T4a,420,6,-3,-8,5,"6,-3"
12035,720575940621130593,right,T4a,421,-1,12,7,5,"-1,12"
12036,720575940637592127,right,T4a,422,-7,-4,5,-9,"-7,-4"
12037,720575940635518093,right,T4a,423,3,-18,-12,-6,"3,-18"
12038,720575940622595572,right,T4a,424,-3,-2,2,-4,"-3,-2"
12039,720575940625924144,right,T4a,425,3,20,7,13,"3,20"
12040,720575940629210292,right,T4a,426,-3,0,3,-3,"-3,0"
12041,720575940630719340,right,T4a,427,5,-18,-14,-4,"5,-18"
12042,720575940629663938,right,T4a,428,-2,23,13,10,"-2,23"
12043,720575940641120653,right,T4a,429,-2,14,9,5,"-2,14"
12044,720575940632643245,right,T4a,430,-3,-7,-1,-6,"-3,-7"
12045,720575940635245492,right,T4a,431,-2,-10,-3,-7,"-2,-10"
12046,720575940641231757,right,T4a,432,-5,7,8,-1,"-5,7"
12047,720575940606444930,right,T4a,433,0,-8,-4,-4,"0,-8"
12048,720575940620755717,right,T4a,434,-3,7,6,1,"-3,7"
12049,720575940638950051,right,T4a,436,0,-15,-8,-7,"0,-15"
12050,720575940627200812,right,T4a,437,-3,12,9,3,"-3,12"
12051,720575940626312997,right,T4a,438,2,27,11,16,"2,27"
12052,720575940634124057,right,T4a,439,-3,-9,-2,-7,"-3,-9"
12053,720575940608498955,right,T4a,440,1,23,10,13,"1,23"
12054,720575940615181974,right,T4a,441,3,-16,-11,-5,"3,-16"
12055,720575940615337895,right,T4a,442,-5,25,17,8,"-5,25"
12056,720575940623132125,right,T4a,443,-6,4,8,-4,"-6,4"
12057,720575940623438828,right,T4a,444,4,-10,-9,-1,"4,-10"
12058,720575940649994361,right,T4a,445,-2,8,6,2,"-2,8"
12059,720575940637706125,right,T4a,446,2,-14,-9,-5,"2,-14"
12060,720575940615307682,right,T4a,447,-1,2,2,0,"-1,2"
12061,720575940634302419,right,T4a,449,6,-16,-14,-2,"6,-16"
12062,720575940644600343,right,T4a,450,2,-9,-7,-2,"2,-9"
12063,720575940621488922,right,T4a,451,4,20,6,14,"4,20"
12064,720575940645056110,right,T4a,452,1,-9,-6,-3,"1,-9"
12065,720575940637090416,right,T4a,453,3,25,9,16,"3,25"
12066,720575940632720485,right,T4a,454,5,-12,-11,-1,"5,-12"
12067,720575940621422774,right,T4a,455,7,-7,-11,4,"7,-7"
12068,720575940614109892,right,T4a,456,0,21,10,11,"0,21"
12069,720575940631378755,right,T4a,457,-2,17,10,7,"-2,17"
12070,720575940632208927,right,T4a,458,5,0,-5,5,"5,0"
12071,720575940607902682,right,T4a,459,5,-3,-7,4,"5,-3"
12072,720575940629480433,right,T4a,460,-3,-20,-7,-13,"-3,-20"
12073,720575940623858616,right,T4a,461,7,-5,-10,5,"7,-5"
12074,720575940614578338,right,T4a,462,-1,18,10,8,"-1,18"
12075,720575940633005212,right,T4a,463,5,17,3,14,"5,17"
12076,720575940621531584,right,T4a,464,4,0,-4,4,"4,0"
12077,720575940634355993,right,T4a,465,3,0,-3,3,"3,0"
12078,720575940608305500,right,T4a,466,1,14,6,8,"1,14"
12079,720575940636686990,right,T4a,467,-2,-20,-8,-12,"-2,-20"
12080,720575940627147052,right,T4a,468,-3,11,8,3,"-3,11"
12081,720575940607814106,right,T4a,470,4,-9,-9,0,"4,-9"
12082,720575940624938940,right,T4a,471,3,-26,-16,-10,"3,-26"
12083,720575940631027275,right,T4a,472,1,25,11,14,"1,25"
12084,720575940626777496,right,T4a,473,-4,23,15,8,"-4,23"
12085,720575940634256279,right,T4a,475,-4,-1,3,-4,"-4,-1"
12086,720575940618989214,right,T4a,476,-1,15,8,7,"-1,15"
12087,720575940620131237,right,T4a,477,-3,2,4,-2,"-3,2"
12088,720575940638487155,right,T4a,479,-2,10,7,3,"-2,10"
12089,720575940614191766,right,T4a,480,3,-19,-13,-6,"3,-19"
12090,720575940617925067,right,T4a,481,4,-8,-8,0,"4,-8"
12091,720575940620511249,right,T4a,482,1,17,7,10,"1,17"
12092,720575940613443084,right,T4a,483,2,-7,-6,-1,"2,-7"
12093,720575940623949309,right,T4a,484,3,-9,-8,-1,"3,-9"
12094,720575940618651864,right,T4a,485,-3,-3,1,-4,"-3,-3"
12095,720575940639988176,right,T4a,486,0,1,0,1,"0,1"
12096,720575940600101641,right,T4a,487,1,-1,-2,1,"1,-1"
12097,720575940628954883,right,T4a,488,7,5,-5,10,"7,5"
12098,720575940647066932,right,T4a,489,-3,10,8,2,"-3,10"
12099,720575940629837868,right,T4a,490,-5,6,8,-2,"-5,6"
12100,720575940626047492,right,T4a,491,7,-1,-8,7,"7,-1"
12101,720575940627149834,right,T4a,492,-7,-2,6,-8,"-7,-2"
12102,720575940610736533,right,T4a,493,-3,23,14,9,"-3,23"
12103,720575940626217516,right,T4a,494,0,29,14,15,"0,29"
12104,720575940626245016,right,T4a,495,4,5,-2,7,"4,5"
12105,720575940619375900,right,T4a,496,7,8,-3,11,"7,8"
12106,720575940630735447,right,T4a,497,6,1,-6,7,"6,1"
12107,720575940611969778,right,T4a,498,6,10,-1,11,"6,10"
12108,720575940609425347,right,T4a,499,5,10,0,10,"5,10"
12109,720575940621750255,right,T4a,500,7,-8,-11,3,"7,-8"
12110,720575940607814665,right,T4a,501,1,2,0,2,"1,2"
12111,720575940621529536,right,T4a,502,5,8,-1,9,"5,8"
12112,720575940621963433,right,T4a,503,3,17,5,12,"3,17"
12113,720575940624321865,right,T4a,504,-2,9,6,3,"-2,9"
12114,720575940612039154,right,T4a,506,1,-12,-7,-5,"1,-12"
12115,720575940627385877,right,T4a,507,-5,-12,-1,-11,"-5,-12"
12116,720575940628552556,right,T4a,508,-5,11,10,1,"-5,11"
12117,720575940642820388,right,T4a,509,-4,10,9,1,"-4,10"
12118,720575940626489644,right,T4a,510,-2,11,7,4,"-2,11"
12119,720575940623627411,right,T4a,511,5,-11,-11,0,"5,-11"
12120,720575940635781684,right,T4a,512,6,0,-6,6,"6,0"
12121,720575940636955199,right,T4a,514,-4,-10,-1,-9,"-4,-10"
12122,720575940625114109,right,T4a,516,7,-18,-16,-2,"7,-18"
12123,720575940635806772,right,T4a,517,6,3,-5,8,"6,3"
12124,720575940629794295,right,T4a,518,-4,22,15,7,"-4,22"
12125,720575940627541480,right,T4a,519,-5,-5,2,-7,"-5,-5"
12126,720575940615985164,right,T4a,520,-2,-22,-9,-13,"-2,-22"
12127,720575940624193255,right,T4a,521,6,-9,-11,2,"6,-9"
12128,720575940635998362,right,T4a,522,-4,0,4,-4,"-4,0"
12129,720575940660772993,right,T4a,523,2,14,5,9,"2,14"
12130,720575940629784108,right,T4a,524,4,-20,-14,-6,"4,-20"
12131,720575940608511068,right,T4a,525,-1,-20,-9,-11,"-1,-20"
12132,720575940630230376,right,T4a,526,0,-10,-5,-5,"0,-10"
12133,720575940625371280,right,T4a,527,-4,-8,0,-8,"-4,-8"
12134,720575940621678785,right,T4a,528,2,7,1,6,"2,7"
12135,720575940635282332,right,T4a,529,2,-2,-3,1,"2,-2"
12136,720575940626967311,right,T4a,530,-3,-13,-4,-9,"-3,-13"
12137,720575940628777463,right,T4a,531,1,0,-1,1,"1,0"
12138,720575940605852192,right,T4a,532,-8,7,11,-4,"-8,7"
12139,720575940617847454,right,T4a,533,0,-16,-8,-8,"0,-16"
12140,720575940641657396,right,T4a,534,3,2,-2,4,"3,2"
12141,720575940637514974,right,T4a,535,8,-4,-10,6,"8,-4"
12142,720575940620685039,right,T4a,536,3,4,-1,5,"3,4"
12143,720575940622106409,right,T4a,537,0,-23,-12,-11,"0,-23"
12144,720575940640090752,right,T4a,538,-4,1,4,-3,"-4,1"
12145,720575940622969853,right,T4a,539,-6,15,13,2,"-6,15"
12146,720575940611187298,right,T4a,540,-2,-9,-3,-6,"-2,-9"
12147,720575940620277942,right,T4a,541,-4,14,11,3,"-4,14"
12148,720575940645617262,right,T4a,542,6,-13,-13,0,"6,-13"
12149,720575940635928176,right,T4a,543,-1,-4,-1,-3,"-1,-4"
12150,720575940616951947,right,T4a,544,3,-13,-10,-3,"3,-13"
12151,720575940612230553,right,T4a,545,5,11,0,11,"5,11"
12152,720575940617018183,right,T4a,546,3,6,0,6,"3,6"
12153,720575940624749749,right,T4a,547,-1,21,11,10,"-1,21"
12154,720575940623384968,right,T4a,548,1,-16,-9,-7,"1,-16"
12155,720575940605803744,right,T4a,549,0,-9,-5,-4,"0,-9"
12156,720575940613118760,right,T4a,550,-2,3,3,0,"-2,3"
12157,720575940630368732,right,T4a,551,-4,-9,-1,-8,"-4,-9"
12158,720575940638662708,right,T4a,552,4,-1,-5,4,"4,-1"
12159,720575940619812717,right,T4a,553,-3,16,11,5,"-3,16"
12160,720575940638196157,right,T4a,555,-4,9,8,1,"-4,9"
12161,720575940620220598,right,T4a,556,0,10,5,5,"0,10"
12162,720575940620575067,right,T4a,557,6,-10,-11,1,"6,-10"
12163,720575940622106657,right,T4a,558,-4,-21,-7,-14,"-4,-21"
12164,720575940621625953,right,T4a,560,-7,14,14,0,"-7,14"
12165,720575940632008007,right,T4a,561,5,7,-2,9,"5,7"
12166,720575940629929925,right,T4a,562,-5,-2,4,-6,"-5,-2"
12167,720575940633879853,right,T4a,563,5,-13,-12,-1,"5,-13"
12168,720575940628774782,right,T4a,564,3,-23,-15,-8,"3,-23"
12169,720575940626482840,right,T4a,565,0,-26,-13,-13,"0,-26"
12170,720575940632744621,right,T4a,566,5,-8,-9,1,"5,-8"
12171,720575940629524730,right,T4a,567,-2,22,13,9,"-2,22"
12172,720575940625347661,right,T4a,568,-6,-8,2,-10,"-6,-8"
12173,720575940627214504,right,T4a,569,6,6,-3,9,"6,6"
12174,720575940619233585,right,T4a,570,2,25,10,15,"2,25"
12175,720575940639500963,right,T4a,571,0,-14,-7,-7,"0,-14"
12176,720575940606821250,right,T4a,573,4,14,3,11,"4,14"
12177,720575940629875906,right,T4a,574,-6,5,8,-3,"-6,5"
12178,720575940635931755,right,T4a,575,6,9,-2,11,"6,9"
12179,720575940633672078,right,T4a,576,0,28,14,14,"0,28"
12180,720575940616454210,right,T4a,577,5,-14,-12,-2,"5,-14"
12181,720575940605939814,right,T4a,578,4,-11,-10,-1,"4,-11"
12182,720575940613994671,right,T4a,579,-3,-10,-2,-8,"-3,-10"
12183,720575940633786975,right,T4a,580,-2,-23,-10,-13,"-2,-23"
12184,720575940638646874,right,T4a,581,3,9,1,8,"3,9"
12185,720575940617212987,right,T4a,582,-1,23,12,11,"-1,23"
12186,720575940627286153,right,T4a,583,3,-25,-16,-9,"3,-25"
12187,720575940647830404,right,T4a,584,4,23,7,16,"4,23"
12188,720575940619453318,right,T4a,585,-1,-23,-11,-12,"-1,-23"
12189,720575940620572781,right,T4a,586,2,18,7,11,"2,18"
12190,720575940614709446,right,T4a,588,1,4,1,3,"1,4"
12191,720575940618774848,right,T4a,589,-1,-5,-2,-3,"-1,-5"
12192,720575940610862638,right,T4a,590,1,9,3,6,"1,9"
12193,720575940627922180,right,T4a,591,3,-3,-5,2,"3,-3"
12194,720575940628189833,right,T4a,592,3,-28,-17,-11,"3,-28"
12195,720575940626666877,right,T4a,593,3,-14,-10,-4,"3,-14"
12196,720575940626452880,right,T4a,594,7,-16,-15,-1,"7,-16"
12197,720575940636515429,right,T4a,595,7,-12,-13,1,"7,-12"
12198,720575940623801272,right,T4a,597,4,1,-4,5,"4,1"
12199,720575940627170437,right,T4a,598,2,-18,-11,-7,"2,-18"
12200,720575940623692775,right,T4a,599,-1,9,5,4,"-1,9"
12201,720575940627326825,right,T4a,600,3,-10,-8,-2,"3,-10"
12202,720575940637379550,right,T4a,601,1,16,7,9,"1,16"
12203,720575940605793726,right,T4a,602,4,-2,-5,3,"4,-2"
12204,720575940617825629,right,T4a,603,-3,-23,-9,-14,"-3,-23"
12205,720575940632417363,right,T4a,604,-6,-17,-3,-14,"-6,-17"
12206,720575940629170519,right,T4a,605,3,15,4,11,"3,15"
12207,720575940613669784,right,T4a,606,-1,-19,-9,-10,"-1,-19"
12208,720575940623188420,right,T4a,607,1,18,8,10,"1,18"
12209,720575940626444741,right,T4a,608,1,10,4,6,"1,10"
12210,720575940628426366,right,T4a,609,-2,0,2,-2,"-2,0"
12211,720575940631620089,right,T4a,610,2,-23,-14,-9,"2,-23"
12212,720575940627534613,right,T4a,611,-1,-18,-8,-10,"-1,-18"
12213,720575940611108194,right,T4a,612,-3,-26,-10,-16,"-3,-26"
12214,720575940619196143,right,T4a,613,-8,-4,6,-10,"-8,-4"
12215,720575940618214685,right,T4a,614,-2,-8,-2,-6,"-2,-8"
12216,720575940660454017,right,T4a,615,-7,-7,3,-10,"-7,-7"
12217,720575940628169371,right,T4a,616,-3,15,10,5,"-3,15"
12218,720575940654955937,right,T4a,617,-2,-17,-7,-10,"-2,-17"
12219,720575940617391249,right,T4a,618,-1,24,13,11,"-1,24"
12220,720575940643136456,right,T4a,619,-4,-19,-6,-13,"-4,-19"
12221,720575940639503448,right,T4a,620,7,1,-7,8,"7,1"
12222,720575940620335437,right,T4a,621,1,24,11,13,"1,24"
12223,720575940622227068,right,T4a,622,-5,20,15,5,"-5,20"
12224,720575940626427589,right,T4a,623,1,13,5,8,"1,13"
12225,720575940618059604,right,T4a,624,1,-17,-10,-7,"1,-17"
12226,720575940614119218,right,T4a,625,-2,24,14,10,"-2,24"
12227,720575940637668574,right,T4a,626,-5,-8,1,-9,"-5,-8"
12228,720575940632879841,right,T4a,627,0,-1,-1,0,"0,-1"
12229,720575940620584319,right,T4a,628,0,0,0,0,"0,0"
12230,720575940617390910,right,T4a,629,4,24,8,16,"4,24"
12231,720575940619197854,right,T4a,630,4,8,0,8,"4,8"
12232,720575940613037037,right,T4a,631,1,26,12,14,"1,26"
12233,720575940640779984,right,T4a,634,-3,-15,-5,-10,"-3,-15"
12234,720575940621038677,right,T4a,635,6,-6,-9,3,"6,-6"
12235,720575940609942136,right,T4a,636,0,6,3,3,"0,6"
12236,720575940621871469,right,T4a,637,3,-21,-14,-7,"3,-21"
12237,720575940618038651,right,T4a,638,-1,7,4,3,"-1,7"
12238,720575940660868481,right,T4a,639,-4,19,13,6,"-4,19"
12239,720575940632297901,right,T4a,640,-1,-16,-7,-9,"-1,-16"
12240,720575940613378541,right,T4a,641,-8,-5,5,-10,"-8,-5"
12241,720575940629088508,right,T4a,642,-5,-11,-1,-10,"-5,-11"
12242,720575940615541654,right,T4a,643,6,14,1,13,"6,14"
12243,720575940621238767,right,T4a,644,-6,18,15,3,"-6,18"
12244,720575940614300211,right,T4a,645,-4,27,17,10,"-4,27"
12245,720575940625584933,right,T4a,646,6,17,2,15,"6,17"
12246,720575940617376985,right,T4a,648,1,7,2,5,"1,7"
12247,720575940618700248,right,T4a,649,-1,5,3,2,"-1,5"
12248,720575940620977788,right,T4a,650,-3,-25,-10,-15,"-3,-25"
12249,720575940604383776,right,T4a,651,-4,-5,1,-6,"-4,-5"
12250,720575940617345753,right,T4a,652,-6,-11,0,-11,"-6,-11"
12251,720575940611509966,right,T4a,653,-6,-12,0,-12,"-6,-12"
12252,720575940622286625,right,T4a,654,-3,8,7,1,"-3,8"
12253,720575940614169086,right,T4a,655,6,-1,-7,6,"6,-1"
12254,720575940649880441,right,T4a,656,0,-11,-6,-5,"0,-11"
12255,720575940631879225,right,T4a,657,-2,-25,-11,-14,"-2,-25"
12256,720575940615512898,right,T4a,658,1,20,9,11,"1,20"
12257,720575940622780543,right,T4a,659,-4,-6,1,-7,"-4,-6"
12258,720575940618181606,right,T4a,660,2,28,12,16,"2,28"
12259,720575940614743190,right,T4a,661,-3,14,10,4,"-3,14"
12260,720575940600143369,right,T4a,662,2,-1,-3,2,"2,-1"
12261,720575940604474982,right,T4a,663,0,8,4,4,"0,8"
12262,720575940626647464,right,T4a,664,1,-27,-15,-12,"1,-27"
12263,720575940626947271,right,T4a,665,7,-2,-8,6,"7,-2"
12264,720575940616579841,right,T4a,666,7,-13,-14,1,"7,-13"
12265,720575940612685864,right,T4a,667,1,-28,-15,-13,"1,-28"
12266,720575940604640945,right,T4a,668,1,19,8,11,"1,19"
12267,720575940616997062,right,T4a,669,4,-16,-12,-4,"4,-16"
12268,720575940623982216,right,T4a,670,5,5,-3,8,"5,5"
12269,720575940616695835,right,T4a,673,2,5,0,5,"2,5"
12270,720575940639036494,right,T4a,674,-4,-14,-3,-11,"-4,-14"
12271,720575940620981108,right,T4a,676,-3,-21,-8,-13,"-3,-21"
12272,720575940631624248,right,T4a,677,0,11,5,6,"0,11"
12273,720575940627873448,right,T4a,678,3,-7,-7,0,"3,-7"
12274,720575940620326929,right,T4a,679,4,18,5,13,"4,18"
12275,720575940618375197,right,T4a,680,-1,25,13,12,"-1,25"
12276,720575940618936733,right,T4a,681,-2,-21,-9,-12,"-2,-21"
12277,720575940603526005,right,T4a,682,6,-8,-10,2,"6,-8"
12278,720575940635637428,right,T4a,683,2,6,1,5,"2,6"
12279,720575940624513255,right,T4a,684,-6,17,14,3,"-6,17"
12280,720575940630825338,right,T4a,685,-5,-9,0,-9,"-5,-9"
12281,720575940617306841,right,T4a,686,5,-22,-16,-6,"5,-22"
12282,720575940624679719,right,T4a,687,-6,-3,4,-7,"-6,-3"
12283,720575940613534870,right,T4a,688,-7,10,12,-2,"-7,10"
12284,720575940608924740,right,T4a,689,-2,18,11,7,"-2,18"
12285,720575940613526422,right,T4a,692,-4,24,16,8,"-4,24"
12286,720575940617874781,right,T4a,693,-3,25,15,10,"-3,25"
12287,720575940621780001,right,T4a,694,4,3,-3,6,"4,3"
12288,720575940621757832,right,T4a,695,-6,10,11,-1,"-6,10"
12289,720575940633170076,right,T4a,696,-2,16,10,6,"-2,16"
12290,720575940624708169,right,T4a,697,1,-22,-12,-10,"1,-22"
12291,720575940632803411,right,T4a,698,6,-7,-10,3,"6,-7"
12292,720575940619837387,right,T4a,699,-5,0,5,-5,"-5,0"
12293,720575940622950161,right,T4a,700,5,15,2,13,"5,15"
12294,720575940629413194,right,T4a,701,0,-4,-2,-2,"0,-4"
12295,720575940635718751,right,T4a,702,-5,23,16,7,"-5,23"
12296,720575940623066392,right,T4a,703,-3,1,3,-2,"-3,1"
12297,720575940628637519,right,T4a,704,-7,8,11,-3,"-7,8"
12298,720575940618373962,right,T4a,705,1,1,-1,2,"1,1"
12299,720575940617718758,right,T4a,707,-2,25,14,11,"-2,25"
12300,720575940621353392,right,T4a,708,-4,-25,-9,-16,"-4,-25"
12301,720575940627346186,right,T4a,709,-2,-24,-10,-14,"-2,-24"
12302,720575940618802000,right,T4a,710,4,-25,-17,-8,"4,-25"
12303,720575940616518612,right,T4a,711,-1,19,10,9,"-1,19"
12304,720575940629120732,right,T4a,712,-7,12,13,-1,"-7,12"
12305,720575940606539465,right,T4a,713,-6,16,14,2,"-6,16"
12306,720575940633963181,right,T4a,714,5,12,1,11,"5,12"
12307,720575940622478972,right,T4a,715,4,10,1,9,"4,10"
12308,720575940625113597,right,T4a,716,4,-6,-7,1,"4,-6"
12309,720575940637959770,right,T4a,717,2,-22,-13,-9,"2,-22"
12310,720575940619793997,right,T4a,718,-5,24,17,7,"-5,24"
12311,720575940632799059,right,T4a,719,1,27,12,15,"1,27"
12312,720575940627505277,right,T4a,720,-5,21,15,6,"-5,21"
12313,720575940622191830,right,T4a,721,5,13,1,12,"5,13"
12314,720575940612900466,right,T4a,722,6,-15,-14,-1,"6,-15"
12315,720575940631767436,right,T4a,723,-2,-11,-4,-7,"-2,-11"
12316,720575940640757200,right,T4a,724,4,2,-3,5,"4,2"
12317,720575940616577653,right,T4a,725,-3,-24,-9,-15,"-3,-24"
12318,720575940627772037,right,T4a,726,2,-28,-16,-12,"2,-28"
12319,720575940600547529,right,T4a,727,7,6,-4,10,"7,6"
12320,720575940625678862,right,T4a,728,7,12,-1,13,"7,12"
12321,720575940624002604,right,T4a,729,-3,29,17,12,"-3,29"
12322,720575940613619090,right,T4a,730,7,0,-7,7,"7,0"
12323,720575940626723870,right,T4a,731,-6,9,10,-1,"-6,9"
12324,720575940614835131,right,T4a,732,-3,6,6,0,"-3,6"
12325,720575940639197247,right,T4a,733,-5,-17,-4,-13,"-5,-17"
12326,720575940629338011,right,T4a,734,2,0,-2,2,"2,0"
12327,720575940635149151,right,T4a,735,1,-23,-13,-10,"1,-23"
12328,720575940624009827,right,T4a,736,-8,1,8,-7,"-8,1"
12329,720575940612741799,right,T4a,737,0,19,9,10,"0,19"
12330,720575940613711254,right,T4a,738,-3,13,9,4,"-3,13"
12331,720575940625407690,right,T4a,739,-7,2,8,-6,"-7,2"
12332,720575940612437966,right,T4a,740,2,-8,-6,-2,"2,-8"
12333,720575940630280508,right,T4a,741,-2,-14,-5,-9,"-2,-14"
12334,720575940638474584,right,T4a,742,-4,11,9,2,"-4,11"
12335,720575940617220281,right,T4a,743,6,-19,-16,-3,"6,-19"
12336,720575940628026641,right,T4a,744,-4,25,16,9,"-4,25"
12337,720575940626446869,right,T4a,745,0,13,6,7,"0,13"
12338,720575940637784127,right,T4a,746,-3,3,4,-1,"-3,3"
12339,720575940633618272,right,T4a,747,0,2,1,1,"0,2"
12340,720575940614722198,right,T4a,748,-4,20,14,6,"-4,20"
12341,720575940616130955,right,T4a,749,-2,1,2,-1,"-2,1"
12342,720575940611991219,right,T4a,750,4,-24,-16,-8,"4,-24"
12343,720575940614547879,right,T4a,751,1,6,2,4,"1,6"
12344,720575940608781579,right,T4a,752,-2,7,5,2,"-2,7"
12345,720575940619146910,right,T4a,753,-3,24,15,9,"-3,24"
12346,720575940621150561,right,T4a,754,-1,-13,-6,-7,"-1,-13"
12347,720575940628632080,right,T4a,755,4,19,5,14,"4,19"
12348,720575940631508803,right,T4a,756,5,20,5,15,"5,20"
12349,720575940637689434,right,T4a,757,0,-6,-3,-3,"0,-6"
12350,720575940608288523,right,T4a,758,5,-1,-6,5,"5,-1"
12351,720575940630457335,right,T4a,759,7,14,0,14,"7,14"
12352,720575940607197826,right,T4a,760,0,17,8,9,"0,17"
12353,720575940621810902,right,T4a,761,-4,-18,-5,-13,"-4,-18"
12354,720575940613693677,right,T4a,762,0,14,7,7,"0,14"
12355,720575940627266054,right,T4a,763,-5,14,12,2,"-5,14"
12356,720575940635100572,right,T4a,765,-3,9,7,2,"-3,9"
12357,720575940628033042,right,T4a,766,2,-4,-4,0,"2,-4"
12358,720575940614276271,right,T4a,767,1,28,13,15,"1,28"
12359,720575940622994982,right,T4a,768,3,5,-1,6,"3,5"
12360,720575940615720350,right,T4a,770,5,4,-3,7,"5,4"
12361,720575940628027665,right,T4a,772,1,12,5,7,"1,12"
12362,720575940633520927,right,T4a,773,5,-19,-15,-4,"5,-19"
12363,720575940616440251,right,T4a,775,5,22,6,16,"5,22"
12364,720575940630086138,right,T4a,776,5,21,5,16,"5,21"
12365,720575940615088894,right,T4a,778,4,25,8,17,"4,25"
12366,720575940628675846,right,T4a,779,5,24,7,17,"5,24"
12367,720575940623897129,right,T4a,780,-6,25,18,7,"-6,25"
12368,720575940638586787,right,T4a,782,-5,27,18,9,"-5,27"
12369,720575940610367556,right,T4a,783,-4,28,18,10,"-4,28"
12370,720575940630147781,right,T4a,785,-3,30,18,12,"-3,30"
12371,720575940611084566,right,T4a,786,-2,30,17,13,"-2,30"
12372,720575940627645973,right,T4a,787,3,28,11,17,"3,28"
12373,720575940633268525,right,T4a,788,3,27,10,17,"3,27"
12374,720575940619007867,right,T4a,790,-2,-27,-12,-15,"-2,-27"
12375,720575940644935447,right,T4a,791,-1,-28,-13,-15,"-1,-28"
12376,720575940621527841,right,T4a,792,8,2,-7,9,"8,2"
12377,720575940640155789,right,T4a,793,8,-6,-11,5,"8,-6"
12378,720575940630800762,right,T4a,794,5,-26,-18,-8,"5,-26"
12379,720575940636315022,right,T4a,796,4,26,9,17,"4,26"
12380,720575940634086295,right,T4b,1,-6,13,12,1,"-6,13"
12381,720575940630507116,right,T4b,2,-8,2,9,-7,"-8,2"
12382,720575940627958471,right,T4b,3,6,-12,-12,0,"6,-12"
12383,720575940632903085,right,T4b,5,-1,16,9,7,"-1,16"
12384,720575940629503319,right,T4b,6,-2,-4,0,-4,"-2,-4"
12385,720575940629782469,right,T4b,7,-6,-6,3,-9,"-6,-6"
12386,720575940645145891,right,T4b,8,-4,26,17,9,"-4,26"
12387,720575940617034077,right,T4b,9,4,9,0,9,"4,9"
12388,720575940609008853,right,T4b,10,5,-15,-13,-2,"5,-15"
12389,720575940612235586,right,T4b,11,7,-14,-14,0,"7,-14"
12390,720575940621824282,right,T4b,12,-7,9,11,-2,"-7,9"
12391,720575940635223397,right,T4b,13,-1,-26,-12,-14,"-1,-26"
12392,720575940622268748,right,T4b,14,0,-27,-14,-13,"0,-27"
12393,720575940631725452,right,T4b,15,2,-3,-4,1,"2,-3"
12394,720575940624742548,right,T4b,16,-2,-16,-6,-10,"-2,-16"
12395,720575940638725773,right,T4b,17,1,-5,-4,-1,"1,-5"
12396,720575940612271786,right,T4b,18,5,-16,-13,-3,"5,-16"
12397,720575940630437228,right,T4b,19,-7,17,15,2,"-7,17"
12398,720575940622591220,right,T4b,20,3,-11,-9,-2,"3,-11"
12399,720575940632483532,right,T4b,21,-2,19,11,8,"-2,19"
12400,720575940605453001,right,T4b,22,-1,3,2,1,"-1,3"
12401,720575940631241002,right,T4b,23,-3,-16,-5,-11,"-3,-16"
12402,720575940635240333,right,T4b,24,-1,-10,-4,-6,"-1,-10"
12403,720575940613036525,right,T4b,25,-9,3,10,-7,"-9,3"
12404,720575940620416586,right,T4b,26,1,-3,-3,0,"1,-3"
12405,720575940628640774,right,T4b,27,0,-25,-13,-12,"0,-25"
12406,720575940639494232,right,T4b,28,5,6,-2,8,"5,6"
12407,720575940612125170,right,T4b,29,-1,-3,-1,-2,"-1,-3"
12408,720575940626767618,right,T4b,30,6,16,2,14,"6,16"
12409,720575940622111058,right,T4b,31,0,16,8,8,"0,16"
12410,720575940626461186,right,T4b,32,0,12,6,6,"0,12"
12411,720575940611860698,right,T4b,33,3,18,6,12,"3,18"
12412,720575940621354991,right,T4b,34,6,18,3,15,"6,18"
12413,720575940624788798,right,T4b,35,1,-24,-13,-11,"1,-24"
12414,720575940629660919,right,T4b,36,6,8,-2,10,"6,8"
12415,720575940630949647,right,T4b,37,1,5,1,4,"1,5"
12416,720575940623202634,right,T4b,38,0,-2,-1,-1,"0,-2"
12417,720575940642699976,right,T4b,39,0,20,10,10,"0,20"
12418,720575940621488566,right,T4b,40,-2,-6,-1,-5,"-2,-6"
12419,720575940623987244,right,T4b,41,-3,28,17,11,"-3,28"
12420,720575940632858707,right,T4b,42,-1,14,8,6,"-1,14"
12421,720575940632675117,right,T4b,43,-5,18,14,4,"-5,18"
12422,720575940605135532,right,T4b,44,5,-10,-10,0,"5,-10"
12423,720575940619087307,right,T4b,45,-5,-1,4,-5,"-5,-1"
12424,720575940634027932,right,T4b,46,-5,15,12,3,"-5,15"
12425,720575940631112668,right,T4b,47,-9,-1,8,-9,"-9,-1"
12426,720575940610623089,right,T4b,48,-4,-22,-7,-15,"-4,-22"
12427,720575940615103830,right,T4b,49,4,-4,-6,2,"4,-4"
12428,720575940624939865,right,T4b,50,-2,21,12,9,"-2,21"
12429,720575940622497476,right,T4b,51,0,-19,-10,-9,"0,-19"
12430,720575940612696728,right,T4b,52,-1,-22,-10,-12,"-1,-22"
12431,720575940626782151,right,T4b,53,5,14,2,12,"5,14"
12432,720575940633641919,right,T4b,54,-4,3,5,-2,"-4,3"
12433,720575940626881673,right,T4b,55,-4,-11,-2,-9,"-4,-11"
12434,720575940607987395,right,T4b,56,1,-13,-8,-5,"1,-13"
12435,720575940631861048,right,T4b,57,6,-11,-12,1,"6,-11"
12436,720575940624380652,right,T4b,58,3,12,3,9,"3,12"
12437,720575940622420189,right,T4b,60,-8,8,12,-4,"-8,8"
12438,720575940629856556,right,T4b,61,-4,-4,2,-6,"-4,-4"
12439,720575940623936253,right,T4b,63,4,12,2,10,"4,12"
12440,720575940612718322,right,T4b,64,4,-23,-16,-7,"4,-23"
12441,720575940637242286,right,T4b,65,-1,28,15,13,"-1,28"
12442,720575940620410304,right,T4b,66,2,15,5,10,"2,15"
12443,720575940617161531,right,T4b,67,-2,-13,-5,-8,"-2,-13"
12444,720575940628169115,right,T4b,68,3,16,5,11,"3,16"
12445,720575940626512581,right,T4b,69,1,8,3,5,"1,8"
12446,720575940621791237,right,T4b,70,-4,21,14,7,"-4,21"
12447,720575940620354726,right,T4b,71,-2,-3,0,-3,"-2,-3"
12448,720575940628019985,right,T4b,72,0,-28,-14,-14,"0,-28"
12449,720575940640032088,right,T4b,73,2,2,-1,3,"2,2"
12450,720575940637557645,right,T4b,74,-1,-9,-4,-5,"-1,-9"
12451,720575940652193014,right,T4b,75,-6,14,13,1,"-6,14"
12452,720575940610396718,right,T4b,76,-3,-4,1,-5,"-3,-4"
12453,720575940624379792,right,T4b,77,2,-5,-5,0,"2,-5"
12454,720575940622855935,right,T4b,79,2,1,-2,3,"2,1"
12455,720575940604818092,right,T4b,80,4,13,2,11,"4,13"
12456,720575940634753983,right,T4b,81,6,-2,-7,5,"6,-2"
12457,720575940605398048,right,T4b,82,-7,7,10,-3,"-7,7"
12458,720575940611842936,right,T4b,83,2,-21,-13,-8,"2,-21"
12459,720575940636574174,right,T4b,84,-2,12,8,4,"-2,12"
12460,720575940637841805,right,T4b,85,4,-22,-15,-7,"4,-22"
12461,720575940644741412,right,T4b,86,-5,-7,1,-8,"-5,-7"
12462,720575940632672851,right,T4b,87,1,11,4,7,"1,11"
12463,720575940615598267,right,T4b,88,7,4,-5,9,"7,4"
12464,720575940648454009,right,T4b,89,1,-19,-11,-8,"1,-19"
12465,720575940631378986,right,T4b,90,-4,5,6,-1,"-4,5"
12466,720575940625958444,right,T4b,91,-1,6,4,2,"-1,6"
12467,720575940626511557,right,T4b,92,0,9,4,5,"0,9"
12468,720575940650521209,right,T4b,93,-6,3,7,-4,"-6,3"
12469,720575940619701077,right,T4b,94,5,18,4,14,"5,18"
12470,720575940620714479,right,T4b,95,4,-21,-15,-6,"4,-21"
12471,720575940621749492,right,T4b,96,1,-10,-6,-4,"1,-10"
12472,720575940610637688,right,T4b,97,-5,2,6,-4,"-5,2"
12473,720575940608352690,right,T4b,98,-1,-12,-5,-7,"-1,-12"
12474,720575940619336753,right,T4b,99,4,15,3,12,"4,15"
12475,720575940629075279,right,T4b,100,2,-10,-7,-3,"2,-10"
12476,720575940619925696,right,T4b,101,-7,6,10,-4,"-7,6"
12477,720575940624412820,right,T4b,102,3,13,3,10,"3,13"
12478,720575940622555094,right,T4b,104,-1,-27,-13,-14,"-1,-27"
12479,720575940619717257,right,T4b,105,3,22,8,14,"3,22"
12480,720575940637863401,right,T4b,106,-7,11,12,-1,"-7,11"
12481,720575940626510232,right,T4b,108,-3,-12,-3,-9,"-3,-12"
12482,720575940638864256,right,T4b,109,4,-5,-7,2,"4,-5"
12483,720575940628651014,right,T4b,110,-7,0,7,-7,"-7,0"
12484,720575940621250403,right,T4b,111,2,-24,-14,-10,"2,-24"
12485,720575940617174758,right,T4b,112,-6,1,6,-5,"-6,1"
12486,720575940642858804,right,T4b,113,-2,4,4,0,"-2,4"
12487,720575940620553921,right,T4b,114,2,-13,-9,-4,"2,-13"
12488,720575940625974572,right,T4b,115,-4,2,5,-3,"-4,2"
12489,720575940617845277,right,T4b,116,-1,-8,-3,-5,"-1,-8"
12490,720575940614952607,right,T4b,117,-8,-2,7,-9,"-8,-2"
12491,720575940631101999,right,T4b,118,3,1,-3,4,"3,1"
12492,720575940626315397,right,T4b,119,-2,6,5,1,"-2,6"
12493,720575940637989978,right,T4b,120,-1,-1,0,-1,"-1,-1"
12494,720575940614686662,right,T4b,121,-8,4,10,-6,"-8,4"
12495,720575940615228482,right,T4b,122,-5,9,9,0,"-5,9"
12496,720575940623812622,right,T4b,124,1,-7,-5,-2,"1,-7"
12497,720575940631729548,right,T4b,125,5,9,-1,10,"5,9"
12498,720575940621843382,right,T4b,126,3,11,2,9,"3,11"
12499,720575940622372301,right,T4b,127,0,15,7,8,"0,15"
12500,720575940619442159,right,T4b,128,3,-22,-14,-8,"3,-22"
12501,720575940639768448,right,T4b,129,0,-13,-7,-6,"0,-13"
12502,720575940627266822,right,T4b,130,2,12,4,8,"2,12"
12503,720575940624567271,right,T4b,131,-6,20,16,4,"-6,20"
12504,720575940617005383,right,T4b,132,2,4,0,4,"2,4"
12505,720575940625997258,right,T4b,133,-3,20,13,7,"-3,20"
12506,720575940630905807,right,T4b,134,-5,-18,-4,-14,"-5,-18"
12507,720575940631567687,right,T4b,135,-3,-22,-8,-14,"-3,-22"
12508,720575940623417525,right,T4b,136,0,3,1,2,"0,3"
12509,720575940617957149,right,T4b,137,5,-7,-9,2,"5,-7"
12510,720575940627150985,right,T4b,138,0,27,13,14,"0,27"
12511,720575940633408869,right,T4b,139,1,-14,-8,-6,"1,-14"
12512,720575940615239285,right,T4b,140,3,8,1,7,"3,8"
12513,720575940613898365,right,T4b,142,-2,-18,-7,-11,"-2,-18"
12514,720575940640595152,right,T4b,143,-4,16,12,4,"-4,16"
12515,720575940617665885,right,T4b,144,7,-11,-13,2,"7,-11"
12516,720575940615685278,right,T4b,145,0,4,2,2,"0,4"
12517,720575940616110523,right,T4b,146,1,-6,-4,-2,"1,-6"
12518,720575940620793406,right,T4b,147,1,21,9,12,"1,21"
12519,720575940630334459,right,T4b,148,-7,-11,1,-12,"-7,-11"
12520,720575940635503758,right,T4b,149,6,-14,-13,-1,"6,-14"
12521,720575940624051348,right,T4b,150,-8,5,10,-5,"-8,5"
12522,720575940614931862,right,T4b,151,-3,-14,-4,-10,"-3,-14"
12523,720575940629970647,right,T4b,152,3,-15,-11,-4,"3,-15"
12524,720575940628358068,right,T4b,153,8,0,-8,8,"8,0"
12525,720575940621289221,right,T4b,154,-8,0,8,-8,"-8,0"
12526,720575940620059813,right,T4b,155,-8,13,14,-1,"-8,13"
12527,720575940608049419,right,T4b,156,-9,1,9,-8,"-9,1"
12528,720575940633925739,right,T4b,157,-1,-7,-3,-4,"-1,-7"
12529,720575940629908418,right,T4b,158,3,-5,-6,1,"3,-5"
12530,720575940617786113,right,T4b,160,-2,20,12,8,"-2,20"
12531,720575940641037696,right,T4b,161,4,-14,-11,-3,"4,-14"
12532,720575940609293660,right,T4b,162,-4,-2,3,-5,"-4,-2"
12533,720575940616575062,right,T4b,163,-9,7,12,-5,"-9,7"
12534,720575940622298637,right,T4b,164,-1,-2,0,-2,"-1,-2"
12535,720575940615263967,right,T4b,165,4,16,4,12,"4,16"
12536,720575940622110546,right,T4b,166,0,18,9,9,"0,18"
12537,720575940627642645,right,T4b,167,0,-17,-9,-8,"0,-17"
12538,720575940638009919,right,T4b,168,-1,17,9,8,"-1,17"
12539,720575940631284439,right,T4b,169,0,-18,-9,-9,"0,-18"
12540,720575940634935403,right,T4b,170,-5,1,5,-4,"-5,1"
12541,720575940625883454,right,T4b,171,6,-20,-16,-4,"6,-20"
12542,720575940628077511,right,T4b,172,1,22,10,12,"1,22"
12543,720575940624332012,right,T4b,174,4,-15,-12,-3,"4,-15"
12544,720575940617636057,right,T4b,175,-6,-7,2,-9,"-6,-7"
12545,720575940624411796,right,T4b,176,-2,13,8,5,"-2,13"
12546,720575940622739690,right,T4b,177,-2,-1,1,-2,"-2,-1"
12547,720575940614281122,right,T4b,178,2,11,3,8,"2,11"
12548,720575940618445241,right,T4b,179,-5,-16,-3,-13,"-5,-16"
12549,720575940628030738,right,T4b,181,1,-4,-3,-1,"1,-4"
12550,720575940628861435,right,T4b,182,7,-10,-12,2,"7,-10"
12551,720575940625233552,right,T4b,183,-5,-15,-3,-12,"-5,-15"
12552,720575940613471205,right,T4b,184,-6,-5,3,-8,"-6,-5"
12553,720575940636088462,right,T4b,185,2,-11,-8,-3,"2,-11"
12554,720575940623728522,right,T4b,186,-1,26,14,12,"-1,26"
12555,720575940618882427,right,T4b,187,3,21,7,14,"3,21"
12556,720575940625989907,right,T4b,188,-5,17,13,4,"-5,17"
12557,720575940609804245,right,T4b,189,6,13,0,13,"6,13"
12558,720575940640113792,right,T4b,190,-3,-5,0,-5,"-3,-5"
12559,720575940616493115,right,T4b,191,-1,-11,-5,-6,"-1,-11"
12560,720575940610907654,right,T4b,192,7,10,-2,12,"7,10"
12561,720575940630400374,right,T4b,193,-5,4,7,-3,"-5,4"
12562,720575940627731112,right,T4b,194,0,-5,-3,-2,"0,-5"
12563,720575940640721141,right,T4b,195,-3,-1,2,-3,"-3,-1"
12564,720575940605977265,right,T4b,196,-1,8,5,3,"-1,8"
12565,720575940631268252,right,T4b,197,0,-20,-10,-10,"0,-20"
12566,720575940637612260,right,T4b,198,6,2,-5,7,"6,2"
12567,720575940639501475,right,T4b,199,0,-12,-6,-6,"0,-12"
12568,720575940618531585,right,T4b,200,-5,12,11,1,"-5,12"
12569,720575940633429726,right,T4b,202,-1,27,14,13,"-1,27"
12570,720575940629762426,right,T4b,203,3,-1,-4,3,"3,-1"
12571,720575940615171467,right,T4b,204,5,-2,-6,4,"5,-2"
12572,720575940638566744,right,T4b,205,5,-6,-8,2,"5,-6"
12573,720575940652355574,right,T4b,206,-3,5,5,0,"-3,5"
12574,720575940619724937,right,T4b,207,1,29,13,16,"1,29"
12575,720575940621684318,right,T4b,208,5,-21,-16,-5,"5,-21"
12576,720575940630605932,right,T4b,209,-3,-8,-1,-7,"-3,-8"
12577,720575940613288499,right,T4b,210,-6,8,10,-2,"-6,8"
12578,720575940631762233,right,T4b,211,-7,-1,6,-7,"-7,-1"
12579,720575940623499814,right,T4b,212,2,-16,-10,-6,"2,-16"
12580,720575940608115418,right,T4b,213,3,-4,-5,1,"3,-4"
12581,720575940610585208,right,T4b,214,-5,3,6,-3,"-5,3"
12582,720575940630988113,right,T4b,215,6,7,-3,10,"6,7"
12583,720575940631633208,right,T4b,216,2,19,7,12,"2,19"
12584,720575940626512837,right,T4b,218,2,10,3,7,"2,10"
12585,720575940623956221,right,T4b,219,6,-4,-8,4,"6,-4"
12586,720575940609972578,right,T4b,220,2,-6,-5,-1,"2,-6"
12587,720575940621234927,right,T4b,221,-7,3,8,-5,"-7,3"
12588,720575940627864337,right,T4b,222,-3,26,16,10,"-3,26"
12589,720575940634111167,right,T4b,223,-2,26,15,11,"-2,26"
12590,720575940624846823,right,T4b,224,0,5,2,3,"0,5"
12591,720575940630105106,right,T4b,226,5,19,4,15,"5,19"
12592,720575940639210062,right,T4b,227,-7,5,9,-4,"-7,5"
12593,720575940624056061,right,T4b,228,-7,1,7,-6,"-7,1"
12594,720575940626298243,right,T4b,229,5,2,-4,6,"5,2"
12595,720575940620137408,right,T4b,230,2,9,2,7,"2,9"
12596,720575940639524515,right,T4b,231,4,-12,-10,-2,"4,-12"
12597,720575940627147308,right,T4b,232,-4,13,10,3,"-4,13"
12598,720575940607039618,right,T4b,233,4,-13,-11,-2,"4,-13"
12599,720575940622355788,right,T4b,234,1,3,0,3,"1,3"
12600,720575940611466389,right,T4b,235,4,11,1,10,"4,11"
12601,720575940628894402,right,T4b,236,-1,4,3,1,"-1,4"
12602,720575940634246881,right,T4b,237,-2,27,15,12,"-2,27"
12603,720575940628409674,right,T4b,238,-8,-3,6,-9,"-8,-3"
12604,720575940637991401,right,T4b,239,-6,6,9,-3,"-6,6"
12605,720575940625759525,right,T4b,240,-4,-3,2,-5,"-4,-3"
12606,720575940613222115,right,T4b,241,2,-17,-11,-6,"2,-17"
12607,720575940625419312,right,T4b,242,-4,6,7,-1,"-4,6"
12608,720575940610983634,right,T4b,243,-1,-21,-10,-11,"-1,-21"
12609,720575940639221949,right,T4b,244,-4,-12,-2,-10,"-4,-12"
12610,720575940633497826,right,T4b,245,-5,-3,3,-6,"-5,-3"
12611,720575940620606061,right,T4b,246,-4,15,11,4,"-4,15"
12612,720575940599457990,right,T4b,247,-4,-15,-4,-11,"-4,-15"
12613,720575940627479016,right,T4b,248,-6,0,6,-6,"-6,0"
12614,720575940627407887,right,T4b,249,2,-12,-8,-4,"2,-12"
12615,720575940631752877,right,T4b,250,-1,1,1,0,"-1,1"
12616,720575940627456811,right,T4b,251,-1,-14,-6,-8,"-1,-14"
12617,720575940632280903,right,T4b,252,3,23,8,15,"3,23"
12618,720575940624668092,right,T4b,253,5,16,3,13,"5,16"
12619,720575940645498734,right,T4b,254,3,-24,-15,-9,"3,-24"
12620,720575940614413218,right,T4b,255,-6,-13,-1,-12,"-6,-13"
12621,720575940636843120,right,T4b,256,5,-20,-15,-5,"5,-20"
12622,720575940620773217,right,T4b,257,2,21,8,13,"2,21"
12623,720575940627448122,right,T4b,258,-4,-17,-5,-12,"-4,-17"
12624,720575940620921771,right,T4b,259,-7,-5,4,-9,"-7,-5"
12625,720575940632826797,right,T4b,260,-3,19,12,7,"-3,19"
12626,720575940616575761,right,T4b,261,-1,13,7,6,"-1,13"
12627,720575940625917228,right,T4b,263,-3,4,5,-1,"-3,4"
12628,720575940616390913,right,T4b,264,-1,-6,-2,-4,"-1,-6"
12629,720575940601672201,right,T4b,265,-6,-1,5,-6,"-6,-1"
12630,720575940631872569,right,T4b,266,-1,-25,-12,-13,"-1,-25"
12631,720575940625052233,right,T4b,267,-6,2,7,-5,"-6,2"
12632,720575940609810013,right,T4b,268,7,-6,-10,4,"7,-6"
12633,720575940629624058,right,T4b,269,2,-19,-12,-7,"2,-19"
12634,720575940631685480,right,T4b,270,1,-8,-5,-3,"1,-8"
12635,720575940640715096,right,T4b,271,4,6,-1,7,"4,6"
12636,720575940631370932,right,T4b,272,3,-2,-4,2,"3,-2"
12637,720575940628764203,right,T4b,273,-6,23,17,6,"-6,23"
12638,720575940632116388,right,T4b,274,6,4,-4,8,"6,4"
12639,720575940629575921,right,T4b,275,-8,-1,7,-8,"-8,-1"
12640,720575940639505240,right,T4b,276,2,3,-1,4,"2,3"
12641,720575940611333841,right,T4b,277,7,-3,-9,6,"7,-3"
12642,720575940641400795,right,T4b,278,-5,10,10,0,"-5,10"
12643,720575940625171533,right,T4b,279,-4,8,8,0,"-4,8"
12644,720575940646496547,right,T4b,280,-6,-14,-1,-13,"-6,-14"
12645,720575940626239020,right,T4b,282,0,26,13,13,"0,26"
12646,720575940646707764,right,T4b,283,-4,4,6,-2,"-4,4"
12647,720575940619764873,right,T4b,284,0,25,12,13,"0,25"
12648,720575940634922906,right,T4b,285,6,-18,-15,-3,"6,-18"
12649,720575940609499000,right,T4b,286,0,-24,-12,-12,"0,-24"
12650,720575940634430048,right,T4b,287,-5,13,11,2,"-5,13"
12651,720575940633429470,right,T4b,288,-1,30,16,14,"-1,30"
12652,720575940628688745,right,T4b,289,-1,11,6,5,"-1,11"
12653,720575940622779775,right,T4b,290,5,-24,-17,-7,"5,-24"
12654,720575940623618999,right,T4b,291,7,2,-6,8,"7,2"
12655,720575940631138322,right,T4b,292,-4,18,13,5,"-4,18"
12656,720575940615625026,right,T4b,293,4,-17,-13,-4,"4,-17"
12657,720575940634428255,right,T4b,294,1,-20,-11,-9,"1,-20"
12658,720575940626241580,right,T4b,295,-2,29,16,13,"-2,29"
12659,720575940613305640,right,T4b,296,1,-18,-10,-8,"1,-18"
12660,720575940626791293,right,T4b,298,-5,5,7,-2,"-5,5"
12661,720575940610816881,right,T4b,299,-4,12,10,2,"-4,12"
12662,720575940610773602,right,T4b,300,4,-18,-13,-5,"4,-18"
12663,720575940630996754,right,T4b,301,-5,16,13,3,"-5,16"
12664,720575940621676817,right,T4b,302,2,17,6,11,"2,17"
12665,720575940626791468,right,T4b,303,-5,22,16,6,"-5,22"
12666,720575940623075819,right,T4b,304,6,5,-4,9,"6,5"
12667,720575940627469564,right,T4b,305,-7,4,9,-5,"-7,4"
12668,720575940614414539,right,T4b,306,3,7,0,7,"3,7"
12669,720575940617598109,right,T4b,308,-5,8,9,-1,"-5,8"
12670,720575940627247620,right,T4b,309,-6,12,12,0,"-6,12"
12671,720575940630521923,right,T4b,310,2,22,9,13,"2,22"
12672,720575940621044340,right,T4b,311,-7,15,14,1,"-7,15"
12673,720575940603498869,right,T4b,312,4,-7,-8,1,"4,-7"
12674,720575940644506135,right,T4b,313,7,3,-6,9,"7,3"
12675,720575940626177176,right,T4b,314,-9,5,11,-6,"-9,5"
12676,720575940615620876,right,T4b,315,-3,-6,0,-6,"-3,-6"
12677,720575940634922647,right,T4b,316,5,-4,-7,3,"5,-4"
12678,720575940623227283,right,T4b,317,-5,-4,3,-7,"-5,-4"
12679,720575940635544973,right,T4b,318,4,-19,-14,-5,"4,-19"
12680,720575940638086461,right,T4b,319,-2,5,4,1,"-2,5"
12681,720575940625815070,right,T4b,320,-2,-5,-1,-4,"-2,-5"
12682,720575940649378681,right,T4b,321,8,4,-6,10,"8,4"
12683,720575940630658041,right,T4b,322,2,26,11,15,"2,26"
12684,720575940627006750,right,T4b,323,-7,-13,0,-13,"-7,-13"
12685,720575940618630720,right,T4b,324,3,24,9,15,"3,24"
12686,720575940623166090,right,T4b,325,5,1,-5,6,"5,1"
12687,720575940630800747,right,T4b,326,2,16,6,10,"2,16"
12688,720575940623271914,right,T4b,327,5,3,-4,7,"5,3"
12689,720575940627736326,right,T4b,328,5,-9,-10,1,"5,-9"
12690,720575940623993673,right,T4b,329,0,24,12,12,"0,24"
12691,720575940637931354,right,T4b,330,3,3,-2,5,"3,3"
12692,720575940633591397,right,T4b,331,1,-15,-9,-6,"1,-15"
12693,720575940621908360,right,T4b,332,4,-26,-17,-9,"4,-26"
12694,720575940616452182,right,T4b,333,0,-21,-11,-10,"0,-21"
12695,720575940608920075,right,T4b,334,1,-26,-14,-12,"1,-26"
12696,720575940621129569,right,T4b,335,2,8,2,6,"2,8"
12697,720575940630818135,right,T4b,336,0,23,11,12,"0,23"
12698,720575940617747037,right,T4b,337,-5,-6,2,-8,"-5,-6"
12699,720575940612200371,right,T4b,338,-1,0,1,-1,"-1,0"
12700,720575940632433000,right,T4b,339,6,11,-1,12,"6,11"
12701,720575940630260188,right,T4b,340,-4,17,12,5,"-4,17"
12702,720575940615803954,right,T4b,341,6,-17,-15,-2,"6,-17"
12703,720575940627398675,right,T4b,342,2,-15,-10,-5,"2,-15"
12704,720575940618264404,right,T4b,343,-3,27,16,11,"-3,27"
12705,720575940610493560,right,T4b,344,-2,-15,-6,-9,"-2,-15"
12706,720575940623338876,right,T4b,345,3,-12,-9,-3,"3,-12"
12707,720575940630054219,right,T4b,346,-7,-9,2,-11,"-7,-9"
12708,720575940623714765,right,T4b,347,-5,-13,-2,-11,"-5,-13"
12709,720575940604805566,right,T4b,348,3,14,4,10,"3,14"
12710,720575940621449686,right,T4b,350,1,15,6,9,"1,15"
12711,720575940604699120,right,T4b,351,-1,-17,-8,-9,"-1,-17"
12712,720575940626220588,right,T4b,352,-2,28,16,12,"-2,28"
12713,720575940637429605,right,T4b,353,2,24,10,14,"2,24"
12714,720575940632509552,right,T4b,354,-2,-26,-11,-15,"-2,-26"
12715,720575940637903076,right,T4b,355,-7,-6,4,-10,"-7,-6"
12716,720575940601206499,right,T4b,356,0,22,11,11,"0,22"
12717,720575940628906747,right,T4b,357,4,17,4,13,"4,17"
12718,720575940611773906,right,T4b,358,-3,17,11,6,"-3,17"
12719,720575940619752329,right,T4b,359,2,23,9,14,"2,23"
12720,720575940622215779,right,T4b,360,-5,19,14,5,"-5,19"
12721,720575940631966009,right,T4b,361,0,-7,-4,-3,"0,-7"
12722,720575940636648590,right,T4b,362,2,-20,-12,-8,"2,-20"
12723,720575940630766647,right,T4b,363,7,-4,-9,5,"7,-4"
12724,720575940614121425,right,T4b,364,4,4,-2,6,"4,4"
12725,720575940610539250,right,T4b,365,4,7,-1,8,"4,7"
12726,720575940631601227,right,T4b,366,-5,-20,-5,-15,"-5,-20"
12727,720575940611829141,right,T4b,367,-6,-15,-2,-13,"-6,-15"
12728,720575940628793243,right,T4b,368,-4,-20,-6,-14,"-4,-20"
12729,720575940607361545,right,T4b,369,5,-5,-8,3,"5,-5"
12730,720575940628258289,right,T4b,370,-3,21,13,8,"-3,21"
12731,720575940630420730,right,T4b,371,6,-5,-9,4,"6,-5"
12732,720575940638547508,right,T4b,372,1,-2,-2,0,"1,-2"
12733,720575940623597704,right,T4b,373,1,-21,-12,-9,"1,-21"
12734,720575940632374867,right,T4b,374,2,13,4,9,"2,13"
12735,720575940623502119,right,T4b,375,-6,7,9,-2,"-6,7"
12736,720575940622082184,right,T4b,377,0,7,3,4,"0,7"
12737,720575940635448312,right,T4b,378,-3,18,12,6,"-3,18"
12738,720575940629222915,right,T4b,380,-1,29,15,14,"-1,29"
12739,720575940617443677,right,T4b,381,-8,-9,3,-12,"-8,-9"
12740,720575940619615568,right,T4b,382,3,-6,-6,0,"3,-6"
12741,720575940628453787,right,T4b,383,-6,11,11,0,"-6,11"
12742,720575940615332246,right,T4b,384,-6,-2,5,-7,"-6,-2"
12743,720575940610514274,right,T4b,385,-3,-18,-6,-12,"-3,-18"
12744,720575940628456091,right,T4b,386,-6,19,15,4,"-6,19"
12745,720575940612985775,right,T4b,387,-1,-15,-7,-8,"-1,-15"
12746,720575940629445498,right,T4b,388,3,19,6,13,"3,19"
12747,720575940620727361,right,T4b,389,-6,-16,-2,-14,"-6,-16"
12748,720575940646864948,right,T4b,390,-6,-9,1,-10,"-6,-9"
12749,720575940642029019,right,T4b,391,4,-3,-6,3,"4,-3"
12750,720575940644397092,right,T4b,392,-4,7,7,0,"-4,7"
12751,720575940613406114,right,T4b,393,-1,22,12,10,"-1,22"
12752,720575940617961245,right,T4b,394,-7,-8,3,-11,"-7,-8"
12753,720575940616894681,right,T4b,395,0,-22,-11,-11,"0,-22"
12754,720575940632661412,right,T4b,396,-1,10,6,4,"-1,10"
12755,720575940626946300,right,T4b,397,-3,-19,-7,-12,"-3,-19"
12756,720575940614473414,right,T4b,398,-3,22,14,8,"-3,22"
12757,720575940613292798,right,T4b,399,-4,-24,-8,-16,"-4,-24"
12758,720575940633245907,right,T4b,400,1,-29,-16,-13,"1,-29"
12759,720575940618366528,right,T4b,401,-2,-19,-8,-11,"-2,-19"
12760,720575940631321797,right,T4b,402,3,26,10,16,"3,26"
12761,720575940623010345,right,T4b,403,-2,-12,-4,-8,"-2,-12"
12762,720575940632841773,right,T4b,404,-1,20,11,9,"-1,20"
12763,720575940631046999,right,T4b,405,3,10,2,8,"3,10"
12764,720575940634999231,right,T4b,406,1,-25,-14,-11,"1,-25"
12765,720575940611755286,right,T4b,407,-5,-10,0,-10,"-5,-10"
12766,720575940626727848,right,T4b,408,-6,-4,4,-8,"-6,-4"
12767,720575940631668072,right,T4b,409,0,-3,-2,-1,"0,-3"
12768,720575940638641990,right,T4b,410,-2,-2,1,-3,"-2,-2"
12769,720575940620033872,right,T4b,411,-5,-19,-5,-14,"-5,-19"
12770,720575940614421922,right,T4b,412,-6,21,16,5,"-6,21"
12771,720575940613810227,right,T4b,413,-2,-7,-2,-5,"-2,-7"
12772,720575940622437334,right,T4b,414,4,21,6,15,"4,21"
12773,720575940628921162,right,T4b,415,6,12,0,12,"6,12"
12774,720575940614586124,right,T4b,416,3,-8,-7,-1,"3,-8"
12775,720575940626665128,right,T4b,417,-6,-10,1,-11,"-6,-10"
12776,720575940635430904,right,T4b,418,-2,15,9,6,"-2,15"
12777,720575940626967055,right,T4b,419,-3,-11,-3,-8,"-3,-11"
12778,720575940616147573,right,T4b,420,6,-3,-8,5,"6,-3"
12779,720575940614747554,right,T4b,421,-1,12,7,5,"-1,12"
12780,720575940606527922,right,T4b,422,-7,-4,5,-9,"-7,-4"
12781,720575940608278537,right,T4b,423,3,-18,-12,-6,"3,-18"
12782,720575940624653035,right,T4b,424,-3,-2,2,-4,"-3,-2"
12783,720575940620640594,right,T4b,425,3,20,7,13,"3,20"
12784,720575940642945844,right,T4b,426,-3,0,3,-3,"-3,0"
12785,720575940619631158,right,T4b,427,5,-18,-14,-4,"5,-18"
12786,720575940621602625,right,T4b,428,-2,23,13,10,"-2,23"
12787,720575940630706683,right,T4b,429,-2,14,9,5,"-2,14"
12788,720575940625774205,right,T4b,430,-3,-7,-1,-6,"-3,-7"
12789,720575940644347940,right,T4b,431,-2,-10,-3,-7,"-2,-10"
12790,720575940619656789,right,T4b,432,-5,7,8,-1,"-5,7"
12791,720575940627762179,right,T4b,433,0,-8,-4,-4,"0,-8"
12792,720575940659001473,right,T4b,434,-3,7,6,1,"-3,7"
12793,720575940627518468,right,T4b,436,0,-15,-8,-7,"0,-15"
12794,720575940613710511,right,T4b,437,-3,12,9,3,"-3,12"
12795,720575940633648153,right,T4b,439,-3,-9,-2,-7,"-3,-9"
12796,720575940613922966,right,T4b,440,1,23,10,13,"1,23"
12797,720575940638335302,right,T4b,441,3,-16,-11,-5,"3,-16"
12798,720575940625523545,right,T4b,442,-5,25,17,8,"-5,25"
12799,720575940637441758,right,T4b,443,-6,4,8,-4,"-6,4"
12800,720575940630764793,right,T4b,444,4,-10,-9,-1,"4,-10"
12801,720575940620732525,right,T4b,445,-2,8,6,2,"-2,8"
12802,720575940642052749,right,T4b,446,2,-14,-9,-5,"2,-14"
12803,720575940611521945,right,T4b,447,-1,2,2,0,"-1,2"
12804,720575940627232286,right,T4b,448,0,30,15,15,"0,30"
12805,720575940633454305,right,T4b,449,6,-16,-14,-2,"6,-16"
12806,720575940637289956,right,T4b,450,2,-9,-7,-2,"2,-9"
12807,720575940624483410,right,T4b,451,4,20,6,14,"4,20"
12808,720575940621557744,right,T4b,452,1,-9,-6,-3,"1,-9"
12809,720575940619779465,right,T4b,453,3,25,9,16,"3,25"
12810,720575940632736101,right,T4b,454,5,-12,-11,-1,"5,-12"
12811,720575940627887356,right,T4b,455,7,-7,-11,4,"7,-7"
12812,720575940611988698,right,T4b,456,0,21,10,11,"0,21"
12813,720575940621636173,right,T4b,457,-2,17,10,7,"-2,17"
12814,720575940639644531,right,T4b,458,5,0,-5,5,"5,0"
12815,720575940626812553,right,T4b,459,5,-3,-7,4,"5,-3"
12816,720575940618827318,right,T4b,460,-3,-20,-7,-13,"-3,-20"
12817,720575940618136859,right,T4b,461,7,-5,-10,5,"7,-5"
12818,720575940621571149,right,T4b,462,-1,18,10,8,"-1,18"
12819,720575940631215609,right,T4b,463,5,17,3,14,"5,17"
12820,720575940615602107,right,T4b,464,4,0,-4,4,"4,0"
12821,720575940622461516,right,T4b,465,3,0,-3,3,"3,0"
12822,720575940617969937,right,T4b,466,1,14,6,8,"1,14"
12823,720575940618366021,right,T4b,467,-2,-20,-8,-12,"-2,-20"
12824,720575940631167535,right,T4b,468,-3,11,8,3,"-3,11"
12825,720575940614122207,right,T4b,469,-7,13,13,0,"-7,13"
12826,720575940609799778,right,T4b,470,4,-9,-9,0,"4,-9"
12827,720575940635192474,right,T4b,471,3,-26,-16,-10,"3,-26"
12828,720575940629365776,right,T4b,472,1,25,11,14,"1,25"
12829,720575940628712448,right,T4b,473,-4,23,15,8,"-4,23"
12830,720575940613896829,right,T4b,474,-3,-17,-6,-11,"-3,-17"
12831,720575940623100906,right,T4b,475,-4,-1,3,-4,"-4,-1"
12832,720575940629880108,right,T4b,476,-1,15,8,7,"-1,15"
12833,720575940643829960,right,T4b,477,-3,2,4,-2,"-3,2"
12834,720575940632359566,right,T4b,478,-7,16,15,1,"-7,16"
12835,720575940626481964,right,T4b,479,-2,10,7,3,"-2,10"
12836,720575940629696727,right,T4b,481,4,-8,-8,0,"4,-8"
12837,720575940617305556,right,T4b,482,1,17,7,10,"1,17"
12838,720575940622887523,right,T4b,483,2,-7,-6,-1,"2,-7"
12839,720575940620726849,right,T4b,484,3,-9,-8,-1,"3,-9"
12840,720575940625315120,right,T4b,485,-3,-3,1,-4,"-3,-3"
12841,720575940628455038,right,T4b,486,0,1,0,1,"0,1"
12842,720575940620012526,right,T4b,487,1,-1,-2,1,"1,-1"
12843,720575940609574468,right,T4b,488,7,5,-5,10,"7,5"
12844,720575940633372129,right,T4b,489,-3,10,8,2,"-3,10"
12845,720575940637893609,right,T4b,490,-5,6,8,-2,"-5,6"
12846,720575940609907298,right,T4b,491,7,-1,-8,7,"7,-1"
12847,720575940616503553,right,T4b,493,-3,23,14,9,"-3,23"
12848,720575940628783355,right,T4b,494,0,29,14,15,"0,29"
12849,720575940627923185,right,T4b,495,4,5,-2,7,"4,5"
12850,720575940632665252,right,T4b,496,7,8,-3,11,"7,8"
12851,720575940612520470,right,T4b,497,6,1,-6,7,"6,1"
12852,720575940625703975,right,T4b,498,6,10,-1,11,"6,10"
12853,720575940635220148,right,T4b,499,5,10,0,10,"5,10"
12854,720575940624385772,right,T4b,500,7,-8,-11,3,"7,-8"
12855,720575940628468552,right,T4b,501,1,2,0,2,"1,2"
12856,720575940614971550,right,T4b,502,5,8,-1,9,"5,8"
12857,720575940624039885,right,T4b,503,3,17,5,12,"3,17"
12858,720575940641139085,right,T4b,504,-2,9,6,3,"-2,9"
12859,720575940647838852,right,T4b,505,6,-22,-17,-5,"6,-22"
12860,720575940633860703,right,T4b,506,1,-12,-7,-5,"1,-12"
12861,720575940623022889,right,T4b,507,-5,-12,-1,-11,"-5,-12"
12862,720575940614800908,right,T4b,508,-5,11,10,1,"-5,11"
12863,720575940628402682,right,T4b,509,-4,10,9,1,"-4,10"
12864,720575940611136435,right,T4b,510,-2,11,7,4,"-2,11"
12865,720575940636510053,right,T4b,511,5,-11,-11,0,"5,-11"
12866,720575940644405796,right,T4b,512,6,0,-6,6,"6,0"
12867,720575940632889645,right,T4b,513,-4,-13,-3,-10,"-4,-13"
12868,720575940635913840,right,T4b,514,-4,-10,-1,-9,"-4,-10"
12869,720575940635870772,right,T4b,517,6,3,-5,8,"6,3"
12870,720575940624648679,right,T4b,518,-4,22,15,7,"-4,22"
12871,720575940627154313,right,T4b,519,-5,-5,2,-7,"-5,-5"
12872,720575940612381335,right,T4b,520,-2,-22,-9,-13,"-2,-22"
12873,720575940623970231,right,T4b,521,6,-9,-11,2,"6,-9"
12874,720575940612740501,right,T4b,522,-4,0,4,-4,"-4,0"
12875,720575940631622712,right,T4b,523,2,14,5,9,"2,14"
12876,720575940635630989,right,T4b,524,4,-20,-14,-6,"4,-20"
12877,720575940622638691,right,T4b,525,-1,-20,-9,-11,"-1,-20"
12878,720575940633529555,right,T4b,526,0,-10,-5,-5,"0,-10"
12879,720575940605547552,right,T4b,527,-4,-8,0,-8,"-4,-8"
12880,720575940612405477,right,T4b,528,2,7,1,6,"2,7"
12881,720575940619472344,right,T4b,529,2,-2,-3,1,"2,-2"
12882,720575940614796509,right,T4b,530,-3,-13,-4,-9,"-3,-13"
12883,720575940623362634,right,T4b,531,1,0,-1,1,"1,0"
12884,720575940631888524,right,T4b,532,-8,7,11,-4,"-8,7"
12885,720575940621828488,right,T4b,533,0,-16,-8,-8,"0,-16"
12886,720575940633058733,right,T4b,534,3,2,-2,4,"3,2"
12887,720575940632079540,right,T4b,535,8,-4,-10,6,"8,-4"
12888,720575940641658164,right,T4b,536,3,4,-1,5,"3,4"
12889,720575940631164316,right,T4b,537,0,-23,-12,-11,"0,-23"
12890,720575940630766610,right,T4b,538,-4,1,4,-3,"-4,1"
12891,720575940642126221,right,T4b,539,-6,15,13,2,"-6,15"
12892,720575940637542797,right,T4b,540,-2,-9,-3,-6,"-2,-9"
12893,720575940619060673,right,T4b,541,-4,14,11,3,"-4,14"
12894,720575940636678884,right,T4b,542,6,-13,-13,0,"6,-13"
12895,720575940621377029,right,T4b,543,-1,-4,-1,-3,"-1,-4"
12896,720575940631088591,right,T4b,544,3,-13,-10,-3,"3,-13"
12897,720575940624631224,right,T4b,545,5,11,0,11,"5,11"
12898,720575940614746847,right,T4b,546,3,6,0,6,"3,6"
12899,720575940630258135,right,T4b,547,-1,21,11,10,"-1,21"
12900,720575940611795861,right,T4b,548,1,-16,-9,-7,"1,-16"
12901,720575940621642118,right,T4b,549,0,-9,-5,-4,"0,-9"
12902,720575940619636395,right,T4b,550,-2,3,3,0,"-2,3"
12903,720575940634207644,right,T4b,551,-4,-9,-1,-8,"-4,-9"
12904,720575940623667383,right,T4b,552,4,-1,-5,4,"4,-1"
12905,720575940612651030,right,T4b,553,-3,16,11,5,"-3,16"
12906,720575940618984315,right,T4b,555,-4,9,8,1,"-4,9"
12907,720575940630192640,right,T4b,556,0,10,5,5,"0,10"
12908,720575940604435061,right,T4b,557,6,-10,-11,1,"6,-10"
12909,720575940645426286,right,T4b,558,-4,-21,-7,-14,"-4,-21"
12910,720575940613153689,right,T4b,559,-6,22,17,5,"-6,22"
12911,720575940633664281,right,T4b,560,-7,14,14,0,"-7,14"
12912,720575940616203166,right,T4b,561,5,7,-2,9,"5,7"
12913,720575940627541736,right,T4b,562,-5,-2,4,-6,"-5,-2"
12914,720575940620690768,right,T4b,563,5,-13,-12,-1,"5,-13"
12915,720575940654921633,right,T4b,564,3,-23,-15,-8,"3,-23"
12916,720575940612669849,right,T4b,565,0,-26,-13,-13,"0,-26"
12917,720575940623214483,right,T4b,566,5,-8,-9,1,"5,-8"
12918,720575940619774811,right,T4b,567,-2,22,13,9,"-2,22"
12919,720575940644383432,right,T4b,568,-6,-8,2,-10,"-6,-8"
12920,720575940635491982,right,T4b,569,6,6,-3,9,"6,6"
12921,720575940618010942,right,T4b,570,2,25,10,15,"2,25"
12922,720575940620561279,right,T4b,571,0,-14,-7,-7,"0,-14"
12923,720575940626760211,right,T4b,572,-8,3,9,-6,"-8,3"
12924,720575940623674893,right,T4b,573,4,14,3,11,"4,14"
12925,720575940647120163,right,T4b,575,6,9,-2,11,"6,9"
12926,720575940633432798,right,T4b,576,0,28,14,14,"0,28"
12927,720575940627027731,right,T4b,577,5,-14,-12,-2,"5,-14"
12928,720575940606947529,right,T4b,578,4,-11,-10,-1,"4,-11"
12929,720575940624815079,right,T4b,579,-3,-10,-2,-8,"-3,-10"
12930,720575940636017527,right,T4b,580,-2,-23,-10,-13,"-2,-23"
12931,720575940616890897,right,T4b,581,3,9,1,8,"3,9"
12932,720575940622936811,right,T4b,582,-1,23,12,11,"-1,23"
12933,720575940646184995,right,T4b,583,3,-25,-16,-9,"3,-25"
12934,720575940647826052,right,T4b,584,4,23,7,16,"4,23"
12935,720575940629933762,right,T4b,585,-1,-23,-11,-12,"-1,-23"
12936,720575940617999680,right,T4b,586,2,18,7,11,"2,18"
12937,720575940611982802,right,T4b,587,4,22,7,15,"4,22"
12938,720575940626397778,right,T4b,588,1,4,1,3,"1,4"
12939,720575940637204877,right,T4b,589,-1,-5,-2,-3,"-1,-5"
12940,720575940626446789,right,T4b,590,1,9,3,6,"1,9"
12941,720575940636377207,right,T4b,591,3,-3,-5,2,"3,-3"
12942,720575940639355251,right,T4b,593,3,-14,-10,-4,"3,-14"
12943,720575940611415362,right,T4b,595,7,-12,-13,1,"7,-12"
12944,720575940630619510,right,T4b,596,-4,-16,-4,-12,"-4,-16"
12945,720575940611861427,right,T4b,597,4,1,-4,5,"4,1"
12946,720575940627847428,right,T4b,598,2,-18,-11,-7,"2,-18"
12947,720575940616343953,right,T4b,599,-1,9,5,4,"-1,9"
12948,720575940634591851,right,T4b,600,3,-10,-8,-2,"3,-10"
12949,720575940629913655,right,T4b,601,1,16,7,9,"1,16"
12950,720575940631516852,right,T4b,602,4,-2,-5,3,"4,-2"
12951,720575940608650507,right,T4b,603,-3,-23,-9,-14,"-3,-23"
12952,720575940643997220,right,T4b,604,-6,-17,-3,-14,"-6,-17"
12953,720575940617285588,right,T4b,605,3,15,4,11,"3,15"
12954,720575940610725218,right,T4b,606,-1,-19,-9,-10,"-1,-19"
12955,720575940621797726,right,T4b,607,1,18,8,10,"1,18"
12956,720575940626510789,right,T4b,608,1,10,4,6,"1,10"
12957,720575940625824899,right,T4b,609,-2,0,2,-2,"-2,0"
12958,720575940605833062,right,T4b,610,2,-23,-14,-9,"2,-23"
12959,720575940625929609,right,T4b,611,-1,-18,-8,-10,"-1,-18"
12960,720575940632300345,right,T4b,612,-3,-26,-10,-16,"-3,-26"
12961,720575940645622051,right,T4b,613,-8,-4,6,-10,"-8,-4"
12962,720575940627958546,right,T4b,614,-2,-8,-2,-6,"-2,-8"
12963,720575940641577101,right,T4b,615,-7,-7,3,-10,"-7,-7"
12964,720575940640231296,right,T4b,616,-3,15,10,5,"-3,15"
12965,720575940631637048,right,T4b,617,-2,-17,-7,-10,"-2,-17"
12966,720575940625085671,right,T4b,618,-1,24,13,11,"-1,24"
12967,720575940626094794,right,T4b,619,-4,-19,-6,-13,"-4,-19"
12968,720575940639304563,right,T4b,620,7,1,-7,8,"7,1"
12969,720575940623652074,right,T4b,621,1,24,11,13,"1,24"
12970,720575940628585987,right,T4b,622,-5,20,15,5,"-5,20"
12971,720575940616525073,right,T4b,623,1,13,5,8,"1,13"
12972,720575940610776162,right,T4b,624,1,-17,-10,-7,"1,-17"
12973,720575940630420444,right,T4b,625,-2,24,14,10,"-2,24"
12974,720575940617358009,right,T4b,626,-5,-8,1,-9,"-5,-8"
12975,720575940623362122,right,T4b,627,0,-1,-1,0,"0,-1"
12976,720575940631755746,right,T4b,628,0,0,0,0,"0,0"
12977,720575940658428033,right,T4b,629,4,24,8,16,"4,24"
12978,720575940630532183,right,T4b,630,4,8,0,8,"4,8"
12979,720575940623871276,right,T4b,631,1,26,12,14,"1,26"
12980,720575940622771592,right,T4b,632,3,-20,-13,-7,"3,-20"
12981,720575940612894771,right,T4b,633,-1,-24,-11,-13,"-1,-24"
12982,720575940617070405,right,T4b,634,-3,-15,-5,-10,"-3,-15"
12983,720575940625364557,right,T4b,635,6,-6,-9,3,"6,-6"
12984,720575940632860499,right,T4b,636,0,6,3,3,"0,6"
12985,720575940628692329,right,T4b,638,-1,7,4,3,"-1,7"
12986,720575940631110475,right,T4b,639,-4,19,13,6,"-4,19"
12987,720575940609721186,right,T4b,640,-1,-16,-7,-9,"-1,-16"
12988,720575940640501467,right,T4b,641,-8,-5,5,-10,"-8,-5"
12989,720575940619332475,right,T4b,642,-5,-11,-1,-10,"-5,-11"
12990,720575940613645487,right,T4b,643,6,14,1,13,"6,14"
12991,720575940622788195,right,T4b,644,-6,18,15,3,"-6,18"
12992,720575940624377096,right,T4b,645,-4,27,17,10,"-4,27"
12993,720575940629905255,right,T4b,646,6,17,2,15,"6,17"
12994,720575940626736808,right,T4b,647,-4,-7,0,-7,"-4,-7"
12995,720575940626452421,right,T4b,648,1,7,2,5,"1,7"
12996,720575940632328403,right,T4b,649,-1,5,3,2,"-1,5"
12997,720575940620035408,right,T4b,650,-3,-25,-10,-15,"-3,-25"
12998,720575940620831341,right,T4b,651,-4,-5,1,-6,"-4,-5"
12999,720575940620117895,right,T4b,652,-6,-11,0,-11,"-6,-11"
13000,720575940630151996,right,T4b,653,-6,-12,0,-12,"-6,-12"
13001,720575940644164718,right,T4b,654,-3,8,7,1,"-3,8"
13002,720575940620346305,right,T4b,655,6,-1,-7,6,"6,-1"
13003,720575940612068594,right,T4b,656,0,-11,-6,-5,"0,-11"
13004,720575940633423586,right,T4b,657,-2,-25,-11,-14,"-2,-25"
13005,720575940643774368,right,T4b,659,-4,-6,1,-7,"-4,-6"
13006,720575940626381356,right,T4b,661,-3,14,10,4,"-3,14"
13007,720575940629010432,right,T4b,662,2,-1,-3,2,"2,-1"
13008,720575940627010685,right,T4b,663,0,8,4,4,"0,8"
13009,720575940615229346,right,T4b,665,7,-2,-8,6,"7,-2"
13010,720575940627103588,right,T4b,667,1,-28,-15,-13,"1,-28"
13011,720575940625790748,right,T4b,668,1,19,8,11,"1,19"
13012,720575940644608036,right,T4b,669,4,-16,-12,-4,"4,-16"
13013,720575940641634100,right,T4b,670,5,5,-3,8,"5,5"
13014,720575940604180140,right,T4b,671,-4,-23,-8,-15,"-4,-23"
13015,720575940627021612,right,T4b,672,-8,11,13,-2,"-8,11"
13016,720575940625952589,right,T4b,673,2,5,0,5,"2,5"
13017,720575940618056005,right,T4b,674,-4,-14,-3,-11,"-4,-14"
13018,720575940631072527,right,T4b,675,-7,19,16,3,"-7,19"
13019,720575940639564147,right,T4b,676,-3,-21,-8,-13,"-3,-21"
13020,720575940622415044,right,T4b,677,0,11,5,6,"0,11"
13021,720575940626787614,right,T4b,678,3,-7,-7,0,"3,-7"
13022,720575940630891883,right,T4b,679,4,18,5,13,"4,18"
13023,720575940633724767,right,T4b,680,-1,25,13,12,"-1,25"
13024,720575940626290276,right,T4b,681,-2,-21,-9,-12,"-2,-21"
13025,720575940615017951,right,T4b,682,6,-8,-10,2,"6,-8"
13026,720575940612773338,right,T4b,683,2,6,1,5,"2,6"
13027,720575940620395759,right,T4b,684,-6,17,14,3,"-6,17"
13028,720575940621188161,right,T4b,685,-5,-9,0,-9,"-5,-9"
13029,720575940607353801,right,T4b,686,5,-22,-16,-6,"5,-22"
13030,720575940630418263,right,T4b,687,-6,-3,4,-7,"-6,-3"
13031,720575940640169277,right,T4b,688,-7,10,12,-2,"-7,10"
13032,720575940613323262,right,T4b,689,-2,18,11,7,"-2,18"
13033,720575940608756693,right,T4b,690,-7,-3,5,-8,"-7,-3"
13034,720575940628088582,right,T4b,691,-9,4,11,-7,"-9,4"
13035,720575940619062693,right,T4b,692,-4,24,16,8,"-4,24"
13036,720575940629600359,right,T4b,693,-3,25,15,10,"-3,25"
13037,720575940641647668,right,T4b,694,4,3,-3,6,"4,3"
13038,720575940615220639,right,T4b,695,-6,10,11,-1,"-6,10"
13039,720575940625929872,right,T4b,696,-2,16,10,6,"-2,16"
13040,720575940638601030,right,T4b,697,1,-22,-12,-10,"1,-22"
13041,720575940615779807,right,T4b,698,6,-7,-10,3,"6,-7"
13042,720575940630378583,right,T4b,699,-5,0,5,-5,"-5,0"
13043,720575940615708266,right,T4b,700,5,15,2,13,"5,15"
13044,720575940616052054,right,T4b,701,0,-4,-2,-2,"0,-4"
13045,720575940634893534,right,T4b,702,-5,23,16,7,"-5,23"
13046,720575940609762094,right,T4b,703,-3,1,3,-2,"-3,1"
13047,720575940624718862,right,T4b,704,-7,8,11,-3,"-7,8"
13048,720575940623289162,right,T4b,705,1,1,-1,2,"1,1"
13049,720575940626050490,right,T4b,706,-7,-12,1,-13,"-7,-12"
13050,720575940639501621,right,T4b,707,-2,25,14,11,"-2,25"
13051,720575940630153324,right,T4b,708,-4,-25,-9,-16,"-4,-25"
13052,720575940608694795,right,T4b,709,-2,-24,-10,-14,"-2,-24"
13053,720575940620148596,right,T4b,710,4,-25,-17,-8,"4,-25"
13054,720575940621674367,right,T4b,711,-1,19,10,9,"-1,19"
13055,720575940639067470,right,T4b,712,-7,12,13,-1,"-7,12"
13056,720575940641410011,right,T4b,713,-6,16,14,2,"-6,16"
13057,720575940631758562,right,T4b,714,5,12,1,11,"5,12"
13058,720575940609062665,right,T4b,715,4,10,1,9,"4,10"
13059,720575940612702105,right,T4b,716,4,-6,-7,1,"4,-6"
13060,720575940610086264,right,T4b,717,2,-22,-13,-9,"2,-22"
13061,720575940644146030,right,T4b,718,-5,24,17,7,"-5,24"
13062,720575940612621285,right,T4b,719,1,27,12,15,"1,27"
13063,720575940620908969,right,T4b,720,-5,21,15,6,"-5,21"
13064,720575940639564870,right,T4b,721,5,13,1,12,"5,13"
13065,720575940622107312,right,T4b,722,6,-15,-14,-1,"6,-15"
13066,720575940635234189,right,T4b,723,-2,-11,-4,-7,"-2,-11"
13067,720575940621398399,right,T4b,724,4,2,-3,5,"4,2"
13068,720575940641829851,right,T4b,725,-3,-24,-9,-15,"-3,-24"
13069,720575940616949977,right,T4b,727,7,6,-4,10,"7,6"
13070,720575940616770610,right,T4b,728,7,12,-1,13,"7,12"
13071,720575940620355917,right,T4b,729,-3,29,17,12,"-3,29"
13072,720575940614241439,right,T4b,730,7,0,-7,7,"7,0"
13073,720575940624388756,right,T4b,731,-6,9,10,-1,"-6,9"
13074,720575940643696676,right,T4b,732,-3,6,6,0,"-3,6"
13075,720575940623089348,right,T4b,733,-5,-17,-4,-13,"-5,-17"
13076,720575940630700684,right,T4b,734,2,0,-2,2,"2,0"
13077,720575940623153961,right,T4b,735,1,-23,-13,-10,"1,-23"
13078,720575940641435099,right,T4b,736,-8,1,8,-7,"-8,1"
13079,720575940617811929,right,T4b,737,0,19,9,10,"0,19"
13080,720575940610582392,right,T4b,738,-3,13,9,4,"-3,13"
13081,720575940630754635,right,T4b,739,-7,2,8,-6,"-7,2"
13082,720575940640183936,right,T4b,740,2,-8,-6,-2,"2,-8"
13083,720575940608173916,right,T4b,741,-2,-14,-5,-9,"-2,-14"
13084,720575940626458412,right,T4b,742,-4,11,9,2,"-4,11"
13085,720575940631894238,right,T4b,744,-4,25,16,9,"-4,25"
13086,720575940626955274,right,T4b,745,0,13,6,7,"0,13"
13087,720575940619244112,right,T4b,746,-3,3,4,-1,"-3,3"
13088,720575940633946731,right,T4b,747,0,2,1,1,"0,2"
13089,720575940638894406,right,T4b,748,-4,20,14,6,"-4,20"
13090,720575940629872172,right,T4b,749,-2,1,2,-1,"-2,1"
13091,720575940616614978,right,T4b,750,4,-24,-16,-8,"4,-24"
13092,720575940625672496,right,T4b,751,1,6,2,4,"1,6"
13093,720575940641682128,right,T4b,752,-2,7,5,2,"-2,7"
13094,720575940630365689,right,T4b,753,-3,24,15,9,"-3,24"
13095,720575940640676925,right,T4b,754,-1,-13,-6,-7,"-1,-13"
13096,720575940622290252,right,T4b,755,4,19,5,14,"4,19"
13097,720575940622945041,right,T4b,756,5,20,5,15,"5,20"
13098,720575940628876076,right,T4b,757,0,-6,-3,-3,"0,-6"
13099,720575940632973357,right,T4b,758,5,-1,-6,5,"5,-1"
13100,720575940615711338,right,T4b,759,7,14,0,14,"7,14"
13101,720575940604835756,right,T4b,760,0,17,8,9,"0,17"
13102,720575940635589044,right,T4b,761,-4,-18,-5,-13,"-4,-18"
13103,720575940629209287,right,T4b,762,0,14,7,7,"0,14"
13104,720575940615630934,right,T4b,763,-5,14,12,2,"-5,14"
13105,720575940616928185,right,T4b,764,-8,-6,5,-11,"-8,-6"
13106,720575940613312423,right,T4b,765,-3,9,7,2,"-3,9"
13107,720575940608119770,right,T4b,766,2,-4,-4,0,"2,-4"
13108,720575940623811268,right,T4b,767,1,28,13,15,"1,28"
13109,720575940624448492,right,T4b,768,3,5,-1,6,"3,5"
13110,720575940624565006,right,T4b,770,5,4,-3,7,"5,4"
13111,720575940642621344,right,T4b,772,1,12,5,7,"1,12"
13112,720575940645949294,right,T4b,774,-8,6,11,-5,"-8,6"
13113,720575940643866568,right,T4b,776,5,21,5,16,"5,21"
13114,720575940643705248,right,T4b,777,6,20,4,16,"6,20"
13115,720575940636349108,right,T4b,780,-6,25,18,7,"-6,25"
13116,720575940613292595,right,T4b,781,-5,26,18,8,"-5,26"
13117,720575940647818116,right,T4b,782,-5,27,18,9,"-5,27"
13118,720575940629266179,right,T4b,783,-4,28,18,10,"-4,28"
13119,720575940614821630,right,T4b,784,-4,29,18,11,"-4,29"
13120,720575940626251308,right,T4b,785,-3,30,18,12,"-3,30"
13121,720575940620804288,right,T4b,786,-2,30,17,13,"-2,30"
13122,720575940636288357,right,T4b,788,3,27,10,17,"3,27"
13123,720575940626302138,right,T4b,796,4,26,9,17,"4,26"
13124,720575940641411547,right,T4c,1,-6,13,12,1,"-6,13"
13125,720575940619019313,right,T4c,2,-8,2,9,-7,"-8,2"
13126,720575940620613409,right,T4c,3,6,-12,-12,0,"6,-12"
13127,720575940611143266,right,T4c,4,-5,-21,-6,-15,"-5,-21"
13128,720575940622126418,right,T4c,5,-1,16,9,7,"-1,16"
13129,720575940631222031,right,T4c,6,-2,-4,0,-4,"-2,-4"
13130,720575940624663560,right,T4c,7,-6,-6,3,-9,"-6,-6"
13131,720575940623336330,right,T4c,8,-4,26,17,9,"-4,26"
13132,720575940643533728,right,T4c,9,4,9,0,9,"4,9"
13133,720575940614902459,right,T4c,10,5,-15,-13,-2,"5,-15"
13134,720575940603563893,right,T4c,11,7,-14,-14,0,"7,-14"
13135,720575940627102802,right,T4c,12,-7,9,11,-2,"-7,9"
13136,720575940615473002,right,T4c,13,-1,-26,-12,-14,"-1,-26"
13137,720575940630428892,right,T4c,14,0,-27,-14,-13,"0,-27"
13138,720575940632269267,right,T4c,15,2,-3,-4,1,"2,-3"
13139,720575940627746069,right,T4c,16,-2,-16,-6,-10,"-2,-16"
13140,720575940624226121,right,T4c,17,1,-5,-4,-1,"1,-5"
13141,720575940629887173,right,T4c,18,5,-16,-13,-3,"5,-16"
13142,720575940641423056,right,T4c,19,-7,17,15,2,"-7,17"
13143,720575940652594422,right,T4c,20,3,-11,-9,-2,"3,-11"
13144,720575940637822436,right,T4c,21,-2,19,11,8,"-2,19"
13145,720575940632074669,right,T4c,22,-1,3,2,1,"-1,3"
13146,720575940622221865,right,T4c,23,-3,-16,-5,-11,"-3,-16"
13147,720575940640122240,right,T4c,24,-1,-10,-4,-6,"-1,-10"
13148,720575940616696347,right,T4c,25,-9,3,10,-7,"-9,3"
13149,720575940639391184,right,T4c,26,1,-3,-3,0,"1,-3"
13150,720575940625052659,right,T4c,27,0,-25,-13,-12,"0,-25"
13151,720575940613892094,right,T4c,28,5,6,-2,8,"5,6"
13152,720575940623310333,right,T4c,29,-1,-3,-1,-2,"-1,-3"
13153,720575940622712609,right,T4c,30,6,16,2,14,"6,16"
13154,720575940622012748,right,T4c,31,0,16,8,8,"0,16"
13155,720575940616556561,right,T4c,32,0,12,6,6,"0,12"
13156,720575940624003581,right,T4c,33,3,18,6,12,"3,18"
13157,720575940631883883,right,T4c,34,6,18,3,15,"6,18"
13158,720575940623813316,right,T4c,35,1,-24,-13,-11,"1,-24"
13159,720575940627834311,right,T4c,36,6,8,-2,10,"6,8"
13160,720575940617002311,right,T4c,37,1,5,1,4,"1,5"
13161,720575940613719294,right,T4c,38,0,-2,-1,-1,"0,-2"
13162,720575940633790745,right,T4c,39,0,20,10,10,"0,20"
13163,720575940624196169,right,T4c,40,-2,-6,-1,-5,"-2,-6"
13164,720575940647825540,right,T4c,41,-3,28,17,11,"-3,28"
13165,720575940620735691,right,T4c,42,-1,14,8,6,"-1,14"
13166,720575940604812204,right,T4c,43,-5,18,14,4,"-5,18"
13167,720575940660312449,right,T4c,44,5,-10,-10,0,"5,-10"
13168,720575940616616507,right,T4c,45,-5,-1,4,-5,"-5,-1"
13169,720575940625119053,right,T4c,46,-5,15,12,3,"-5,15"
13170,720575940627100618,right,T4c,48,-4,-22,-7,-15,"-4,-22"
13171,720575940622708429,right,T4c,49,4,-4,-6,2,"4,-4"
13172,720575940629767015,right,T4c,50,-2,21,12,9,"-2,21"
13173,720575940638331974,right,T4c,51,0,-19,-10,-9,"0,-19"
13174,720575940628917147,right,T4c,52,-1,-22,-10,-12,"-1,-22"
13175,720575940628128842,right,T4c,53,5,14,2,12,"5,14"
13176,720575940634284954,right,T4c,54,-4,3,5,-2,"-4,3"
13177,720575940627724456,right,T4c,55,-4,-11,-2,-9,"-4,-11"
13178,720575940639844925,right,T4c,56,1,-13,-8,-5,"1,-13"
13179,720575940621759100,right,T4c,57,6,-11,-12,1,"6,-11"
13180,720575940627130442,right,T4c,58,3,12,3,9,"3,12"
13181,720575940619197121,right,T4c,59,-2,2,3,-1,"-2,2"
13182,720575940622733097,right,T4c,60,-8,8,12,-4,"-8,8"
13183,720575940608085771,right,T4c,61,-4,-4,2,-6,"-4,-4"
13184,720575940624552172,right,T4c,62,0,-29,-15,-14,"0,-29"
13185,720575940621514080,right,T4c,63,4,12,2,10,"4,12"
13186,720575940642395637,right,T4c,64,4,-23,-16,-7,"4,-23"
13187,720575940633678734,right,T4c,65,-1,28,15,13,"-1,28"
13188,720575940620757926,right,T4c,66,2,15,5,10,"2,15"
13189,720575940615449922,right,T4c,67,-2,-13,-5,-8,"-2,-13"
13190,720575940617132761,right,T4c,68,3,16,5,11,"3,16"
13191,720575940617780241,right,T4c,69,1,8,3,5,"1,8"
13192,720575940615054815,right,T4c,70,-4,21,14,7,"-4,21"
13193,720575940623872492,right,T4c,71,-2,-3,0,-3,"-2,-3"
13194,720575940632842148,right,T4c,72,0,-28,-14,-14,"0,-28"
13195,720575940621201078,right,T4c,73,2,2,-1,3,"2,2"
13196,720575940638177087,right,T4c,74,-1,-9,-4,-5,"-1,-9"
13197,720575940612971634,right,T4c,75,-6,14,13,1,"-6,14"
13198,720575940616961861,right,T4c,76,-3,-4,1,-5,"-3,-4"
13199,720575940621505404,right,T4c,77,2,-5,-5,0,"2,-5"
13200,720575940645255022,right,T4c,78,2,20,8,12,"2,20"
13201,720575940618376522,right,T4c,79,2,1,-2,3,"2,1"
13202,720575940605751008,right,T4c,80,4,13,2,11,"4,13"
13203,720575940629942827,right,T4c,81,6,-2,-7,5,"6,-2"
13204,720575940638987061,right,T4c,82,-7,7,10,-3,"-7,7"
13205,720575940623245706,right,T4c,83,2,-21,-13,-8,"2,-21"
13206,720575940627223634,right,T4c,84,-2,12,8,4,"-2,12"
13207,720575940612245454,right,T4c,85,4,-22,-15,-7,"4,-22"
13208,720575940612547813,right,T4c,86,-5,-7,1,-8,"-5,-7"
13209,720575940627978183,right,T4c,87,1,11,4,7,"1,11"
13210,720575940641648436,right,T4c,88,7,4,-5,9,"7,4"
13211,720575940632025036,right,T4c,89,1,-19,-11,-8,"1,-19"
13212,720575940619451608,right,T4c,90,-4,5,6,-1,"-4,5"
13213,720575940624103861,right,T4c,91,-1,6,4,2,"-1,6"
13214,720575940623305620,right,T4c,92,0,9,4,5,"0,9"
13215,720575940630429945,right,T4c,93,-6,3,7,-4,"-6,3"
13216,720575940608936284,right,T4c,94,5,18,4,14,"5,18"
13217,720575940620992865,right,T4c,95,4,-21,-15,-6,"4,-21"
13218,720575940628574658,right,T4c,96,1,-10,-6,-4,"1,-10"
13219,720575940624941924,right,T4c,97,-5,2,6,-4,"-5,2"
13220,720575940635371405,right,T4c,98,-1,-12,-5,-7,"-1,-12"
13221,720575940610759378,right,T4c,99,4,15,3,12,"4,15"
13222,720575940625126635,right,T4c,100,2,-10,-7,-3,"2,-10"
13223,720575940643515296,right,T4c,101,-7,6,10,-4,"-7,6"
13224,720575940618037990,right,T4c,102,3,13,3,10,"3,13"
13225,720575940605418942,right,T4c,103,7,9,-3,12,"7,9"
13226,720575940626483600,right,T4c,104,-1,-27,-13,-14,"-1,-27"
13227,720575940620672609,right,T4c,105,3,22,8,14,"3,22"
13228,720575940632441427,right,T4c,106,-7,11,12,-1,"-7,11"
13229,720575940620935444,right,T4c,107,8,-2,-9,7,"8,-2"
13230,720575940636273294,right,T4c,108,-3,-12,-3,-9,"-3,-12"
13231,720575940604636021,right,T4c,109,4,-5,-7,2,"4,-5"
13232,720575940628994203,right,T4c,110,-7,0,7,-7,"-7,0"
13233,720575940646845236,right,T4c,111,2,-24,-14,-10,"2,-24"
13234,720575940619415089,right,T4c,112,-6,1,6,-5,"-6,1"
13235,720575940635021247,right,T4c,113,-2,4,4,0,"-2,4"
13236,720575940620766817,right,T4c,114,2,-13,-9,-4,"2,-13"
13237,720575940613623848,right,T4c,115,-4,2,5,-3,"-4,2"
13238,720575940620306853,right,T4c,116,-1,-8,-3,-5,"-1,-8"
13239,720575940620011503,right,T4c,117,-8,-2,7,-9,"-8,-2"
13240,720575940631448716,right,T4c,118,3,1,-3,4,"3,1"
13241,720575940630667576,right,T4c,119,-2,6,5,1,"-2,6"
13242,720575940619665005,right,T4c,120,-1,-1,0,-1,"-1,-1"
13243,720575940617111513,right,T4c,122,-5,9,9,0,"-5,9"
13244,720575940618536350,right,T4c,123,-8,10,13,-3,"-8,10"
13245,720575940639402880,right,T4c,124,1,-7,-5,-2,"1,-7"
13246,720575940629814071,right,T4c,125,5,9,-1,10,"5,9"
13247,720575940628456976,right,T4c,126,3,11,2,9,"3,11"
13248,720575940610047698,right,T4c,127,0,15,7,8,"0,15"
13249,720575940619265963,right,T4c,128,3,-22,-14,-8,"3,-22"
13250,720575940617017542,right,T4c,129,0,-13,-7,-6,"0,-13"
13251,720575940622684966,right,T4c,131,-6,20,16,4,"-6,20"
13252,720575940631598863,right,T4c,132,2,4,0,4,"2,4"
13253,720575940613967839,right,T4c,133,-3,20,13,7,"-3,20"
13254,720575940624408840,right,T4c,134,-5,-18,-4,-14,"-5,-18"
13255,720575940633295571,right,T4c,135,-3,-22,-8,-14,"-3,-22"
13256,720575940628613775,right,T4c,136,0,3,1,2,"0,3"
13257,720575940623118633,right,T4c,137,5,-7,-9,2,"5,-7"
13258,720575940625809182,right,T4c,138,0,27,13,14,"0,27"
13259,720575940642763680,right,T4c,139,1,-14,-8,-6,"1,-14"
13260,720575940628951814,right,T4c,140,3,8,1,7,"3,8"
13261,720575940628200721,right,T4c,141,5,-23,-17,-6,"5,-23"
13262,720575940639627608,right,T4c,142,-2,-18,-7,-11,"-2,-18"
13263,720575940631345450,right,T4c,143,-4,16,12,4,"-4,16"
13264,720575940618368216,right,T4c,144,7,-11,-13,2,"7,-11"
13265,720575940637247322,right,T4c,145,0,4,2,2,"0,4"
13266,720575940613591761,right,T4c,146,1,-6,-4,-2,"1,-6"
13267,720575940630829419,right,T4c,147,1,21,9,12,"1,21"
13268,720575940622955363,right,T4c,148,-7,-11,1,-12,"-7,-11"
13269,720575940649980537,right,T4c,149,6,-14,-13,-1,"6,-14"
13270,720575940638302067,right,T4c,150,-8,5,10,-5,"-8,5"
13271,720575940622006218,right,T4c,151,-3,-14,-4,-10,"-3,-14"
13272,720575940635745648,right,T4c,152,3,-15,-11,-4,"3,-15"
13273,720575940605139116,right,T4c,153,8,0,-8,8,"8,0"
13274,720575940612246258,right,T4c,154,-8,0,8,-8,"-8,0"
13275,720575940612237285,right,T4c,155,-8,13,14,-1,"-8,13"
13276,720575940633364388,right,T4c,156,-9,1,9,-8,"-9,1"
13277,720575940634346135,right,T4c,157,-1,-7,-3,-4,"-1,-7"
13278,720575940611173474,right,T4c,158,3,-5,-6,1,"3,-5"
13279,720575940634385945,right,T4c,159,7,7,-4,11,"7,7"
13280,720575940605470310,right,T4c,160,-2,20,12,8,"-2,20"
13281,720575940640475856,right,T4c,161,4,-14,-11,-3,"4,-14"
13282,720575940626800403,right,T4c,162,-4,-2,3,-5,"-4,-2"
13283,720575940636538286,right,T4c,163,-9,7,12,-5,"-9,7"
13284,720575940631339700,right,T4c,164,-1,-2,0,-2,"-1,-2"
13285,720575940630587855,right,T4c,165,4,16,4,12,"4,16"
13286,720575940620637266,right,T4c,166,0,18,9,9,"0,18"
13287,720575940619368128,right,T4c,167,0,-17,-9,-8,"0,-17"
13288,720575940630067164,right,T4c,168,-1,17,9,8,"-1,17"
13289,720575940614540199,right,T4c,169,0,-18,-9,-9,"0,-18"
13290,720575940621180912,right,T4c,170,-5,1,5,-4,"-5,1"
13291,720575940635951727,right,T4c,171,6,-20,-16,-4,"6,-20"
13292,720575940642045147,right,T4c,172,1,22,10,12,"1,22"
13293,720575940633387233,right,T4c,173,2,-25,-15,-10,"2,-25"
13294,720575940628546682,right,T4c,174,4,-15,-12,-3,"4,-15"
13295,720575940632310328,right,T4c,175,-6,-7,2,-9,"-6,-7"
13296,720575940621475293,right,T4c,176,-2,13,8,5,"-2,13"
13297,720575940620012782,right,T4c,177,-2,-1,1,-2,"-2,-1"
13298,720575940633392083,right,T4c,178,2,11,3,8,"2,11"
13299,720575940624322196,right,T4c,179,-5,-16,-3,-13,"-5,-16"
13300,720575940631030603,right,T4c,180,2,-27,-16,-11,"2,-27"
13301,720575940605180844,right,T4c,181,1,-4,-3,-1,"1,-4"
13302,720575940622057989,right,T4c,182,7,-10,-12,2,"7,-10"
13303,720575940621689613,right,T4c,183,-5,-15,-3,-12,"-5,-15"
13304,720575940626859804,right,T4c,184,-6,-5,3,-8,"-6,-5"
13305,720575940631615993,right,T4c,185,2,-11,-8,-3,"2,-11"
13306,720575940630925942,right,T4c,186,-1,26,14,12,"-1,26"
13307,720575940620644434,right,T4c,187,3,21,7,14,"3,21"
13308,720575940612049777,right,T4c,188,-5,17,13,4,"-5,17"
13309,720575940645597719,right,T4c,189,6,13,0,13,"6,13"
13310,720575940615070687,right,T4c,190,-3,-5,0,-5,"-3,-5"
13311,720575940620760029,right,T4c,191,-1,-11,-5,-6,"-1,-11"
13312,720575940628488811,right,T4c,192,7,10,-2,12,"7,10"
13313,720575940636228782,right,T4c,193,-5,4,7,-3,"-5,4"
13314,720575940630426947,right,T4c,194,0,-5,-3,-2,"0,-5"
13315,720575940627454407,right,T4c,195,-3,-1,2,-3,"-3,-1"
13316,720575940610845333,right,T4c,196,-1,8,5,3,"-1,8"
13317,720575940624201805,right,T4c,197,0,-20,-10,-10,"0,-20"
13318,720575940613190125,right,T4c,198,6,2,-5,7,"6,2"
13319,720575940626370691,right,T4c,199,0,-12,-6,-6,"0,-12"
13320,720575940637084991,right,T4c,200,-5,12,11,1,"-5,12"
13321,720575940628620547,right,T4c,201,-8,9,12,-3,"-8,9"
13322,720575940604983398,right,T4c,202,-1,27,14,13,"-1,27"
13323,720575940600850441,right,T4c,203,3,-1,-4,3,"3,-1"
13324,720575940640571088,right,T4c,204,5,-2,-6,4,"5,-2"
13325,720575940604636789,right,T4c,205,5,-6,-8,2,"5,-6"
13326,720575940623014185,right,T4c,206,-3,5,5,0,"-3,5"
13327,720575940609042955,right,T4c,207,1,29,13,16,"1,29"
13328,720575940626104457,right,T4c,208,5,-21,-16,-5,"5,-21"
13329,720575940627002626,right,T4c,209,-3,-8,-1,-7,"-3,-8"
13330,720575940631885964,right,T4c,210,-6,8,10,-2,"-6,8"
13331,720575940610585646,right,T4c,211,-7,-1,6,-7,"-7,-1"
13332,720575940633597285,right,T4c,212,2,-16,-10,-6,"2,-16"
13333,720575940627562250,right,T4c,213,3,-4,-5,1,"3,-4"
13334,720575940608519689,right,T4c,214,-5,3,6,-3,"-5,3"
13335,720575940628099130,right,T4c,215,6,7,-3,10,"6,7"
13336,720575940619716961,right,T4c,216,2,19,7,12,"2,19"
13337,720575940625540185,right,T4c,217,6,15,1,14,"6,15"
13338,720575940628347774,right,T4c,219,6,-4,-8,4,"6,-4"
13339,720575940610508334,right,T4c,220,2,-6,-5,-1,"2,-6"
13340,720575940606521545,right,T4c,221,-7,3,8,-5,"-7,3"
13341,720575940630793943,right,T4c,222,-3,26,16,10,"-3,26"
13342,720575940629322395,right,T4c,223,-2,26,15,11,"-2,26"
13343,720575940638747251,right,T4c,225,2,-26,-15,-11,"2,-26"
13344,720575940630086394,right,T4c,226,5,19,4,15,"5,19"
13345,720575940612289689,right,T4c,227,-7,5,9,-4,"-7,5"
13346,720575940615610930,right,T4c,228,-7,1,7,-6,"-7,1"
13347,720575940619734987,right,T4c,229,5,2,-4,6,"5,2"
13348,720575940634830699,right,T4c,230,2,9,2,7,"2,9"
13349,720575940636906893,right,T4c,231,4,-12,-10,-2,"4,-12"
13350,720575940611212238,right,T4c,232,-4,13,10,3,"-4,13"
13351,720575940612960661,right,T4c,233,4,-13,-11,-2,"4,-13"
13352,720575940620314246,right,T4c,234,1,3,0,3,"1,3"
13353,720575940621522272,right,T4c,235,4,11,1,10,"4,11"
13354,720575940629063106,right,T4c,236,-1,4,3,1,"-1,4"
13355,720575940620913798,right,T4c,237,-2,27,15,12,"-2,27"
13356,720575940646004003,right,T4c,238,-8,-3,6,-9,"-8,-3"
13357,720575940618517794,right,T4c,239,-6,6,9,-3,"-6,6"
13358,720575940632591897,right,T4c,240,-4,-3,2,-5,"-4,-3"
13359,720575940630809448,right,T4c,241,2,-17,-11,-6,"2,-17"
13360,720575940617180305,right,T4c,242,-4,6,7,-1,"-4,6"
13361,720575940631270556,right,T4c,243,-1,-21,-10,-11,"-1,-21"
13362,720575940620117669,right,T4c,244,-4,-12,-2,-10,"-4,-12"
13363,720575940623820873,right,T4c,245,-5,-3,3,-6,"-5,-3"
13364,720575940614431378,right,T4c,246,-4,15,11,4,"-4,15"
13365,720575940644787479,right,T4c,247,-4,-15,-4,-11,"-4,-15"
13366,720575940631438696,right,T4c,248,-6,0,6,-6,"-6,0"
13367,720575940633943708,right,T4c,249,2,-12,-8,-4,"2,-12"
13368,720575940618344571,right,T4c,250,-1,1,1,0,"-1,1"
13369,720575940628223570,right,T4c,251,-1,-14,-6,-8,"-1,-14"
13370,720575940618773840,right,T4c,253,5,16,3,13,"5,16"
13371,720575940627825051,right,T4c,254,3,-24,-15,-9,"3,-24"
13372,720575940616191861,right,T4c,255,-6,-13,-1,-12,"-6,-13"
13373,720575940610303790,right,T4c,256,5,-20,-15,-5,"5,-20"
13374,720575940605432422,right,T4c,257,2,21,8,13,"2,21"
13375,720575940614101043,right,T4c,258,-4,-17,-5,-12,"-4,-17"
13376,720575940631406587,right,T4c,259,-7,-5,4,-9,"-7,-5"
13377,720575940617781661,right,T4c,260,-3,19,12,7,"-3,19"
13378,720575940617643705,right,T4c,261,-1,13,7,6,"-1,13"
13379,720575940619580245,right,T4c,262,1,-11,-7,-4,"1,-11"
13380,720575940620017829,right,T4c,263,-3,4,5,-1,"-3,4"
13381,720575940627288580,right,T4c,264,-1,-6,-2,-4,"-1,-6"
13382,720575940658822785,right,T4c,265,-6,-1,5,-6,"-6,-1"
13383,720575940620922748,right,T4c,266,-1,-25,-12,-13,"-1,-25"
13384,720575940629557803,right,T4c,267,-6,2,7,-5,"-6,2"
13385,720575940612221669,right,T4c,268,7,-6,-10,4,"7,-6"
13386,720575940639032910,right,T4c,269,2,-19,-12,-7,"2,-19"
13387,720575940630739705,right,T4c,270,1,-8,-5,-3,"1,-8"
13388,720575940622199105,right,T4c,271,4,6,-1,7,"4,6"
13389,720575940619889729,right,T4c,272,3,-2,-4,2,"3,-2"
13390,720575940607131570,right,T4c,273,-6,23,17,6,"-6,23"
13391,720575940627306261,right,T4c,274,6,4,-4,8,"6,4"
13392,720575940620697520,right,T4c,275,-8,-1,7,-8,"-8,-1"
13393,720575940641656116,right,T4c,276,2,3,-1,4,"2,3"
13394,720575940631610472,right,T4c,277,7,-3,-9,6,"7,-3"
13395,720575940620608365,right,T4c,278,-5,10,10,0,"-5,10"
13396,720575940612874803,right,T4c,279,-4,8,8,0,"-4,8"
13397,720575940612176090,right,T4c,280,-6,-14,-1,-13,"-6,-14"
13398,720575940614174098,right,T4c,281,-9,2,10,-8,"-9,2"
13399,720575940635454827,right,T4c,282,0,26,13,13,"0,26"
13400,720575940627110226,right,T4c,283,-4,4,6,-2,"-4,4"
13401,720575940629766247,right,T4c,284,0,25,12,13,"0,25"
13402,720575940617098681,right,T4c,285,6,-18,-15,-3,"6,-18"
13403,720575940614854034,right,T4c,286,0,-24,-12,-12,"0,-24"
13404,720575940638284622,right,T4c,287,-5,13,11,2,"-5,13"
13405,720575940632931294,right,T4c,288,-1,30,16,14,"-1,30"
13406,720575940621651694,right,T4c,289,-1,11,6,5,"-1,11"
13407,720575940635683695,right,T4c,290,5,-24,-17,-7,"5,-24"
13408,720575940621454719,right,T4c,291,7,2,-6,8,"7,2"
13409,720575940612755314,right,T4c,292,-4,18,13,5,"-4,18"
13410,720575940617771803,right,T4c,293,4,-17,-13,-4,"4,-17"
13411,720575940620519173,right,T4c,294,1,-20,-11,-9,"1,-20"
13412,720575940621651366,right,T4c,295,-2,29,16,13,"-2,29"
13413,720575940638533208,right,T4c,296,1,-18,-10,-8,"1,-18"
13414,720575940649627257,right,T4c,297,7,-9,-12,3,"7,-9"
13415,720575940631514179,right,T4c,298,-5,5,7,-2,"-5,5"
13416,720575940608394249,right,T4c,299,-4,12,10,2,"-4,12"
13417,720575940609843298,right,T4c,300,4,-18,-13,-5,"4,-18"
13418,720575940626174210,right,T4c,301,-5,16,13,3,"-5,16"
13419,720575940635446264,right,T4c,302,2,17,6,11,"2,17"
13420,720575940631054649,right,T4c,303,-5,22,16,6,"-5,22"
13421,720575940617194937,right,T4c,304,6,5,-4,9,"6,5"
13422,720575940612316313,right,T4c,305,-7,4,9,-5,"-7,4"
13423,720575940607784405,right,T4c,306,3,7,0,7,"3,7"
13424,720575940617227449,right,T4c,307,5,-25,-18,-7,"5,-25"
13425,720575940640240117,right,T4c,308,-5,8,9,-1,"-5,8"
13426,720575940634914411,right,T4c,309,-6,12,12,0,"-6,12"
13427,720575940620260998,right,T4c,310,2,22,9,13,"2,22"
13428,720575940623997931,right,T4c,312,4,-7,-8,1,"4,-7"
13429,720575940628105488,right,T4c,313,7,3,-6,9,"7,3"
13430,720575940653493750,right,T4c,314,-9,5,11,-6,"-9,5"
13431,720575940620228212,right,T4c,315,-3,-6,0,-6,"-3,-6"
13432,720575940617449250,right,T4c,316,5,-4,-7,3,"5,-4"
13433,720575940624609511,right,T4c,317,-5,-4,3,-7,"-5,-4"
13434,720575940630945551,right,T4c,318,4,-19,-14,-5,"4,-19"
13435,720575940624478608,right,T4c,319,-2,5,4,1,"-2,5"
13436,720575940625653228,right,T4c,320,-2,-5,-1,-4,"-2,-5"
13437,720575940638250054,right,T4c,321,8,4,-6,10,"8,4"
13438,720575940628112456,right,T4c,322,2,26,11,15,"2,26"
13439,720575940617967773,right,T4c,323,-7,-13,0,-13,"-7,-13"
13440,720575940617699998,right,T4c,325,5,1,-5,6,"5,1"
13441,720575940604898662,right,T4c,326,2,16,6,10,"2,16"
13442,720575940616517749,right,T4c,327,5,3,-4,7,"5,3"
13443,720575940604622453,right,T4c,328,5,-9,-10,1,"5,-9"
13444,720575940620476436,right,T4c,329,0,24,12,12,"0,24"
13445,720575940624499947,right,T4c,330,3,3,-2,5,"3,3"
13446,720575940614559894,right,T4c,331,1,-15,-9,-6,"1,-15"
13447,720575940623910397,right,T4c,332,4,-26,-17,-9,"4,-26"
13448,720575940633978649,right,T4c,333,0,-21,-11,-10,"0,-21"
13449,720575940628195527,right,T4c,334,1,-26,-14,-12,"1,-26"
13450,720575940630723671,right,T4c,335,2,8,2,6,"2,8"
13451,720575940634767711,right,T4c,336,0,23,11,12,"0,23"
13452,720575940620243591,right,T4c,337,-5,-6,2,-8,"-5,-6"
13453,720575940628694121,right,T4c,338,-1,0,1,-1,"-1,0"
13454,720575940629486891,right,T4c,339,6,11,-1,12,"6,11"
13455,720575940633380192,right,T4c,340,-4,17,12,5,"-4,17"
13456,720575940611795320,right,T4c,341,6,-17,-15,-2,"6,-17"
13457,720575940636612324,right,T4c,342,2,-15,-10,-5,"2,-15"
13458,720575940626876291,right,T4c,343,-3,27,16,11,"-3,27"
13459,720575940635633588,right,T4c,345,3,-12,-9,-3,"3,-12"
13460,720575940632389201,right,T4c,346,-7,-9,2,-11,"-7,-9"
13461,720575940637645790,right,T4c,347,-5,-13,-2,-11,"-5,-13"
13462,720575940626555589,right,T4c,348,3,14,4,10,"3,14"
13463,720575940614102579,right,T4c,349,-5,-14,-2,-12,"-5,-14"
13464,720575940619647808,right,T4c,350,1,15,6,9,"1,15"
13465,720575940603904496,right,T4c,351,-1,-17,-8,-9,"-1,-17"
13466,720575940617578201,right,T4c,352,-2,28,16,12,"-2,28"
13467,720575940630251884,right,T4c,353,2,24,10,14,"2,24"
13468,720575940618258845,right,T4c,354,-2,-26,-11,-15,"-2,-26"
13469,720575940626349242,right,T4c,355,-7,-6,4,-10,"-7,-6"
13470,720575940632685004,right,T4c,356,0,22,11,11,"0,22"
13471,720575940620394257,right,T4c,357,4,17,4,13,"4,17"
13472,720575940631736680,right,T4c,358,-3,17,11,6,"-3,17"
13473,720575940623312874,right,T4c,359,2,23,9,14,"2,23"
13474,720575940634874975,right,T4c,360,-5,19,14,5,"-5,19"
13475,720575940630043727,right,T4c,361,0,-7,-4,-3,"0,-7"
13476,720575940607955723,right,T4c,362,2,-20,-12,-8,"2,-20"
13477,720575940603797420,right,T4c,363,7,-4,-9,5,"7,-4"
13478,720575940627442831,right,T4c,364,4,4,-2,6,"4,4"
13479,720575940630268780,right,T4c,365,4,7,-1,8,"4,7"
13480,720575940626070714,right,T4c,366,-5,-20,-5,-15,"-5,-20"
13481,720575940624685204,right,T4c,367,-6,-15,-2,-13,"-6,-15"
13482,720575940622342012,right,T4c,368,-4,-20,-6,-14,"-4,-20"
13483,720575940630182364,right,T4c,369,5,-5,-8,3,"5,-5"
13484,720575940610835922,right,T4c,370,-3,21,13,8,"-3,21"
13485,720575940628657914,right,T4c,371,6,-5,-9,4,"6,-5"
13486,720575940631286343,right,T4c,372,1,-2,-2,0,"1,-2"
13487,720575940617193428,right,T4c,373,1,-21,-12,-9,"1,-21"
13488,720575940654504353,right,T4c,374,2,13,4,9,"2,13"
13489,720575940635700335,right,T4c,375,-6,7,9,-2,"-6,7"
13490,720575940636059503,right,T4c,376,-7,-10,2,-12,"-7,-10"
13491,720575940617514241,right,T4c,377,0,7,3,4,"0,7"
13492,720575940626721688,right,T4c,378,-3,18,12,6,"-3,18"
13493,720575940603391712,right,T4c,379,3,-17,-12,-5,"3,-17"
13494,720575940626702026,right,T4c,380,-1,29,15,14,"-1,29"
13495,720575940628806782,right,T4c,381,-8,-9,3,-12,"-8,-9"
13496,720575940637610597,right,T4c,382,3,-6,-6,0,"3,-6"
13497,720575940631935116,right,T4c,383,-6,11,11,0,"-6,11"
13498,720575940648649860,right,T4c,384,-6,-2,5,-7,"-6,-2"
13499,720575940618757430,right,T4c,385,-3,-18,-6,-12,"-3,-18"
13500,720575940612415146,right,T4c,386,-6,19,15,4,"-6,19"
13501,720575940632760933,right,T4c,387,-1,-15,-7,-8,"-1,-15"
13502,720575940637627749,right,T4c,388,3,19,6,13,"3,19"
13503,720575940631961657,right,T4c,389,-6,-16,-2,-14,"-6,-16"
13504,720575940640150912,right,T4c,390,-6,-9,1,-10,"-6,-9"
13505,720575940627131910,right,T4c,391,4,-3,-6,3,"4,-3"
13506,720575940627113994,right,T4c,392,-4,7,7,0,"-4,7"
13507,720575940627410793,right,T4c,393,-1,22,12,10,"-1,22"
13508,720575940629023494,right,T4c,394,-7,-8,3,-11,"-7,-8"
13509,720575940632813357,right,T4c,395,0,-22,-11,-11,"0,-22"
13510,720575940634067612,right,T4c,396,-1,10,6,4,"-1,10"
13511,720575940632712275,right,T4c,397,-3,-19,-7,-12,"-3,-19"
13512,720575940631971346,right,T4c,398,-3,22,14,8,"-3,22"
13513,720575940634193008,right,T4c,399,-4,-24,-8,-16,"-4,-24"
13514,720575940627179401,right,T4c,400,1,-29,-16,-13,"1,-29"
13515,720575940653694881,right,T4c,401,-2,-19,-8,-11,"-2,-19"
13516,720575940645362542,right,T4c,402,3,26,10,16,"3,26"
13517,720575940634182937,right,T4c,403,-2,-12,-4,-8,"-2,-12"
13518,720575940616931101,right,T4c,404,-1,20,11,9,"-1,20"
13519,720575940612694755,right,T4c,405,3,10,2,8,"3,10"
13520,720575940628180617,right,T4c,406,1,-25,-14,-11,"1,-25"
13521,720575940646191236,right,T4c,407,-5,-10,0,-10,"-5,-10"
13522,720575940615255446,right,T4c,408,-6,-4,4,-8,"-6,-4"
13523,720575940615803807,right,T4c,409,0,-3,-2,-1,"0,-3"
13524,720575940615068895,right,T4c,410,-2,-2,1,-3,"-2,-2"
13525,720575940630315052,right,T4c,411,-5,-19,-5,-14,"-5,-19"
13526,720575940626857260,right,T4c,412,-6,21,16,5,"-6,21"
13527,720575940612761458,right,T4c,413,-2,-7,-2,-5,"-2,-7"
13528,720575940620397841,right,T4c,414,4,21,6,15,"4,21"
13529,720575940628122186,right,T4c,415,6,12,0,12,"6,12"
13530,720575940620506862,right,T4c,416,3,-8,-7,-1,"3,-8"
13531,720575940618910228,right,T4c,417,-6,-10,1,-11,"-6,-10"
13532,720575940628591619,right,T4c,418,-2,15,9,6,"-2,15"
13533,720575940644958487,right,T4c,419,-3,-11,-3,-8,"-3,-11"
13534,720575940626976180,right,T4c,420,6,-3,-8,5,"6,-3"
13535,720575940605671625,right,T4c,421,-1,12,7,5,"-1,12"
13536,720575940623653098,right,T4c,422,-7,-4,5,-9,"-7,-4"
13537,720575940638872765,right,T4c,423,3,-18,-12,-6,"3,-18"
13538,720575940621229552,right,T4c,424,-3,-2,2,-4,"-3,-2"
13539,720575940630381007,right,T4c,426,-3,0,3,-3,"-3,0"
13540,720575940629435130,right,T4c,427,5,-18,-14,-4,"5,-18"
13541,720575940620894854,right,T4c,428,-2,23,13,10,"-2,23"
13542,720575940614218655,right,T4c,429,-2,14,9,5,"-2,14"
13543,720575940624748327,right,T4c,430,-3,-7,-1,-6,"-3,-7"
13544,720575940612579763,right,T4c,431,-2,-10,-3,-7,"-2,-10"
13545,720575940623167172,right,T4c,432,-5,7,8,-1,"-5,7"
13546,720575940623748277,right,T4c,433,0,-8,-4,-4,"0,-8"
13547,720575940620625067,right,T4c,434,-3,7,6,1,"-3,7"
13548,720575940638350406,right,T4c,435,5,-17,-14,-3,"5,-17"
13549,720575940632168612,right,T4c,436,0,-15,-8,-7,"0,-15"
13550,720575940627116298,right,T4c,437,-3,12,9,3,"-3,12"
13551,720575940635313562,right,T4c,438,2,27,11,16,"2,27"
13552,720575940617397433,right,T4c,439,-3,-9,-2,-7,"-3,-9"
13553,720575940630219479,right,T4c,440,1,23,10,13,"1,23"
13554,720575940628097768,right,T4c,441,3,-16,-11,-5,"3,-16"
13555,720575940624710379,right,T4c,442,-5,25,17,8,"-5,25"
13556,720575940606521801,right,T4c,443,-6,4,8,-4,"-6,4"
13557,720575940659976065,right,T4c,444,4,-10,-9,-1,"4,-10"
13558,720575940624007176,right,T4c,445,-2,8,6,2,"-2,8"
13559,720575940616643618,right,T4c,446,2,-14,-9,-5,"2,-14"
13560,720575940644174958,right,T4c,447,-1,2,2,0,"-1,2"
13561,720575940624582985,right,T4c,448,0,30,15,15,"0,30"
13562,720575940640356952,right,T4c,449,6,-16,-14,-2,"6,-16"
13563,720575940619962612,right,T4c,450,2,-9,-7,-2,"2,-9"
13564,720575940619979313,right,T4c,451,4,20,6,14,"4,20"
13565,720575940637555853,right,T4c,452,1,-9,-6,-3,"1,-9"
13566,720575940640066382,right,T4c,454,5,-12,-11,-1,"5,-12"
13567,720575940642090400,right,T4c,455,7,-7,-11,4,"7,-7"
13568,720575940630801605,right,T4c,456,0,21,10,11,"0,21"
13569,720575940607702876,right,T4c,457,-2,17,10,7,"-2,17"
13570,720575940632007860,right,T4c,458,5,0,-5,5,"5,0"
13571,720575940646592564,right,T4c,459,5,-3,-7,4,"5,-3"
13572,720575940610732130,right,T4c,460,-3,-20,-7,-13,"-3,-20"
13573,720575940639535438,right,T4c,461,7,-5,-10,5,"7,-5"
13574,720575940621674061,right,T4c,462,-1,18,10,8,"-1,18"
13575,720575940620771937,right,T4c,463,5,17,3,14,"5,17"
13576,720575940620953724,right,T4c,464,4,0,-4,4,"4,0"
13577,720575940628233744,right,T4c,465,3,0,-3,3,"3,0"
13578,720575940638681934,right,T4c,466,1,14,6,8,"1,14"
13579,720575940608362076,right,T4c,467,-2,-20,-8,-12,"-2,-20"
13580,720575940621024124,right,T4c,468,-3,11,8,3,"-3,11"
13581,720575940629428350,right,T4c,469,-7,13,13,0,"-7,13"
13582,720575940646585140,right,T4c,470,4,-9,-9,0,"4,-9"
13583,720575940627753810,right,T4c,471,3,-26,-16,-10,"3,-26"
13584,720575940605980337,right,T4c,472,1,25,11,14,"1,25"
13585,720575940623208376,right,T4c,473,-4,23,15,8,"-4,23"
13586,720575940628364806,right,T4c,474,-3,-17,-6,-11,"-3,-17"
13587,720575940623133075,right,T4c,475,-4,-1,3,-4,"-4,-1"
13588,720575940616524305,right,T4c,476,-1,15,8,7,"-1,15"
13589,720575940635330484,right,T4c,477,-3,2,4,-2,"-3,2"
13590,720575940619278552,right,T4c,478,-7,16,15,1,"-7,16"
13591,720575940630126391,right,T4c,479,-2,10,7,3,"-2,10"
13592,720575940618665595,right,T4c,480,3,-19,-13,-6,"3,-19"
13593,720575940621429492,right,T4c,481,4,-8,-8,0,"4,-8"
13594,720575940622319498,right,T4c,482,1,17,7,10,"1,17"
13595,720575940633641442,right,T4c,483,2,-7,-6,-1,"2,-7"
13596,720575940621124980,right,T4c,484,3,-9,-8,-1,"3,-9"
13597,720575940626402712,right,T4c,485,-3,-3,1,-4,"-3,-3"
13598,720575940628369418,right,T4c,486,0,1,0,1,"0,1"
13599,720575940632861779,right,T4c,487,1,-1,-2,1,"1,-1"
13600,720575940623000614,right,T4c,488,7,5,-5,10,"7,5"
13601,720575940622177712,right,T4c,489,-3,10,8,2,"-3,10"
13602,720575940622787683,right,T4c,490,-5,6,8,-2,"-5,6"
13603,720575940621555821,right,T4c,491,7,-1,-8,7,"7,-1"
13604,720575940632817069,right,T4c,492,-7,-2,6,-8,"-7,-2"
13605,720575940616452950,right,T4c,493,-3,23,14,9,"-3,23"
13606,720575940621824577,right,T4c,494,0,29,14,15,"0,29"
13607,720575940623074598,right,T4c,495,4,5,-2,7,"4,5"
13608,720575940616516865,right,T4c,496,7,8,-3,11,"7,8"
13609,720575940637610468,right,T4c,497,6,1,-6,7,"6,1"
13610,720575940638675034,right,T4c,498,6,10,-1,11,"6,10"
13611,720575940636338789,right,T4c,499,5,10,0,10,"5,10"
13612,720575940627259155,right,T4c,500,7,-8,-11,3,"7,-8"
13613,720575940617646265,right,T4c,501,1,2,0,2,"1,2"
13614,720575940621468352,right,T4c,502,5,8,-1,9,"5,8"
13615,720575940632588430,right,T4c,504,-2,9,6,3,"-2,9"
13616,720575940644664855,right,T4c,505,6,-22,-17,-5,"6,-22"
13617,720575940615160991,right,T4c,506,1,-12,-7,-5,"1,-12"
13618,720575940619119006,right,T4c,507,-5,-12,-1,-11,"-5,-12"
13619,720575940619372736,right,T4c,508,-5,11,10,1,"-5,11"
13620,720575940625731002,right,T4c,509,-4,10,9,1,"-4,10"
13621,720575940637809124,right,T4c,510,-2,11,7,4,"-2,11"
13622,720575940604142453,right,T4c,511,5,-11,-11,0,"5,-11"
13623,720575940638396724,right,T4c,512,6,0,-6,6,"6,0"
13624,720575940614678237,right,T4c,513,-4,-13,-3,-10,"-4,-13"
13625,720575940621781261,right,T4c,514,-4,-10,-1,-9,"-4,-10"
13626,720575940630675756,right,T4c,515,-8,-7,4,-11,"-8,-7"
13627,720575940618114082,right,T4c,516,7,-18,-16,-2,"7,-18"
13628,720575940647192708,right,T4c,517,6,3,-5,8,"6,3"
13629,720575940626534914,right,T4c,518,-4,22,15,7,"-4,22"
13630,720575940632332333,right,T4c,519,-5,-5,2,-7,"-5,-5"
13631,720575940624671636,right,T4c,520,-2,-22,-9,-13,"-2,-22"
13632,720575940631725880,right,T4c,521,6,-9,-11,2,"6,-9"
13633,720575940620878836,right,T4c,522,-4,0,4,-4,"-4,0"
13634,720575940615741145,right,T4c,523,2,14,5,9,"2,14"
13635,720575940632301523,right,T4c,524,4,-20,-14,-6,"4,-20"
13636,720575940625460099,right,T4c,525,-1,-20,-9,-11,"-1,-20"
13637,720575940639743310,right,T4c,526,0,-10,-5,-5,"0,-10"
13638,720575940629558906,right,T4c,527,-4,-8,0,-8,"-4,-8"
13639,720575940632190092,right,T4c,528,2,7,1,6,"2,7"
13640,720575940616714068,right,T4c,529,2,-2,-3,1,"2,-2"
13641,720575940614822621,right,T4c,530,-3,-13,-4,-9,"-3,-13"
13642,720575940616788573,right,T4c,531,1,0,-1,1,"1,0"
13643,720575940612622102,right,T4c,532,-8,7,11,-4,"-8,7"
13644,720575940623296147,right,T4c,533,0,-16,-8,-8,"0,-16"
13645,720575940623011096,right,T4c,534,3,2,-2,4,"3,2"
13646,720575940619097560,right,T4c,535,8,-4,-10,6,"8,-4"
13647,720575940619198110,right,T4c,536,3,4,-1,5,"3,4"
13648,720575940615215170,right,T4c,537,0,-23,-12,-11,"0,-23"
13649,720575940623288260,right,T4c,538,-4,1,4,-3,"-4,1"
13650,720575940627453995,right,T4c,539,-6,15,13,2,"-6,15"
13651,720575940618485312,right,T4c,540,-2,-9,-3,-6,"-2,-9"
13652,720575940631307212,right,T4c,541,-4,14,11,3,"-4,14"
13653,720575940633695201,right,T4c,542,6,-13,-13,0,"6,-13"
13654,720575940614239338,right,T4c,543,-1,-4,-1,-3,"-1,-4"
13655,720575940633372627,right,T4c,544,3,-13,-10,-3,"3,-13"
13656,720575940608947413,right,T4c,545,5,11,0,11,"5,11"
13657,720575940626633615,right,T4c,546,3,6,0,6,"3,6"
13658,720575940621477458,right,T4c,547,-1,21,11,10,"-1,21"
13659,720575940622320861,right,T4c,548,1,-16,-9,-7,"1,-16"
13660,720575940614347774,right,T4c,549,0,-9,-5,-4,"0,-9"
13661,720575940626926991,right,T4c,550,-2,3,3,0,"-2,3"
13662,720575940622218876,right,T4c,551,-4,-9,-1,-8,"-4,-9"
13663,720575940623151240,right,T4c,552,4,-1,-5,4,"4,-1"
13664,720575940623323530,right,T4c,553,-3,16,11,5,"-3,16"
13665,720575940604804798,right,T4c,555,-4,9,8,1,"-4,9"
13666,720575940615512482,right,T4c,556,0,10,5,5,"0,10"
13667,720575940630186556,right,T4c,557,6,-10,-11,1,"6,-10"
13668,720575940627027733,right,T4c,558,-4,-21,-7,-14,"-4,-21"
13669,720575940613972451,right,T4c,559,-6,22,17,5,"-6,22"
13670,720575940634089116,right,T4c,560,-7,14,14,0,"-7,14"
13671,720575940630989899,right,T4c,561,5,7,-2,9,"5,7"
13672,720575940609832387,right,T4c,562,-5,-2,4,-6,"-5,-2"
13673,720575940608317362,right,T4c,563,5,-13,-12,-1,"5,-13"
13674,720575940621111381,right,T4c,564,3,-23,-15,-8,"3,-23"
13675,720575940627115038,right,T4c,565,0,-26,-13,-13,"0,-26"
13676,720575940603498613,right,T4c,566,5,-8,-9,1,"5,-8"
13677,720575940619956045,right,T4c,567,-2,22,13,9,"-2,22"
13678,720575940630675415,right,T4c,568,-6,-8,2,-10,"-6,-8"
13679,720575940624018675,right,T4c,569,6,6,-3,9,"6,6"
13680,720575940627179539,right,T4c,570,2,25,10,15,"2,25"
13681,720575940631944775,right,T4c,571,0,-14,-7,-7,"0,-14"
13682,720575940638730805,right,T4c,572,-8,3,9,-6,"-8,3"
13683,720575940618381981,right,T4c,573,4,14,3,11,"4,14"
13684,720575940629808940,right,T4c,574,-6,5,8,-3,"-6,5"
13685,720575940639565126,right,T4c,575,6,9,-2,11,"6,9"
13686,720575940632439400,right,T4c,576,0,28,14,14,"0,28"
13687,720575940623706549,right,T4c,577,5,-14,-12,-2,"5,-14"
13688,720575940628418639,right,T4c,578,4,-11,-10,-1,"4,-11"
13689,720575940607194290,right,T4c,579,-3,-10,-2,-8,"-3,-10"
13690,720575940605762406,right,T4c,580,-2,-23,-10,-13,"-2,-23"
13691,720575940628876647,right,T4c,581,3,9,1,8,"3,9"
13692,720575940628463977,right,T4c,582,-1,23,12,11,"-1,23"
13693,720575940613032600,right,T4c,583,3,-25,-16,-9,"3,-25"
13694,720575940626579784,right,T4c,584,4,23,7,16,"4,23"
13695,720575940630625654,right,T4c,585,-1,-23,-11,-12,"-1,-23"
13696,720575940619572053,right,T4c,586,2,18,7,11,"2,18"
13697,720575940602928608,right,T4c,587,4,22,7,15,"4,22"
13698,720575940659518849,right,T4c,588,1,4,1,3,"1,4"
13699,720575940639273535,right,T4c,589,-1,-5,-2,-3,"-1,-5"
13700,720575940638379136,right,T4c,590,1,9,3,6,"1,9"
13701,720575940622094377,right,T4c,591,3,-3,-5,2,"3,-3"
13702,720575940623449284,right,T4c,592,3,-28,-17,-11,"3,-28"
13703,720575940637701005,right,T4c,593,3,-14,-10,-4,"3,-14"
13704,720575940623705599,right,T4c,594,7,-16,-15,-1,"7,-16"
13705,720575940641272309,right,T4c,595,7,-12,-13,1,"7,-12"
13706,720575940624331047,right,T4c,596,-4,-16,-4,-12,"-4,-16"
13707,720575940622128161,right,T4c,597,4,1,-4,5,"4,1"
13708,720575940646458500,right,T4c,598,2,-18,-11,-7,"2,-18"
13709,720575940641138829,right,T4c,599,-1,9,5,4,"-1,9"
13710,720575940631784808,right,T4c,600,3,-10,-8,-2,"3,-10"
13711,720575940632280680,right,T4c,601,1,16,7,9,"1,16"
13712,720575940621727493,right,T4c,602,4,-2,-5,3,"4,-2"
13713,720575940619459126,right,T4c,603,-3,-23,-9,-14,"-3,-23"
13714,720575940620603519,right,T4c,604,-6,-17,-3,-14,"-6,-17"
13715,720575940631557699,right,T4c,605,3,15,4,11,"3,15"
13716,720575940622586467,right,T4c,606,-1,-19,-9,-10,"-1,-19"
13717,720575940620515857,right,T4c,607,1,18,8,10,"1,18"
13718,720575940621507568,right,T4c,608,1,10,4,6,"1,10"
13719,720575940618700504,right,T4c,609,-2,0,2,-2,"-2,0"
13720,720575940618925947,right,T4c,610,2,-23,-14,-9,"2,-23"
13721,720575940623460292,right,T4c,611,-1,-18,-8,-10,"-1,-18"
13722,720575940625653543,right,T4c,612,-3,-26,-10,-16,"-3,-26"
13723,720575940631671889,right,T4c,613,-8,-4,6,-10,"-8,-4"
13724,720575940619274118,right,T4c,614,-2,-8,-2,-6,"-2,-8"
13725,720575940644133924,right,T4c,615,-7,-7,3,-10,"-7,-7"
13726,720575940631009810,right,T4c,616,-3,15,10,5,"-3,15"
13727,720575940629263098,right,T4c,617,-2,-17,-7,-10,"-2,-17"
13728,720575940628861244,right,T4c,618,-1,24,13,11,"-1,24"
13729,720575940624296265,right,T4c,619,-4,-19,-6,-13,"-4,-19"
13730,720575940637741801,right,T4c,620,7,1,-7,8,"7,1"
13731,720575940620693999,right,T4c,621,1,24,11,13,"1,24"
13732,720575940616015803,right,T4c,622,-5,20,15,5,"-5,20"
13733,720575940617760670,right,T4c,623,1,13,5,8,"1,13"
13734,720575940616872331,right,T4c,624,1,-17,-10,-7,"1,-17"
13735,720575940632032360,right,T4c,625,-2,24,14,10,"-2,24"
13736,720575940618750006,right,T4c,626,-5,-8,1,-9,"-5,-8"
13737,720575940615035699,right,T4c,627,0,-1,-1,0,"0,-1"
13738,720575940631122489,right,T4c,628,0,0,0,0,"0,0"
13739,720575940612318065,right,T4c,629,4,24,8,16,"4,24"
13740,720575940627446549,right,T4c,630,4,8,0,8,"4,8"
13741,720575940618468692,right,T4c,631,1,26,12,14,"1,26"
13742,720575940617216441,right,T4c,632,3,-20,-13,-7,"3,-20"
13743,720575940624248319,right,T4c,633,-1,-24,-11,-13,"-1,-24"
13744,720575940639387856,right,T4c,634,-3,-15,-5,-10,"-3,-15"
13745,720575940604635253,right,T4c,635,6,-6,-9,3,"6,-6"
13746,720575940608697412,right,T4c,636,0,6,3,3,"0,6"
13747,720575940633103772,right,T4c,637,3,-21,-14,-7,"3,-21"
13748,720575940629969936,right,T4c,638,-1,7,4,3,"-1,7"
13749,720575940623123494,right,T4c,639,-4,19,13,6,"-4,19"
13750,720575940630086876,right,T4c,640,-1,-16,-7,-9,"-1,-16"
13751,720575940617832788,right,T4c,641,-8,-5,5,-10,"-8,-5"
13752,720575940605840514,right,T4c,642,-5,-11,-1,-10,"-5,-11"
13753,720575940624660231,right,T4c,643,6,14,1,13,"6,14"
13754,720575940604521952,right,T4c,644,-6,18,15,3,"-6,18"
13755,720575940635219903,right,T4c,645,-4,27,17,10,"-4,27"
13756,720575940618074205,right,T4c,646,6,17,2,15,"6,17"
13757,720575940636449678,right,T4c,647,-4,-7,0,-7,"-4,-7"
13758,720575940613903978,right,T4c,648,1,7,2,5,"1,7"
13759,720575940622892493,right,T4c,649,-1,5,3,2,"-1,5"
13760,720575940627216259,right,T4c,650,-3,-25,-10,-15,"-3,-25"
13761,720575940627082633,right,T4c,651,-4,-5,1,-6,"-4,-5"
13762,720575940617241437,right,T4c,652,-6,-11,0,-11,"-6,-11"
13763,720575940622953059,right,T4c,653,-6,-12,0,-12,"-6,-12"
13764,720575940632576910,right,T4c,654,-3,8,7,1,"-3,8"
13765,720575940621130849,right,T4c,655,6,-1,-7,6,"6,-1"
13766,720575940623410163,right,T4c,656,0,-11,-6,-5,"0,-11"
13767,720575940638174953,right,T4c,657,-2,-25,-11,-14,"-2,-25"
13768,720575940628303857,right,T4c,658,1,20,9,11,"1,20"
13769,720575940624598771,right,T4c,659,-4,-6,1,-7,"-4,-6"
13770,720575940619531502,right,T4c,660,2,28,12,16,"2,28"
13771,720575940632825261,right,T4c,661,-3,14,10,4,"-3,14"
13772,720575940618489115,right,T4c,662,2,-1,-3,2,"2,-1"
13773,720575940644622628,right,T4c,663,0,8,4,4,"0,8"
13774,720575940625374541,right,T4c,664,1,-27,-15,-12,"1,-27"
13775,720575940608408282,right,T4c,665,7,-2,-8,6,"7,-2"
13776,720575940626256421,right,T4c,666,7,-13,-14,1,"7,-13"
13777,720575940616794930,right,T4c,667,1,-28,-15,-13,"1,-28"
13778,720575940622944525,right,T4c,668,1,19,8,11,"1,19"
13779,720575940620213268,right,T4c,669,4,-16,-12,-4,"4,-16"
13780,720575940620384848,right,T4c,670,5,5,-3,8,"5,5"
13781,720575940632169356,right,T4c,671,-4,-23,-8,-15,"-4,-23"
13782,720575940616530006,right,T4c,672,-8,11,13,-2,"-8,11"
13783,720575940608760843,right,T4c,673,2,5,0,5,"2,5"
13784,720575940617342169,right,T4c,674,-4,-14,-3,-11,"-4,-14"
13785,720575940609108316,right,T4c,675,-7,19,16,3,"-7,19"
13786,720575940614905759,right,T4c,676,-3,-21,-8,-13,"-3,-21"
13787,720575940634302560,right,T4c,678,3,-7,-7,0,"3,-7"
13788,720575940640238499,right,T4c,679,4,18,5,13,"4,18"
13789,720575940626210860,right,T4c,680,-1,25,13,12,"-1,25"
13790,720575940618270877,right,T4c,681,-2,-21,-9,-12,"-2,-21"
13791,720575940613712109,right,T4c,682,6,-8,-10,2,"6,-8"
13792,720575940617348582,right,T4c,683,2,6,1,5,"2,6"
13793,720575940623447530,right,T4c,684,-6,17,14,3,"-6,17"
13794,720575940631369925,right,T4c,685,-5,-9,0,-9,"-5,-9"
13795,720575940614926954,right,T4c,687,-6,-3,4,-7,"-6,-3"
13796,720575940639642968,right,T4c,688,-7,10,12,-2,"-7,10"
13797,720575940612207589,right,T4c,689,-2,18,11,7,"-2,18"
13798,720575940632950684,right,T4c,690,-7,-3,5,-8,"-7,-3"
13799,720575940616748249,right,T4c,691,-9,4,11,-7,"-9,4"
13800,720575940624703979,right,T4c,692,-4,24,16,8,"-4,24"
13801,720575940616238521,right,T4c,693,-3,25,15,10,"-3,25"
13802,720575940623237267,right,T4c,694,4,3,-3,6,"4,3"
13803,720575940632629551,right,T4c,695,-6,10,11,-1,"-6,10"
13804,720575940612584173,right,T4c,696,-2,16,10,6,"-2,16"
13805,720575940624379721,right,T4c,697,1,-22,-12,-10,"1,-22"
13806,720575940627193481,right,T4c,698,6,-7,-10,3,"6,-7"
13807,720575940619185099,right,T4c,699,-5,0,5,-5,"-5,0"
13808,720575940628405064,right,T4c,700,5,15,2,13,"5,15"
13809,720575940620887535,right,T4c,701,0,-4,-2,-2,"0,-4"
13810,720575940622648344,right,T4c,702,-5,23,16,7,"-5,23"
13811,720575940629580414,right,T4c,703,-3,1,3,-2,"-3,1"
13812,720575940612319658,right,T4c,704,-7,8,11,-3,"-7,8"
13813,720575940626840775,right,T4c,705,1,1,-1,2,"1,1"
13814,720575940624985095,right,T4c,706,-7,-12,1,-13,"-7,-12"
13815,720575940627702534,right,T4c,707,-2,25,14,11,"-2,25"
13816,720575940621086299,right,T4c,708,-4,-25,-9,-16,"-4,-25"
13817,720575940613117206,right,T4c,709,-2,-24,-10,-14,"-2,-24"
13818,720575940624269036,right,T4c,710,4,-25,-17,-8,"4,-25"
13819,720575940624822503,right,T4c,711,-1,19,10,9,"-1,19"
13820,720575940633297377,right,T4c,712,-7,12,13,-1,"-7,12"
13821,720575940633583187,right,T4c,713,-6,16,14,2,"-6,16"
13822,720575940624490829,right,T4c,714,5,12,1,11,"5,12"
13823,720575940636903024,right,T4c,715,4,10,1,9,"4,10"
13824,720575940619182507,right,T4c,716,4,-6,-7,1,"4,-6"
13825,720575940611806357,right,T4c,717,2,-22,-13,-9,"2,-22"
13826,720575940605880497,right,T4c,718,-5,24,17,7,"-5,24"
13827,720575940629528080,right,T4c,719,1,27,12,15,"1,27"
13828,720575940635075038,right,T4c,720,-5,21,15,6,"-5,21"
13829,720575940638392390,right,T4c,721,5,13,1,12,"5,13"
13830,720575940630978391,right,T4c,722,6,-15,-14,-1,"6,-15"
13831,720575940627732904,right,T4c,723,-2,-11,-4,-7,"-2,-11"
13832,720575940638729048,right,T4c,724,4,2,-3,5,"4,2"
13833,720575940623736617,right,T4c,725,-3,-24,-9,-15,"-3,-24"
13834,720575940636459877,right,T4c,726,2,-28,-16,-12,"2,-28"
13835,720575940611250040,right,T4c,727,7,6,-4,10,"7,6"
13836,720575940607632306,right,T4c,728,7,12,-1,13,"7,12"
13837,720575940633678478,right,T4c,729,-3,29,17,12,"-3,29"
13838,720575940610633682,right,T4c,730,7,0,-7,7,"7,0"
13839,720575940622804237,right,T4c,731,-6,9,10,-1,"-6,9"
13840,720575940631521484,right,T4c,732,-3,6,6,0,"-3,6"
13841,720575940622975211,right,T4c,733,-5,-17,-4,-13,"-5,-17"
13842,720575940617644171,right,T4c,734,2,0,-2,2,"2,0"
13843,720575940637797609,right,T4c,735,1,-23,-13,-10,"1,-23"
13844,720575940617474561,right,T4c,736,-8,1,8,-7,"-8,1"
13845,720575940617809809,right,T4c,737,0,19,9,10,"0,19"
13846,720575940624247629,right,T4c,738,-3,13,9,4,"-3,13"
13847,720575940622738445,right,T4c,739,-7,2,8,-6,"-7,2"
13848,720575940624951335,right,T4c,740,2,-8,-6,-2,"2,-8"
13849,720575940635350520,right,T4c,741,-2,-14,-5,-9,"-2,-14"
13850,720575940622475263,right,T4c,742,-4,11,9,2,"-4,11"
13851,720575940633179949,right,T4c,743,6,-19,-16,-3,"6,-19"
13852,720575940627110385,right,T4c,744,-4,25,16,9,"-4,25"
13853,720575940616664337,right,T4c,745,0,13,6,7,"0,13"
13854,720575940618340416,right,T4c,746,-3,3,4,-1,"-3,3"
13855,720575940624166837,right,T4c,747,0,2,1,1,"0,2"
13856,720575940603394272,right,T4c,748,-4,20,14,6,"-4,20"
13857,720575940625276990,right,T4c,749,-2,1,2,-1,"-2,1"
13858,720575940630066908,right,T4c,750,4,-24,-16,-8,"4,-24"
13859,720575940619608405,right,T4c,751,1,6,2,4,"1,6"
13860,720575940634333852,right,T4c,752,-2,7,5,2,"-2,7"
13861,720575940627772815,right,T4c,753,-3,24,15,9,"-3,24"
13862,720575940635927151,right,T4c,754,-1,-13,-6,-7,"-1,-13"
13863,720575940627327034,right,T4c,755,4,19,5,14,"4,19"
13864,720575940613498262,right,T4c,756,5,20,5,15,"5,20"
13865,720575940627657749,right,T4c,757,0,-6,-3,-3,"0,-6"
13866,720575940639963224,right,T4c,758,5,-1,-6,5,"5,-1"
13867,720575940630304894,right,T4c,759,7,14,0,14,"7,14"
13868,720575940630988625,right,T4c,760,0,17,8,9,"0,17"
13869,720575940619784033,right,T4c,761,-4,-18,-5,-13,"-4,-18"
13870,720575940613262573,right,T4c,762,0,14,7,7,"0,14"
13871,720575940621044084,right,T4c,763,-5,14,12,2,"-5,14"
13872,720575940627478147,right,T4c,764,-8,-6,5,-11,"-8,-6"
13873,720575940619765670,right,T4c,765,-3,9,7,2,"-3,9"
13874,720575940637958207,right,T4c,766,2,-4,-4,0,"2,-4"
13875,720575940660102273,right,T4c,767,1,28,13,15,"1,28"
13876,720575940618782599,right,T4c,768,3,5,-1,6,"3,5"
13877,720575940614208664,right,T4c,769,4,-27,-18,-9,"4,-27"
13878,720575940616224414,right,T4c,770,5,4,-3,7,"5,4"
13879,720575940622958412,right,T4c,771,3,-27,-17,-10,"3,-27"
13880,720575940626852373,right,T4c,772,1,12,5,7,"1,12"
13881,720575940606480073,right,T4c,773,5,-19,-15,-4,"5,-19"
13882,720575940619675989,right,T4c,774,-8,6,11,-5,"-8,6"
13883,720575940630868165,right,T4c,775,5,22,6,16,"5,22"
13884,720575940647362436,right,T4c,777,6,20,4,16,"6,20"
13885,720575940630610046,right,T4c,778,4,25,8,17,"4,25"
13886,720575940625859879,right,T4c,780,-6,25,18,7,"-6,25"
13887,720575940615221758,right,T4c,781,-5,26,18,8,"-5,26"
13888,720575940624124716,right,T4c,782,-5,27,18,9,"-5,27"
13889,720575940618265172,right,T4c,783,-4,28,18,10,"-4,28"
13890,720575940610050499,right,T4c,784,-4,29,18,11,"-4,29"
13891,720575940627963525,right,T4c,785,-3,30,18,12,"-3,30"
13892,720575940615408757,right,T4c,786,-2,30,17,13,"-2,30"
13893,720575940620696229,right,T4c,788,3,27,10,17,"3,27"
13894,720575940622713724,right,T4c,789,-3,-27,-11,-16,"-3,-27"
13895,720575940608585993,right,T4c,790,-2,-27,-12,-15,"-2,-27"
13896,720575940622536030,right,T4c,791,-1,-28,-13,-15,"-1,-28"
13897,720575940633181410,right,T4c,792,8,2,-7,9,"8,2"
13898,720575940620901870,right,T4c,793,8,-6,-11,5,"8,-6"
13899,720575940639204927,right,T4c,794,5,-26,-18,-8,"5,-26"
13900,720575940623228637,right,T4c,795,6,-21,-17,-4,"6,-21"
13901,720575940624694823,right,T4d,1,-6,13,12,1,"-6,13"
13902,720575940626358617,right,T4d,2,-8,2,9,-7,"-8,2"
13903,720575940635562347,right,T4d,3,6,-12,-12,0,"6,-12"
13904,720575940623235622,right,T4d,4,-5,-21,-6,-15,"-5,-21"
13905,720575940630444396,right,T4d,5,-1,16,9,7,"-1,16"
13906,720575940622468940,right,T4d,6,-2,-4,0,-4,"-2,-4"
13907,720575940617361206,right,T4d,7,-6,-6,3,-9,"-6,-6"
13908,720575940625856039,right,T4d,8,-4,26,17,9,"-4,26"
13909,720575940619181739,right,T4d,9,4,9,0,9,"4,9"
13910,720575940633805267,right,T4d,10,5,-15,-13,-2,"5,-15"
13911,720575940659863937,right,T4d,11,7,-14,-14,0,"7,-14"
13912,720575940629826007,right,T4d,12,-7,9,11,-2,"-7,9"
13913,720575940622196001,right,T4d,13,-1,-26,-12,-14,"-1,-26"
13914,720575940640338229,right,T4d,15,2,-3,-4,1,"2,-3"
13915,720575940639522163,right,T4d,16,-2,-16,-6,-10,"-2,-16"
13916,720575940620431013,right,T4d,17,1,-5,-4,-1,"1,-5"
13917,720575940644663831,right,T4d,18,5,-16,-13,-3,"5,-16"
13918,720575940637836634,right,T4d,19,-7,17,15,2,"-7,17"
13919,720575940625529362,right,T4d,20,3,-11,-9,-2,"3,-11"
13920,720575940615954282,right,T4d,21,-2,19,11,8,"-2,19"
13921,720575940613905514,right,T4d,22,-1,3,2,1,"-1,3"
13922,720575940622739981,right,T4d,23,-3,-16,-5,-11,"-3,-16"
13923,720575940635252109,right,T4d,24,-1,-10,-4,-6,"-1,-10"
13924,720575940620992773,right,T4d,26,1,-3,-3,0,"1,-3"
13925,720575940614248866,right,T4d,27,0,-25,-13,-12,"0,-25"
13926,720575940623374591,right,T4d,28,5,6,-2,8,"5,6"
13927,720575940638695220,right,T4d,29,-1,-3,-1,-2,"-1,-3"
13928,720575940614299047,right,T4d,30,6,16,2,14,"6,16"
13929,720575940617971217,right,T4d,31,0,16,8,8,"0,16"
13930,720575940616680587,right,T4d,32,0,12,6,6,"0,12"
13931,720575940622108442,right,T4d,33,3,18,6,12,"3,18"
13932,720575940630086906,right,T4d,34,6,18,3,15,"6,18"
13933,720575940605241516,right,T4d,35,1,-24,-13,-11,"1,-24"
13934,720575940616008350,right,T4d,36,6,8,-2,10,"6,8"
13935,720575940629457786,right,T4d,37,1,5,1,4,"1,5"
13936,720575940641440397,right,T4d,38,0,-2,-1,-1,"0,-2"
13937,720575940630465910,right,T4d,39,0,20,10,10,"0,20"
13938,720575940627709672,right,T4d,40,-2,-6,-1,-5,"-2,-6"
13939,720575940647286068,right,T4d,41,-3,28,17,11,"-3,28"
13940,720575940615263298,right,T4d,42,-1,14,8,6,"-1,14"
13941,720575940638480755,right,T4d,43,-5,18,14,4,"-5,18"
13942,720575940624519876,right,T4d,44,5,-10,-10,0,"5,-10"
13943,720575940605528166,right,T4d,45,-5,-1,4,-5,"-5,-1"
13944,720575940607063730,right,T4d,46,-5,15,12,3,"-5,15"
13945,720575940632072722,right,T4d,48,-4,-22,-7,-15,"-4,-22"
13946,720575940625123879,right,T4d,49,4,-4,-6,2,"4,-4"
13947,720575940616368667,right,T4d,50,-2,21,12,9,"-2,21"
13948,720575940623481226,right,T4d,51,0,-19,-10,-9,"0,-19"
13949,720575940622987400,right,T4d,52,-1,-22,-10,-12,"-1,-22"
13950,720575940628126449,right,T4d,53,5,14,2,12,"5,14"
13951,720575940627396881,right,T4d,54,-4,3,5,-2,"-4,3"
13952,720575940636768090,right,T4d,55,-4,-11,-2,-9,"-4,-11"
13953,720575940615782962,right,T4d,56,1,-13,-8,-5,"1,-13"
13954,720575940630738775,right,T4d,57,6,-11,-12,1,"6,-11"
13955,720575940649890425,right,T4d,58,3,12,3,9,"3,12"
13956,720575940621344169,right,T4d,59,-2,2,3,-1,"-2,2"
13957,720575940634947167,right,T4d,61,-4,-4,2,-6,"-4,-4"
13958,720575940621520736,right,T4d,63,4,12,2,10,"4,12"
13959,720575940623052326,right,T4d,64,4,-23,-16,-7,"4,-23"
13960,720575940622935832,right,T4d,65,-1,28,15,13,"-1,28"
13961,720575940658882945,right,T4d,66,2,15,5,10,"2,15"
13962,720575940622246090,right,T4d,67,-2,-13,-5,-8,"-2,-13"
13963,720575940620961718,right,T4d,68,3,16,5,11,"3,16"
13964,720575940638179561,right,T4d,69,1,8,3,5,"1,8"
13965,720575940613462579,right,T4d,70,-4,21,14,7,"-4,21"
13966,720575940620894630,right,T4d,71,-2,-3,0,-3,"-2,-3"
13967,720575940616946805,right,T4d,72,0,-28,-14,-14,"0,-28"
13968,720575940636650382,right,T4d,73,2,2,-1,3,"2,2"
13969,720575940627435791,right,T4d,74,-1,-9,-4,-5,"-1,-9"
13970,720575940652673526,right,T4d,75,-6,14,13,1,"-6,14"
13971,720575940611180005,right,T4d,76,-3,-4,1,-5,"-3,-4"
13972,720575940628377618,right,T4d,77,2,-5,-5,0,"2,-5"
13973,720575940627420162,right,T4d,78,2,20,8,12,"2,20"
13974,720575940626580879,right,T4d,79,2,1,-2,3,"2,1"
13975,720575940631107359,right,T4d,80,4,13,2,11,"4,13"
13976,720575940631846324,right,T4d,81,6,-2,-7,5,"6,-2"
13977,720575940620843644,right,T4d,82,-7,7,10,-3,"-7,7"
13978,720575940603842476,right,T4d,83,2,-21,-13,-8,"2,-21"
13979,720575940621380566,right,T4d,84,-2,12,8,4,"-2,12"
13980,720575940635537037,right,T4d,85,4,-22,-15,-7,"4,-22"
13981,720575940635560895,right,T4d,86,-5,-7,1,-8,"-5,-7"
13982,720575940609899844,right,T4d,87,1,11,4,7,"1,11"
13983,720575940621004148,right,T4d,88,7,4,-5,9,"7,4"
13984,720575940628310546,right,T4d,89,1,-19,-11,-8,"1,-19"
13985,720575940616369013,right,T4d,90,-4,5,6,-1,"-4,5"
13986,720575940619184461,right,T4d,91,-1,6,4,2,"-1,6"
13987,720575940610585976,right,T4d,92,0,9,4,5,"0,9"
13988,720575940623087498,right,T4d,93,-6,3,7,-4,"-6,3"
13989,720575940622882045,right,T4d,94,5,18,4,14,"5,18"
13990,720575940635913071,right,T4d,95,4,-21,-15,-6,"4,-21"
13991,720575940646818868,right,T4d,96,1,-10,-6,-4,"1,-10"
13992,720575940620568966,right,T4d,97,-5,2,6,-4,"-5,2"
13993,720575940635252877,right,T4d,98,-1,-12,-5,-7,"-1,-12"
13994,720575940637373918,right,T4d,99,4,15,3,12,"4,15"
13995,720575940620704773,right,T4d,100,2,-10,-7,-3,"2,-10"
13996,720575940634825567,right,T4d,101,-7,6,10,-4,"-7,6"
13997,720575940614947039,right,T4d,102,3,13,3,10,"3,13"
13998,720575940647120419,right,T4d,103,7,9,-3,12,"7,9"
13999,720575940631031855,right,T4d,104,-1,-27,-13,-14,"-1,-27"
14000,720575940632313764,right,T4d,105,3,22,8,14,"3,22"
14001,720575940632057425,right,T4d,106,-7,11,12,-1,"-7,11"
14002,720575940625310029,right,T4d,108,-3,-12,-3,-9,"-3,-12"
14003,720575940604637045,right,T4d,109,4,-5,-7,2,"4,-5"
14004,720575940626358361,right,T4d,110,-7,0,7,-7,"-7,0"
14005,720575940621041005,right,T4d,111,2,-24,-14,-10,"2,-24"
14006,720575940620671367,right,T4d,112,-6,1,6,-5,"-6,1"
14007,720575940652343030,right,T4d,113,-2,4,4,0,"-2,4"
14008,720575940620637935,right,T4d,114,2,-13,-9,-4,"2,-13"
14009,720575940614358695,right,T4d,115,-4,2,5,-3,"-4,2"
14010,720575940615688770,right,T4d,116,-1,-8,-3,-5,"-1,-8"
14011,720575940619792202,right,T4d,118,3,1,-3,4,"3,1"
14012,720575940623322918,right,T4d,119,-2,6,5,1,"-2,6"
14013,720575940624033831,right,T4d,120,-1,-1,0,-1,"-1,-1"
14014,720575940627111250,right,T4d,121,-8,4,10,-6,"-8,4"
14015,720575940616677154,right,T4d,122,-5,9,9,0,"-5,9"
14016,720575940612508851,right,T4d,123,-8,10,13,-3,"-8,10"
14017,720575940633875808,right,T4d,124,1,-7,-5,-2,"1,-7"
14018,720575940621730584,right,T4d,125,5,9,-1,10,"5,9"
14019,720575940605674417,right,T4d,126,3,11,2,9,"3,11"
14020,720575940637380062,right,T4d,127,0,15,7,8,"0,15"
14021,720575940606991817,right,T4d,128,3,-22,-14,-8,"3,-22"
14022,720575940607047810,right,T4d,129,0,-13,-7,-6,"0,-13"
14023,720575940621654305,right,T4d,130,2,12,4,8,"2,12"
14024,720575940627157745,right,T4d,131,-6,20,16,4,"-6,20"
14025,720575940615339743,right,T4d,132,2,4,0,4,"2,4"
14026,720575940619565003,right,T4d,133,-3,20,13,7,"-3,20"
14027,720575940613551510,right,T4d,134,-5,-18,-4,-14,"-5,-18"
14028,720575940606934473,right,T4d,135,-3,-22,-8,-14,"-3,-22"
14029,720575940631219500,right,T4d,136,0,3,1,2,"0,3"
14030,720575940634538135,right,T4d,137,5,-7,-9,2,"5,-7"
14031,720575940634182355,right,T4d,138,0,27,13,14,"0,27"
14032,720575940629672318,right,T4d,139,1,-14,-8,-6,"1,-14"
14033,720575940632810285,right,T4d,140,3,8,1,7,"3,8"
14034,720575940630331095,right,T4d,141,5,-23,-17,-6,"5,-23"
14035,720575940604436720,right,T4d,142,-2,-18,-7,-11,"-2,-18"
14036,720575940627116042,right,T4d,143,-4,16,12,4,"-4,16"
14037,720575940622964957,right,T4d,144,7,-11,-13,2,"7,-11"
14038,720575940622504191,right,T4d,145,0,4,2,2,"0,4"
14039,720575940613534614,right,T4d,146,1,-6,-4,-2,"1,-6"
14040,720575940608846019,right,T4d,147,1,21,9,12,"1,21"
14041,720575940629933561,right,T4d,148,-7,-11,1,-12,"-7,-11"
14042,720575940621609989,right,T4d,149,6,-14,-13,-1,"6,-14"
14043,720575940626794250,right,T4d,150,-8,5,10,-5,"-8,5"
14044,720575940606014898,right,T4d,151,-3,-14,-4,-10,"-3,-14"
14045,720575940630343030,right,T4d,152,3,-15,-11,-4,"3,-15"
14046,720575940646594356,right,T4d,153,8,0,-8,8,"8,0"
14047,720575940630809400,right,T4d,154,-8,0,8,-8,"-8,0"
14048,720575940630368343,right,T4d,156,-9,1,9,-8,"-9,1"
14049,720575940612066802,right,T4d,157,-1,-7,-3,-4,"-1,-7"
14050,720575940615758130,right,T4d,158,3,-5,-6,1,"3,-5"
14051,720575940624529703,right,T4d,159,7,7,-4,11,"7,7"
14052,720575940611903962,right,T4d,160,-2,20,12,8,"-2,20"
14053,720575940630645356,right,T4d,161,4,-14,-11,-3,"4,-14"
14054,720575940633643490,right,T4d,162,-4,-2,3,-5,"-4,-2"
14055,720575940622086614,right,T4d,164,-1,-2,0,-2,"-1,-2"
14056,720575940614030559,right,T4d,165,4,16,4,12,"4,16"
14057,720575940647837572,right,T4d,166,0,18,9,9,"0,18"
14058,720575940628121874,right,T4d,167,0,-17,-9,-8,"0,-17"
14059,720575940624804178,right,T4d,168,-1,17,9,8,"-1,17"
14060,720575940626676057,right,T4d,169,0,-18,-9,-9,"0,-18"
14061,720575940614929002,right,T4d,170,-5,1,5,-4,"-5,1"
14062,720575940636042607,right,T4d,171,6,-20,-16,-4,"6,-20"
14063,720575940627717288,right,T4d,172,1,22,10,12,"1,22"
14064,720575940620855206,right,T4d,173,2,-25,-15,-10,"2,-25"
14065,720575940627399445,right,T4d,174,4,-15,-12,-3,"4,-15"
14066,720575940621271974,right,T4d,175,-6,-7,2,-9,"-6,-7"
14067,720575940622234662,right,T4d,176,-2,13,8,5,"-2,13"
14068,720575940625923203,right,T4d,177,-2,-1,1,-2,"-2,-1"
14069,720575940631561784,right,T4d,178,2,11,3,8,"2,11"
14070,720575940634573408,right,T4d,179,-5,-16,-3,-13,"-5,-16"
14071,720575940630185342,right,T4d,180,2,-27,-16,-11,"2,-27"
14072,720575940634388064,right,T4d,181,1,-4,-3,-1,"1,-4"
14073,720575940638660678,right,T4d,182,7,-10,-12,2,"7,-10"
14074,720575940632413544,right,T4d,183,-5,-15,-3,-12,"-5,-15"
14075,720575940626206352,right,T4d,184,-6,-5,3,-8,"-6,-5"
14076,720575940643411912,right,T4d,185,2,-11,-8,-3,"2,-11"
14077,720575940616297689,right,T4d,186,-1,26,14,12,"-1,26"
14078,720575940627473683,right,T4d,187,3,21,7,14,"3,21"
14079,720575940612617881,right,T4d,188,-5,17,13,4,"-5,17"
14080,720575940630454263,right,T4d,189,6,13,0,13,"6,13"
14081,720575940628559403,right,T4d,190,-3,-5,0,-5,"-3,-5"
14082,720575940617904541,right,T4d,191,-1,-11,-5,-6,"-1,-11"
14083,720575940612879795,right,T4d,192,7,10,-2,12,"7,10"
14084,720575940627595012,right,T4d,193,-5,4,7,-3,"-5,4"
14085,720575940617888157,right,T4d,194,0,-5,-3,-2,"0,-5"
14086,720575940620980390,right,T4d,195,-3,-1,2,-3,"-3,-1"
14087,720575940621945880,right,T4d,196,-1,8,5,3,"-1,8"
14088,720575940616686225,right,T4d,197,0,-20,-10,-10,"0,-20"
14089,720575940624279444,right,T4d,198,6,2,-5,7,"6,2"
14090,720575940613810483,right,T4d,199,0,-12,-6,-6,"0,-12"
14091,720575940614273022,right,T4d,200,-5,12,11,1,"-5,12"
14092,720575940637790298,right,T4d,201,-8,9,12,-3,"-8,9"
14093,720575940625284396,right,T4d,202,-1,27,14,13,"-1,27"
14094,720575940600934665,right,T4d,203,3,-1,-4,3,"3,-1"
14095,720575940631937460,right,T4d,204,5,-2,-6,4,"5,-2"
14096,720575940637405150,right,T4d,205,5,-6,-8,2,"5,-6"
14097,720575940625947692,right,T4d,206,-3,5,5,0,"-3,5"
14098,720575940623383788,right,T4d,208,5,-21,-16,-5,"5,-21"
14099,720575940617557649,right,T4d,209,-3,-8,-1,-7,"-3,-8"
14100,720575940606569417,right,T4d,210,-6,8,10,-2,"-6,8"
14101,720575940639224381,right,T4d,211,-7,-1,6,-7,"-7,-1"
14102,720575940646506019,right,T4d,212,2,-16,-10,-6,"2,-16"
14103,720575940622951571,right,T4d,213,3,-4,-5,1,"3,-4"
14104,720575940618475422,right,T4d,214,-5,3,6,-3,"-5,3"
14105,720575940631687471,right,T4d,215,6,7,-3,10,"6,7"
14106,720575940608708309,right,T4d,216,2,19,7,12,"2,19"
14107,720575940621351151,right,T4d,217,6,15,1,14,"6,15"
14108,720575940632220719,right,T4d,218,2,10,3,7,"2,10"
14109,720575940603498357,right,T4d,219,6,-4,-8,4,"6,-4"
14110,720575940637257869,right,T4d,220,2,-6,-5,-1,"2,-6"
14111,720575940632353453,right,T4d,221,-7,3,8,-5,"-7,3"
14112,720575940624248772,right,T4d,222,-3,26,16,10,"-3,26"
14113,720575940629163536,right,T4d,223,-2,26,15,11,"-2,26"
14114,720575940619454379,right,T4d,224,0,5,2,3,"0,5"
14115,720575940660346497,right,T4d,225,2,-26,-15,-11,"2,-26"
14116,720575940621130356,right,T4d,226,5,19,4,15,"5,19"
14117,720575940621194501,right,T4d,227,-7,5,9,-4,"-7,5"
14118,720575940624619022,right,T4d,228,-7,1,7,-6,"-7,1"
14119,720575940611049678,right,T4d,229,5,2,-4,6,"5,2"
14120,720575940627671061,right,T4d,230,2,9,2,7,"2,9"
14121,720575940637818857,right,T4d,231,4,-12,-10,-2,"4,-12"
14122,720575940633696666,right,T4d,232,-4,13,10,3,"-4,13"
14123,720575940626305554,right,T4d,233,4,-13,-11,-2,"4,-13"
14124,720575940634788703,right,T4d,234,1,3,0,3,"1,3"
14125,720575940629254594,right,T4d,235,4,11,1,10,"4,11"
14126,720575940631680312,right,T4d,236,-1,4,3,1,"-1,4"
14127,720575940632920030,right,T4d,237,-2,27,15,12,"-2,27"
14128,720575940627414184,right,T4d,238,-8,-3,6,-9,"-8,-3"
14129,720575940622089181,right,T4d,239,-6,6,9,-3,"-6,6"
14130,720575940619972998,right,T4d,240,-4,-3,2,-5,"-4,-3"
14131,720575940630265339,right,T4d,241,2,-17,-11,-6,"2,-17"
14132,720575940616934203,right,T4d,242,-4,6,7,-1,"-4,6"
14133,720575940639523187,right,T4d,243,-1,-21,-10,-11,"-1,-21"
14134,720575940633973529,right,T4d,244,-4,-12,-2,-10,"-4,-12"
14135,720575940618432413,right,T4d,245,-5,-3,3,-6,"-5,-3"
14136,720575940610861717,right,T4d,246,-4,15,11,4,"-4,15"
14137,720575940638039268,right,T4d,247,-4,-15,-4,-11,"-4,-15"
14138,720575940645627927,right,T4d,248,-6,0,6,-6,"-6,0"
14139,720575940625926448,right,T4d,249,2,-12,-8,-4,"2,-12"
14140,720575940632222381,right,T4d,250,-1,1,1,0,"-1,1"
14141,720575940622776200,right,T4d,251,-1,-14,-6,-8,"-1,-14"
14142,720575940625612848,right,T4d,252,3,23,8,15,"3,23"
14143,720575940639110222,right,T4d,253,5,16,3,13,"5,16"
14144,720575940620718575,right,T4d,254,3,-24,-15,-9,"3,-24"
14145,720575940623541898,right,T4d,255,-6,-13,-1,-12,"-6,-13"
14146,720575940619849069,right,T4d,256,5,-20,-15,-5,"5,-20"
14147,720575940646143267,right,T4d,257,2,21,8,13,"2,21"
14148,720575940612391661,right,T4d,258,-4,-17,-5,-12,"-4,-17"
14149,720575940621833096,right,T4d,259,-7,-5,4,-9,"-7,-5"
14150,720575940626565178,right,T4d,260,-3,19,12,7,"-3,19"
14151,720575940626554713,right,T4d,261,-1,13,7,6,"-1,13"
14152,720575940646146083,right,T4d,262,1,-11,-7,-4,"1,-11"
14153,720575940619410737,right,T4d,263,-3,4,5,-1,"-3,4"
14154,720575940624320951,right,T4d,264,-1,-6,-2,-4,"-1,-6"
14155,720575940630511557,right,T4d,265,-6,-1,5,-6,"-6,-1"
14156,720575940622826493,right,T4d,266,-1,-25,-12,-13,"-1,-25"
14157,720575940624854798,right,T4d,267,-6,2,7,-5,"-6,2"
14158,720575940603556981,right,T4d,268,7,-6,-10,4,"7,-6"
14159,720575940620593323,right,T4d,269,2,-19,-12,-7,"2,-19"
14160,720575940627932232,right,T4d,270,1,-8,-5,-3,"1,-8"
14161,720575940622479228,right,T4d,271,4,6,-1,7,"4,6"
14162,720575940660286337,right,T4d,272,3,-2,-4,2,"3,-2"
14163,720575940636817806,right,T4d,273,-6,23,17,6,"-6,23"
14164,720575940623034308,right,T4d,274,6,4,-4,8,"6,4"
14165,720575940615643442,right,T4d,275,-8,-1,7,-8,"-8,-1"
14166,720575940622929688,right,T4d,276,2,3,-1,4,"2,3"
14167,720575940630526009,right,T4d,277,7,-3,-9,6,"7,-3"
14168,720575940626680506,right,T4d,278,-5,10,10,0,"-5,10"
14169,720575940620316865,right,T4d,279,-4,8,8,0,"-4,8"
14170,720575940639708531,right,T4d,280,-6,-14,-1,-13,"-6,-14"
14171,720575940625235331,right,T4d,282,0,26,13,13,"0,26"
14172,720575940623469034,right,T4d,283,-4,4,6,-2,"-4,4"
14173,720575940622149887,right,T4d,284,0,25,12,13,"0,25"
14174,720575940617495867,right,T4d,286,0,-24,-12,-12,"0,-24"
14175,720575940638064061,right,T4d,287,-5,13,11,2,"-5,13"
14176,720575940628864247,right,T4d,289,-1,11,6,5,"-1,11"
14177,720575940618183569,right,T4d,290,5,-24,-17,-7,"5,-24"
14178,720575940620348144,right,T4d,291,7,2,-6,8,"7,2"
14179,720575940613984943,right,T4d,292,-4,18,13,5,"-4,18"
14180,720575940627828241,right,T4d,293,4,-17,-13,-4,"4,-17"
14181,720575940620480134,right,T4d,294,1,-20,-11,-9,"1,-20"
14182,720575940633683086,right,T4d,295,-2,29,16,13,"-2,29"
14183,720575940612105690,right,T4d,296,1,-18,-10,-8,"1,-18"
14184,720575940623229737,right,T4d,297,7,-9,-12,3,"7,-9"
14185,720575940624648124,right,T4d,298,-5,5,7,-2,"-5,5"
14186,720575940627023047,right,T4d,299,-4,12,10,2,"-4,12"
14187,720575940625890878,right,T4d,300,4,-18,-13,-5,"4,-18"
14188,720575940614269351,right,T4d,301,-5,16,13,3,"-5,16"
14189,720575940636141943,right,T4d,302,2,17,6,11,"2,17"
14190,720575940620747553,right,T4d,303,-5,22,16,6,"-5,22"
14191,720575940613670963,right,T4d,304,6,5,-4,9,"6,5"
14192,720575940626080356,right,T4d,305,-7,4,9,-5,"-7,4"
14193,720575940627776143,right,T4d,306,3,7,0,7,"3,7"
14194,720575940632613262,right,T4d,308,-5,8,9,-1,"-5,8"
14195,720575940628835015,right,T4d,309,-6,12,12,0,"-6,12"
14196,720575940622189436,right,T4d,310,2,22,9,13,"2,22"
14197,720575940626592664,right,T4d,311,-7,15,14,1,"-7,15"
14198,720575940608792026,right,T4d,312,4,-7,-8,1,"4,-7"
14199,720575940620903856,right,T4d,313,7,3,-6,9,"7,3"
14200,720575940622821133,right,T4d,314,-9,5,11,-6,"-9,5"
14201,720575940631879480,right,T4d,315,-3,-6,0,-6,"-3,-6"
14202,720575940612549490,right,T4d,316,5,-4,-7,3,"5,-4"
14203,720575940604902921,right,T4d,317,-5,-4,3,-7,"-5,-4"
14204,720575940620235867,right,T4d,318,4,-19,-14,-5,"4,-19"
14205,720575940619436709,right,T4d,319,-2,5,4,1,"-2,5"
14206,720575940616594037,right,T4d,320,-2,-5,-1,-4,"-2,-5"
14207,720575940639814051,right,T4d,322,2,26,11,15,"2,26"
14208,720575940628236999,right,T4d,323,-7,-13,0,-13,"-7,-13"
14209,720575940607961283,right,T4d,324,3,24,9,15,"3,24"
14210,720575940635789620,right,T4d,325,5,1,-5,6,"5,1"
14211,720575940615686486,right,T4d,326,2,16,6,10,"2,16"
14212,720575940616439330,right,T4d,327,5,3,-4,7,"5,3"
14213,720575940646180228,right,T4d,328,5,-9,-10,1,"5,-9"
14214,720575940620786624,right,T4d,329,0,24,12,12,"0,24"
14215,720575940621299677,right,T4d,330,3,3,-2,5,"3,3"
14216,720575940628135698,right,T4d,331,1,-15,-9,-6,"1,-15"
14217,720575940622228997,right,T4d,332,4,-26,-17,-9,"4,-26"
14218,720575940623855367,right,T4d,333,0,-21,-11,-10,"0,-21"
14219,720575940618778914,right,T4d,334,1,-26,-14,-12,"1,-26"
14220,720575940610562424,right,T4d,335,2,8,2,6,"2,8"
14221,720575940614245329,right,T4d,336,0,23,11,12,"0,23"
14222,720575940625986441,right,T4d,337,-5,-6,2,-8,"-5,-6"
14223,720575940604946720,right,T4d,338,-1,0,1,-1,"-1,0"
14224,720575940638125646,right,T4d,339,6,11,-1,12,"6,11"
14225,720575940613711279,right,T4d,340,-4,17,12,5,"-4,17"
14226,720575940652151798,right,T4d,341,6,-17,-15,-2,"6,-17"
14227,720575940621480575,right,T4d,342,2,-15,-10,-5,"2,-15"
14228,720575940627479326,right,T4d,343,-3,27,16,11,"-3,27"
14229,720575940604679664,right,T4d,344,-2,-15,-6,-9,"-2,-15"
14230,720575940632009007,right,T4d,345,3,-12,-9,-3,"3,-12"
14231,720575940610690709,right,T4d,347,-5,-13,-2,-11,"-5,-13"
14232,720575940630588111,right,T4d,348,3,14,4,10,"3,14"
14233,720575940615489858,right,T4d,350,1,15,6,9,"1,15"
14234,720575940612234725,right,T4d,351,-1,-17,-8,-9,"-1,-17"
14235,720575940646791715,right,T4d,352,-2,28,16,12,"-2,28"
14236,720575940619763849,right,T4d,353,2,24,10,14,"2,24"
14237,720575940603356896,right,T4d,354,-2,-26,-11,-15,"-2,-26"
14238,720575940635824751,right,T4d,355,-7,-6,4,-10,"-7,-6"
14239,720575940620782318,right,T4d,356,0,22,11,11,"0,22"
14240,720575940619353211,right,T4d,357,4,17,4,13,"4,17"
14241,720575940626505226,right,T4d,358,-3,17,11,6,"-3,17"
14242,720575940643737367,right,T4d,359,2,23,9,14,"2,23"
14243,720575940624704491,right,T4d,360,-5,19,14,5,"-5,19"
14244,720575940634716570,right,T4d,361,0,-7,-4,-3,"0,-7"
14245,720575940612365464,right,T4d,362,2,-20,-12,-8,"2,-20"
14246,720575940614118142,right,T4d,363,7,-4,-9,5,"7,-4"
14247,720575940616306078,right,T4d,364,4,4,-2,6,"4,4"
14248,720575940615481019,right,T4d,365,4,7,-1,8,"4,7"
14249,720575940634542191,right,T4d,366,-5,-20,-5,-15,"-5,-20"
14250,720575940628620535,right,T4d,367,-6,-15,-2,-13,"-6,-15"
14251,720575940639917171,right,T4d,368,-4,-20,-6,-14,"-4,-20"
14252,720575940609352387,right,T4d,369,5,-5,-8,3,"5,-5"
14253,720575940641994741,right,T4d,370,-3,21,13,8,"-3,21"
14254,720575940623191757,right,T4d,371,6,-5,-9,4,"6,-5"
14255,720575940641610804,right,T4d,372,1,-2,-2,0,"1,-2"
14256,720575940621339574,right,T4d,373,1,-21,-12,-9,"1,-21"
14257,720575940628525073,right,T4d,374,2,13,4,9,"2,13"
14258,720575940619723911,right,T4d,375,-6,7,9,-2,"-6,7"
14259,720575940627756968,right,T4d,376,-7,-10,2,-12,"-7,-10"
14260,720575940630968773,right,T4d,377,0,7,3,4,"0,7"
14261,720575940632402892,right,T4d,378,-3,18,12,6,"-3,18"
14262,720575940639508387,right,T4d,379,3,-17,-12,-5,"3,-17"
14263,720575940623274760,right,T4d,380,-1,29,15,14,"-1,29"
14264,720575940628549754,right,T4d,382,3,-6,-6,0,"3,-6"
14265,720575940640240373,right,T4d,383,-6,11,11,0,"-6,11"
14266,720575940630469881,right,T4d,384,-6,-2,5,-7,"-6,-2"
14267,720575940620332308,right,T4d,385,-3,-18,-6,-12,"-3,-18"
14268,720575940620746849,right,T4d,386,-6,19,15,4,"-6,19"
14269,720575940618502841,right,T4d,387,-1,-15,-7,-8,"-1,-15"
14270,720575940610876258,right,T4d,388,3,19,6,13,"3,19"
14271,720575940628816683,right,T4d,390,-6,-9,1,-10,"-6,-9"
14272,720575940617092957,right,T4d,391,4,-3,-6,3,"4,-3"
14273,720575940626771528,right,T4d,392,-4,7,7,0,"-4,7"
14274,720575940640632528,right,T4d,393,-1,22,12,10,"-1,22"
14275,720575940639038798,right,T4d,394,-7,-8,3,-11,"-7,-8"
14276,720575940625396238,right,T4d,395,0,-22,-11,-11,"0,-22"
14277,720575940610793365,right,T4d,396,-1,10,6,4,"-1,10"
14278,720575940622498184,right,T4d,397,-3,-19,-7,-12,"-3,-19"
14279,720575940630269500,right,T4d,398,-3,22,14,8,"-3,22"
14280,720575940623096004,right,T4d,401,-2,-19,-8,-11,"-2,-19"
14281,720575940616947573,right,T4d,402,3,26,10,16,"3,26"
14282,720575940620553069,right,T4d,403,-2,-12,-4,-8,"-2,-12"
14283,720575940626507036,right,T4d,404,-1,20,11,9,"-1,20"
14284,720575940630108204,right,T4d,405,3,10,2,8,"3,10"
14285,720575940624187389,right,T4d,406,1,-25,-14,-11,"1,-25"
14286,720575940626019465,right,T4d,407,-5,-10,0,-10,"-5,-10"
14287,720575940625020820,right,T4d,408,-6,-4,4,-8,"-6,-4"
14288,720575940627263400,right,T4d,409,0,-3,-2,-1,"0,-3"
14289,720575940639659648,right,T4d,410,-2,-2,1,-3,"-2,-2"
14290,720575940611121506,right,T4d,411,-5,-19,-5,-14,"-5,-19"
14291,720575940632442828,right,T4d,412,-6,21,16,5,"-6,21"
14292,720575940608999363,right,T4d,413,-2,-7,-2,-5,"-2,-7"
14293,720575940623148936,right,T4d,414,4,21,6,15,"4,21"
14294,720575940632429416,right,T4d,415,6,12,0,12,"6,12"
14295,720575940626053936,right,T4d,416,3,-8,-7,-1,"3,-8"
14296,720575940620464832,right,T4d,417,-6,-10,1,-11,"-6,-10"
14297,720575940610345426,right,T4d,418,-2,15,9,6,"-2,15"
14298,720575940623021897,right,T4d,419,-3,-11,-3,-8,"-3,-11"
14299,720575940625066483,right,T4d,420,6,-3,-8,5,"6,-3"
14300,720575940632861267,right,T4d,421,-1,12,7,5,"-1,12"
14301,720575940623289187,right,T4d,422,-7,-4,5,-9,"-7,-4"
14302,720575940605446590,right,T4d,423,3,-18,-12,-6,"3,-18"
14303,720575940621380890,right,T4d,424,-3,-2,2,-4,"-3,-2"
14304,720575940620313873,right,T4d,425,3,20,7,13,"3,20"
14305,720575940612082090,right,T4d,426,-3,0,3,-3,"-3,0"
14306,720575940617936197,right,T4d,427,5,-18,-14,-4,"5,-18"
14307,720575940621236918,right,T4d,428,-2,23,13,10,"-2,23"
14308,720575940615524806,right,T4d,429,-2,14,9,5,"-2,14"
14309,720575940619376331,right,T4d,430,-3,-7,-1,-6,"-3,-7"
14310,720575940631251543,right,T4d,431,-2,-10,-3,-7,"-2,-10"
14311,720575940627471633,right,T4d,432,-5,7,8,-1,"-5,7"
14312,720575940620222811,right,T4d,433,0,-8,-4,-4,"0,-8"
14313,720575940627988123,right,T4d,434,-3,7,6,1,"-3,7"
14314,720575940609078723,right,T4d,435,5,-17,-14,-3,"5,-17"
14315,720575940637934682,right,T4d,436,0,-15,-8,-7,"0,-15"
14316,720575940630774376,right,T4d,437,-3,12,9,3,"-3,12"
14317,720575940626235180,right,T4d,438,2,27,11,16,"2,27"
14318,720575940636936282,right,T4d,439,-3,-9,-2,-7,"-3,-9"
14319,720575940619676269,right,T4d,440,1,23,10,13,"1,23"
14320,720575940620957643,right,T4d,441,3,-16,-11,-5,"3,-16"
14321,720575940610364228,right,T4d,442,-5,25,17,8,"-5,25"
14322,720575940629600812,right,T4d,443,-6,4,8,-4,"-6,4"
14323,720575940623788012,right,T4d,444,4,-10,-9,-1,"4,-10"
14324,720575940643696420,right,T4d,445,-2,8,6,2,"-2,8"
14325,720575940624883495,right,T4d,446,2,-14,-9,-5,"2,-14"
14326,720575940638025550,right,T4d,447,-1,2,2,0,"-1,2"
14327,720575940624683838,right,T4d,448,0,30,15,15,"0,30"
14328,720575940628997531,right,T4d,450,2,-9,-7,-2,"2,-9"
14329,720575940621478738,right,T4d,451,4,20,6,14,"4,20"
14330,720575940612065522,right,T4d,452,1,-9,-6,-3,"1,-9"
14331,720575940636307823,right,T4d,453,3,25,9,16,"3,25"
14332,720575940623949565,right,T4d,454,5,-12,-11,-1,"5,-12"
14333,720575940659978625,right,T4d,455,7,-7,-11,4,"7,-7"
14334,720575940617306324,right,T4d,456,0,21,10,11,"0,21"
14335,720575940629885696,right,T4d,457,-2,17,10,7,"-2,17"
14336,720575940632009908,right,T4d,458,5,0,-5,5,"5,0"
14337,720575940638107956,right,T4d,459,5,-3,-7,4,"5,-3"
14338,720575940624630252,right,T4d,460,-3,-20,-7,-13,"-3,-20"
14339,720575940639363491,right,T4d,461,7,-5,-10,5,"7,-5"
14340,720575940623345077,right,T4d,462,-1,18,10,8,"-1,18"
14341,720575940634237791,right,T4d,463,5,17,3,14,"5,17"
14342,720575940637247845,right,T4d,464,4,0,-4,4,"4,0"
14343,720575940631244306,right,T4d,465,3,0,-3,3,"3,0"
14344,720575940625995274,right,T4d,466,1,14,6,8,"1,14"
14345,720575940615363295,right,T4d,467,-2,-20,-8,-12,"-2,-20"
14346,720575940625956652,right,T4d,468,-3,11,8,3,"-3,11"
14347,720575940621626094,right,T4d,469,-7,13,13,0,"-7,13"
14348,720575940621231269,right,T4d,470,4,-9,-9,0,"4,-9"
14349,720575940610492484,right,T4d,471,3,-26,-16,-10,"3,-26"
14350,720575940636022903,right,T4d,472,1,25,11,14,"1,25"
14351,720575940631897362,right,T4d,473,-4,23,15,8,"-4,23"
14352,720575940623255254,right,T4d,475,-4,-1,3,-4,"-4,-1"
14353,720575940630070007,right,T4d,476,-1,15,8,7,"-1,15"
14354,720575940625952258,right,T4d,477,-3,2,4,-2,"-3,2"
14355,720575940627230750,right,T4d,478,-7,16,15,1,"-7,16"
14356,720575940625956140,right,T4d,479,-2,10,7,3,"-2,10"
14357,720575940639230067,right,T4d,480,3,-19,-13,-6,"3,-19"
14358,720575940619944363,right,T4d,481,4,-8,-8,0,"4,-8"
14359,720575940631010578,right,T4d,482,1,17,7,10,"1,17"
14360,720575940632114191,right,T4d,484,3,-9,-8,-1,"3,-9"
14361,720575940623999157,right,T4d,485,-3,-3,1,-4,"-3,-3"
14362,720575940619295983,right,T4d,486,0,1,0,1,"0,1"
14363,720575940621776645,right,T4d,487,1,-1,-2,1,"1,-1"
14364,720575940628017482,right,T4d,488,7,5,-5,10,"7,5"
14365,720575940627698947,right,T4d,489,-3,10,8,2,"-3,10"
14366,720575940630469699,right,T4d,490,-5,6,8,-2,"-5,6"
14367,720575940630020171,right,T4d,491,7,-1,-8,7,"7,-1"
14368,720575940632816813,right,T4d,492,-7,-2,6,-8,"-7,-2"
14369,720575940646760739,right,T4d,493,-3,23,14,9,"-3,23"
14370,720575940626869804,right,T4d,494,0,29,14,15,"0,29"
14371,720575940616303774,right,T4d,495,4,5,-2,7,"4,5"
14372,720575940616236446,right,T4d,496,7,8,-3,11,"7,8"
14373,720575940623237011,right,T4d,497,6,1,-6,7,"6,1"
14374,720575940641259995,right,T4d,498,6,10,-1,11,"6,10"
14375,720575940624203534,right,T4d,499,5,10,0,10,"5,10"
14376,720575940624858126,right,T4d,500,7,-8,-11,3,"7,-8"
14377,720575940625439560,right,T4d,501,1,2,0,2,"1,2"
14378,720575940626662686,right,T4d,502,5,8,-1,9,"5,8"
14379,720575940631887464,right,T4d,503,3,17,5,12,"3,17"
14380,720575940619166029,right,T4d,504,-2,9,6,3,"-2,9"
14381,720575940618283961,right,T4d,505,6,-22,-17,-5,"6,-22"
14382,720575940610532501,right,T4d,506,1,-12,-7,-5,"1,-12"
14383,720575940622218620,right,T4d,507,-5,-12,-1,-11,"-5,-12"
14384,720575940634195819,right,T4d,508,-5,11,10,1,"-5,11"
14385,720575940608253379,right,T4d,509,-4,10,9,1,"-4,10"
14386,720575940630566113,right,T4d,510,-2,11,7,4,"-2,11"
14387,720575940606071217,right,T4d,511,5,-11,-11,0,"5,-11"
14388,720575940631830083,right,T4d,512,6,0,-6,6,"6,0"
14389,720575940610735458,right,T4d,513,-4,-13,-3,-10,"-4,-13"
14390,720575940631444299,right,T4d,514,-4,-10,-1,-9,"-4,-10"
14391,720575940647839108,right,T4d,515,-8,-7,4,-11,"-8,-7"
14392,720575940617488641,right,T4d,517,6,3,-5,8,"6,3"
14393,720575940606319206,right,T4d,518,-4,22,15,7,"-4,22"
14394,720575940616664833,right,T4d,519,-5,-5,2,-7,"-5,-5"
14395,720575940617488852,right,T4d,520,-2,-22,-9,-13,"-2,-22"
14396,720575940632922835,right,T4d,521,6,-9,-11,2,"6,-9"
14397,720575940622877453,right,T4d,522,-4,0,4,-4,"-4,0"
14398,720575940634358196,right,T4d,523,2,14,5,9,"2,14"
14399,720575940609896459,right,T4d,524,4,-20,-14,-6,"4,-20"
14400,720575940617783809,right,T4d,525,-1,-20,-9,-11,"-1,-20"
14401,720575940619883073,right,T4d,526,0,-10,-5,-5,"0,-10"
14402,720575940622318174,right,T4d,527,-4,-8,0,-8,"-4,-8"
14403,720575940624334333,right,T4d,528,2,7,1,6,"2,7"
14404,720575940631027397,right,T4d,529,2,-2,-3,1,"2,-2"
14405,720575940623329279,right,T4d,530,-3,-13,-4,-9,"-3,-13"
14406,720575940610814328,right,T4d,531,1,0,-1,1,"1,0"
14407,720575940618720926,right,T4d,532,-8,7,11,-4,"-8,7"
14408,720575940610637266,right,T4d,533,0,-16,-8,-8,"0,-16"
14409,720575940639144125,right,T4d,534,3,2,-2,4,"3,2"
14410,720575940616658549,right,T4d,535,8,-4,-10,6,"8,-4"
14411,720575940625668878,right,T4d,536,3,4,-1,5,"3,4"
14412,720575940628523207,right,T4d,537,0,-23,-12,-11,"0,-23"
14413,720575940632922067,right,T4d,538,-4,1,4,-3,"-4,1"
14414,720575940640961269,right,T4d,539,-6,15,13,2,"-6,15"
14415,720575940629315995,right,T4d,540,-2,-9,-3,-6,"-2,-9"
14416,720575940635186839,right,T4d,541,-4,14,11,3,"-4,14"
14417,720575940615132738,right,T4d,542,6,-13,-13,0,"6,-13"
14418,720575940641672333,right,T4d,543,-1,-4,-1,-3,"-1,-4"
14419,720575940604567486,right,T4d,544,3,-13,-10,-3,"3,-13"
14420,720575940610428099,right,T4d,546,3,6,0,6,"3,6"
14421,720575940637060238,right,T4d,547,-1,21,11,10,"-1,21"
14422,720575940621317814,right,T4d,548,1,-16,-9,-7,"1,-16"
14423,720575940624067145,right,T4d,549,0,-9,-5,-4,"0,-9"
14424,720575940625075749,right,T4d,550,-2,3,3,0,"-2,3"
14425,720575940619984469,right,T4d,551,-4,-9,-1,-8,"-4,-9"
14426,720575940616649145,right,T4d,552,4,-1,-5,4,"4,-1"
14427,720575940621494256,right,T4d,553,-3,16,11,5,"-3,16"
14428,720575940626277434,right,T4d,555,-4,9,8,1,"-4,9"
14429,720575940623722510,right,T4d,556,0,10,5,5,"0,10"
14430,720575940612696854,right,T4d,557,6,-10,-11,1,"6,-10"
14431,720575940647797892,right,T4d,558,-4,-21,-7,-14,"-4,-21"
14432,720575940624463764,right,T4d,559,-6,22,17,5,"-6,22"
14433,720575940633293599,right,T4d,560,-7,14,14,0,"-7,14"
14434,720575940616420438,right,T4d,561,5,7,-2,9,"5,7"
14435,720575940618979402,right,T4d,562,-5,-2,4,-6,"-5,-2"
14436,720575940610481528,right,T4d,563,5,-13,-12,-1,"5,-13"
14437,720575940639846645,right,T4d,564,3,-23,-15,-8,"3,-23"
14438,720575940644426184,right,T4d,565,0,-26,-13,-13,"0,-26"
14439,720575940619885110,right,T4d,566,5,-8,-9,1,"5,-8"
14440,720575940614514444,right,T4d,567,-2,22,13,9,"-2,22"
14441,720575940638632538,right,T4d,568,-6,-8,2,-10,"-6,-8"
14442,720575940627702012,right,T4d,569,6,6,-3,9,"6,6"
14443,720575940622588893,right,T4d,570,2,25,10,15,"2,25"
14444,720575940622364492,right,T4d,571,0,-14,-7,-7,"0,-14"
14445,720575940636153486,right,T4d,572,-8,3,9,-6,"-8,3"
14446,720575940618727291,right,T4d,573,4,14,3,11,"4,14"
14447,720575940638352755,right,T4d,574,-6,5,8,-3,"-6,5"
14448,720575940622681215,right,T4d,575,6,9,-2,11,"6,9"
14449,720575940636603640,right,T4d,577,5,-14,-12,-2,"5,-14"
14450,720575940622200090,right,T4d,578,4,-11,-10,-1,"4,-11"
14451,720575940612401381,right,T4d,579,-3,-10,-2,-8,"-3,-10"
14452,720575940628621047,right,T4d,580,-2,-23,-10,-13,"-2,-23"
14453,720575940616424209,right,T4d,581,3,9,1,8,"3,9"
14454,720575940630298615,right,T4d,582,-1,23,12,11,"-1,23"
14455,720575940613665432,right,T4d,583,3,-25,-16,-9,"3,-25"
14456,720575940613113511,right,T4d,584,4,23,7,16,"4,23"
14457,720575940618251333,right,T4d,585,-1,-23,-11,-12,"-1,-23"
14458,720575940654702753,right,T4d,586,2,18,7,11,"2,18"
14459,720575940627747144,right,T4d,587,4,22,7,15,"4,22"
14460,720575940621347964,right,T4d,588,1,4,1,3,"1,4"
14461,720575940638006244,right,T4d,589,-1,-5,-2,-3,"-1,-5"
14462,720575940628630889,right,T4d,590,1,9,3,6,"1,9"
14463,720575940631656877,right,T4d,591,3,-3,-5,2,"3,-3"
14464,720575940622725756,right,T4d,592,3,-28,-17,-11,"3,-28"
14465,720575940622910744,right,T4d,593,3,-14,-10,-4,"3,-14"
14466,720575940620069712,right,T4d,595,7,-12,-13,1,"7,-12"
14467,720575940628942183,right,T4d,596,-4,-16,-4,-12,"-4,-16"
14468,720575940617483094,right,T4d,597,4,1,-4,5,"4,1"
14469,720575940612702515,right,T4d,598,2,-18,-11,-7,"2,-18"
14470,720575940627930011,right,T4d,599,-1,9,5,4,"-1,9"
14471,720575940620736704,right,T4d,600,3,-10,-8,-2,"3,-10"
14472,720575940630026770,right,T4d,601,1,16,7,9,"1,16"
14473,720575940637442630,right,T4d,602,4,-2,-5,3,"4,-2"
14474,720575940635193195,right,T4d,603,-3,-23,-9,-14,"-3,-23"
14475,720575940630936284,right,T4d,605,3,15,4,11,"3,15"
14476,720575940604699825,right,T4d,606,-1,-19,-9,-10,"-1,-19"
14477,720575940621114188,right,T4d,607,1,18,8,10,"1,18"
14478,720575940623261162,right,T4d,608,1,10,4,6,"1,10"
14479,720575940649653113,right,T4d,609,-2,0,2,-2,"-2,0"
14480,720575940629435497,right,T4d,610,2,-23,-14,-9,"2,-23"
14481,720575940626694599,right,T4d,611,-1,-18,-8,-10,"-1,-18"
14482,720575940634093675,right,T4d,612,-3,-26,-10,-16,"-3,-26"
14483,720575940627334500,right,T4d,613,-8,-4,6,-10,"-8,-4"
14484,720575940606786761,right,T4d,614,-2,-8,-2,-6,"-2,-8"
14485,720575940630911596,right,T4d,615,-7,-7,3,-10,"-7,-7"
14486,720575940639408243,right,T4d,616,-3,15,10,5,"-3,15"
14487,720575940628802320,right,T4d,617,-2,-17,-7,-10,"-2,-17"
14488,720575940612561381,right,T4d,619,-4,-19,-6,-13,"-4,-19"
14489,720575940632299212,right,T4d,620,7,1,-7,8,"7,1"
14490,720575940613975091,right,T4d,621,1,24,11,13,"1,24"
14491,720575940634862490,right,T4d,622,-5,20,15,5,"-5,20"
14492,720575940626429637,right,T4d,623,1,13,5,8,"1,13"
14493,720575940639683443,right,T4d,624,1,-17,-10,-7,"1,-17"
14494,720575940618703941,right,T4d,625,-2,24,14,10,"-2,24"
14495,720575940620369323,right,T4d,626,-5,-8,1,-9,"-5,-8"
14496,720575940622838525,right,T4d,627,0,-1,-1,0,"0,-1"
14497,720575940628943810,right,T4d,628,0,0,0,0,"0,0"
14498,720575940632393529,right,T4d,629,4,24,8,16,"4,24"
14499,720575940627024069,right,T4d,630,4,8,0,8,"4,8"
14500,720575940624673003,right,T4d,631,1,26,12,14,"1,26"
14501,720575940613218046,right,T4d,632,3,-20,-13,-7,"3,-20"
14502,720575940631732536,right,T4d,633,-1,-24,-11,-13,"-1,-24"
14503,720575940623830857,right,T4d,634,-3,-15,-5,-10,"-3,-15"
14504,720575940632394916,right,T4d,635,6,-6,-9,3,"6,-6"
14505,720575940604738737,right,T4d,636,0,6,3,3,"0,6"
14506,720575940620958959,right,T4d,637,3,-21,-14,-7,"3,-21"
14507,720575940637466846,right,T4d,638,-1,7,4,3,"-1,7"
14508,720575940619043413,right,T4d,639,-4,19,13,6,"-4,19"
14509,720575940637841897,right,T4d,640,-1,-16,-7,-9,"-1,-16"
14510,720575940628033788,right,T4d,642,-5,-11,-1,-10,"-5,-11"
14511,720575940617378833,right,T4d,643,6,14,1,13,"6,14"
14512,720575940629707628,right,T4d,644,-6,18,15,3,"-6,18"
14513,720575940647824004,right,T4d,645,-4,27,17,10,"-4,27"
14514,720575940635931243,right,T4d,646,6,17,2,15,"6,17"
14515,720575940629508347,right,T4d,647,-4,-7,0,-7,"-4,-7"
14516,720575940628676651,right,T4d,648,1,7,2,5,"1,7"
14517,720575940641537677,right,T4d,649,-1,5,3,2,"-1,5"
14518,720575940627541400,right,T4d,650,-3,-25,-10,-15,"-3,-25"
14519,720575940624945456,right,T4d,651,-4,-5,1,-6,"-4,-5"
14520,720575940629624407,right,T4d,652,-6,-11,0,-11,"-6,-11"
14521,720575940604652512,right,T4d,653,-6,-12,0,-12,"-6,-12"
14522,720575940629775311,right,T4d,654,-3,8,7,1,"-3,8"
14523,720575940635790644,right,T4d,655,6,-1,-7,6,"6,-1"
14524,720575940627423759,right,T4d,656,0,-11,-6,-5,"0,-11"
14525,720575940634279160,right,T4d,657,-2,-25,-11,-14,"-2,-25"
14526,720575940622232402,right,T4d,658,1,20,9,11,"1,20"
14527,720575940638498877,right,T4d,659,-4,-6,1,-7,"-4,-6"
14528,720575940634357343,right,T4d,660,2,28,12,16,"2,28"
14529,720575940642372493,right,T4d,661,-3,14,10,4,"-3,14"
14530,720575940637625434,right,T4d,662,2,-1,-3,2,"2,-1"
14531,720575940628668559,right,T4d,664,1,-27,-15,-12,"1,-27"
14532,720575940640894883,right,T4d,665,7,-2,-8,6,"7,-2"
14533,720575940630713081,right,T4d,666,7,-13,-14,1,"7,-13"
14534,720575940632049804,right,T4d,668,1,19,8,11,"1,19"
14535,720575940634480023,right,T4d,669,4,-16,-12,-4,"4,-16"
14536,720575940618069721,right,T4d,670,5,5,-3,8,"5,5"
14537,720575940621210795,right,T4d,671,-4,-23,-8,-15,"-4,-23"
14538,720575940649531513,right,T4d,672,-8,11,13,-2,"-8,11"
14539,720575940620255471,right,T4d,673,2,5,0,5,"2,5"
14540,720575940622079434,right,T4d,674,-4,-14,-3,-11,"-4,-14"
14541,720575940629766759,right,T4d,677,0,11,5,6,"0,11"
14542,720575940615918348,right,T4d,678,3,-7,-7,0,"3,-7"
14543,720575940618657403,right,T4d,679,4,18,5,13,"4,18"
14544,720575940632818910,right,T4d,680,-1,25,13,12,"-1,25"
14545,720575940629380222,right,T4d,681,-2,-21,-9,-12,"-2,-21"
14546,720575940611805589,right,T4d,682,6,-8,-10,2,"6,-8"
14547,720575940638575549,right,T4d,683,2,6,1,5,"2,6"
14548,720575940631012370,right,T4d,684,-6,17,14,3,"-6,17"
14549,720575940621272230,right,T4d,685,-5,-9,0,-9,"-5,-9"
14550,720575940615809211,right,T4d,686,5,-22,-16,-6,"5,-22"
14551,720575940620371371,right,T4d,687,-6,-3,4,-7,"-6,-3"
14552,720575940641399259,right,T4d,689,-2,18,11,7,"-2,18"
14553,720575940635373919,right,T4d,690,-7,-3,5,-8,"-7,-3"
14554,720575940628082025,right,T4d,691,-9,4,11,-7,"-9,4"
14555,720575940612993650,right,T4d,692,-4,24,16,8,"-4,24"
14556,720575940626449098,right,T4d,693,-3,25,15,10,"-3,25"
14557,720575940619810982,right,T4d,694,4,3,-3,6,"4,3"
14558,720575940619671125,right,T4d,695,-6,10,11,-1,"-6,10"
14559,720575940605181152,right,T4d,696,-2,16,10,6,"-2,16"
14560,720575940612249442,right,T4d,697,1,-22,-12,-10,"1,-22"
14561,720575940607662037,right,T4d,698,6,-7,-10,3,"6,-7"
14562,720575940627511528,right,T4d,699,-5,0,5,-5,"-5,0"
14563,720575940623345043,right,T4d,700,5,15,2,13,"5,15"
14564,720575940613965231,right,T4d,701,0,-4,-2,-2,"0,-4"
14565,720575940636945264,right,T4d,702,-5,23,16,7,"-5,23"
14566,720575940626581672,right,T4d,703,-3,1,3,-2,"-3,1"
14567,720575940622380509,right,T4d,704,-7,8,11,-3,"-7,8"
14568,720575940627476742,right,T4d,705,1,1,-1,2,"1,1"
14569,720575940612796330,right,T4d,707,-2,25,14,11,"-2,25"
14570,720575940633196591,right,T4d,708,-4,-25,-9,-16,"-4,-25"
14571,720575940617955073,right,T4d,709,-2,-24,-10,-14,"-2,-24"
14572,720575940609652548,right,T4d,710,4,-25,-17,-8,"4,-25"
14573,720575940622943314,right,T4d,711,-1,19,10,9,"-1,19"
14574,720575940633665049,right,T4d,712,-7,12,13,-1,"-7,12"
14575,720575940633071827,right,T4d,713,-6,16,14,2,"-6,16"
14576,720575940611938856,right,T4d,714,5,12,1,11,"5,12"
14577,720575940622527446,right,T4d,715,4,10,1,9,"4,10"
14578,720575940619966087,right,T4d,716,4,-6,-7,1,"4,-6"
14579,720575940629671294,right,T4d,717,2,-22,-13,-9,"2,-22"
14580,720575940630029131,right,T4d,718,-5,24,17,7,"-5,24"
14581,720575940612719090,right,T4d,719,1,27,12,15,"1,27"
14582,720575940620178256,right,T4d,720,-5,21,15,6,"-5,21"
14583,720575940628142086,right,T4d,721,5,13,1,12,"5,13"
14584,720575940625137934,right,T4d,722,6,-15,-14,-1,"6,-15"
14585,720575940638119613,right,T4d,723,-2,-11,-4,-7,"-2,-11"
14586,720575940627188241,right,T4d,724,4,2,-3,5,"4,2"
14587,720575940627343997,right,T4d,725,-3,-24,-9,-15,"-3,-24"
14588,720575940638252358,right,T4d,727,7,6,-4,10,"7,6"
14589,720575940638526948,right,T4d,728,7,12,-1,13,"7,12"
14590,720575940633170207,right,T4d,729,-3,29,17,12,"-3,29"
14591,720575940624663303,right,T4d,730,7,0,-7,7,"7,0"
14592,720575940623382506,right,T4d,731,-6,9,10,-1,"-6,9"
14593,720575940634957931,right,T4d,732,-3,6,6,0,"-3,6"
14594,720575940611540174,right,T4d,733,-5,-17,-4,-13,"-5,-17"
14595,720575940631481012,right,T4d,734,2,0,-2,2,"2,0"
14596,720575940617148219,right,T4d,735,1,-23,-13,-10,"1,-23"
14597,720575940640275920,right,T4d,736,-8,1,8,-7,"-8,1"
14598,720575940629598846,right,T4d,737,0,19,9,10,"0,19"
14599,720575940615798923,right,T4d,738,-3,13,9,4,"-3,13"
14600,720575940621600892,right,T4d,739,-7,2,8,-6,"-7,2"
14601,720575940632623943,right,T4d,740,2,-8,-6,-2,"2,-8"
14602,720575940617721172,right,T4d,741,-2,-14,-5,-9,"-2,-14"
14603,720575940627211353,right,T4d,742,-4,11,9,2,"-4,11"
14604,720575940627766268,right,T4d,743,6,-19,-16,-3,"6,-19"
14605,720575940646791971,right,T4d,744,-4,25,16,9,"-4,25"
14606,720575940615419442,right,T4d,745,0,13,6,7,"0,13"
14607,720575940637837658,right,T4d,746,-3,3,4,-1,"-3,3"
14608,720575940636091822,right,T4d,747,0,2,1,1,"0,2"
14609,720575940624109547,right,T4d,748,-4,20,14,6,"-4,20"
14610,720575940624172220,right,T4d,749,-2,1,2,-1,"-2,1"
14611,720575940620857453,right,T4d,751,1,6,2,4,"1,6"
14612,720575940623022005,right,T4d,752,-2,7,5,2,"-2,7"
14613,720575940646795299,right,T4d,753,-3,24,15,9,"-3,24"
14614,720575940630778981,right,T4d,754,-1,-13,-6,-7,"-1,-13"
14615,720575940641548685,right,T4d,755,4,19,5,14,"4,19"
14616,720575940616695579,right,T4d,756,5,20,5,15,"5,20"
14617,720575940628929079,right,T4d,757,0,-6,-3,-3,"0,-6"
14618,720575940640995573,right,T4d,758,5,-1,-6,5,"5,-1"
14619,720575940627443728,right,T4d,759,7,14,0,14,"7,14"
14620,720575940621792606,right,T4d,760,0,17,8,9,"0,17"
14621,720575940624229631,right,T4d,761,-4,-18,-5,-13,"-4,-18"
14622,720575940619453611,right,T4d,762,0,14,7,7,"0,14"
14623,720575940606642121,right,T4d,763,-5,14,12,2,"-5,14"
14624,720575940632576654,right,T4d,765,-3,9,7,2,"-3,9"
14625,720575940629334427,right,T4d,766,2,-4,-4,0,"2,-4"
14626,720575940635180695,right,T4d,767,1,28,13,15,"1,28"
14627,720575940606942130,right,T4d,768,3,5,-1,6,"3,5"
14628,720575940639681341,right,T4d,770,5,4,-3,7,"5,4"
14629,720575940632591683,right,T4d,771,3,-27,-17,-10,"3,-27"
14630,720575940610863150,right,T4d,772,1,12,5,7,"1,12"
14631,720575940618714235,right,T4d,773,5,-19,-15,-4,"5,-19"
14632,720575940617890132,right,T4d,775,5,22,6,16,"5,22"
14633,720575940631215353,right,T4d,776,5,21,5,16,"5,21"
14634,720575940618704453,right,T4d,778,4,25,8,17,"4,25"
14635,720575940627582525,right,T4d,780,-6,25,18,7,"-6,25"
14636,720575940645280023,right,T4d,781,-5,26,18,8,"-5,26"
14637,720575940633644174,right,T4d,782,-5,27,18,9,"-5,27"
14638,720575940625277740,right,T4d,783,-4,28,18,10,"-4,28"
14639,720575940647285812,right,T4d,784,-4,29,18,11,"-4,29"
14640,720575940612847018,right,T4d,785,-3,30,18,12,"-3,30"
14641,720575940615402914,right,T4d,786,-2,30,17,13,"-2,30"
14642,720575940626219564,right,T4d,787,3,28,11,17,"3,28"
14643,720575940614623430,right,T4d,788,3,27,10,17,"3,27"
14644,720575940638559295,right,T4d,790,-2,-27,-12,-15,"-2,-27"
14645,720575940635888180,right,T4d,792,8,2,-7,9,"8,2"
14646,720575940637657486,right,T4d,794,5,-26,-18,-8,"5,-26"
14647,720575940646769187,right,T4d,795,6,-21,-17,-4,"6,-21"
14648,720575940606236337,right,T4d,796,4,26,9,17,"4,26"
14649,720575940627648847,right,T5a,1,-6,13,12,1,"-6,13"
14650,720575940637988329,right,T5a,2,-8,2,9,-7,"-8,2"
14651,720575940615415263,right,T5a,3,6,-12,-12,0,"6,-12"
14652,720575940619977045,right,T5a,4,-5,-21,-6,-15,"-5,-21"
14653,720575940621841185,right,T5a,5,-1,16,9,7,"-1,16"
14654,720575940622671629,right,T5a,6,-2,-4,0,-4,"-2,-4"
14655,720575940626912275,right,T5a,7,-6,-6,3,-9,"-6,-6"
14656,720575940647817092,right,T5a,8,-4,26,17,9,"-4,26"
14657,720575940620279131,right,T5a,9,4,9,0,9,"4,9"
14658,720575940624909811,right,T5a,10,5,-15,-13,-2,"5,-15"
14659,720575940627960060,right,T5a,11,7,-14,-14,0,"7,-14"
14660,720575940629467262,right,T5a,12,-7,9,11,-2,"-7,9"
14661,720575940615408962,right,T5a,13,-1,-26,-12,-14,"-1,-26"
14662,720575940631883320,right,T5a,14,0,-27,-14,-13,"0,-27"
14663,720575940628008041,right,T5a,15,2,-3,-4,1,"2,-3"
14664,720575940610730082,right,T5a,16,-2,-16,-6,-10,"-2,-16"
14665,720575940633952869,right,T5a,17,1,-5,-4,-1,"1,-5"
14666,720575940620336475,right,T5a,19,-7,17,15,2,"-7,17"
14667,720575940614270673,right,T5a,20,3,-11,-9,-2,"3,-11"
14668,720575940629519486,right,T5a,21,-2,19,11,8,"-2,19"
14669,720575940626484361,right,T5a,22,-1,3,2,1,"-1,3"
14670,720575940629365612,right,T5a,23,-3,-16,-5,-11,"-3,-16"
14671,720575940621651658,right,T5a,24,-1,-10,-4,-6,"-1,-10"
14672,720575940627889095,right,T5a,25,-9,3,10,-7,"-9,3"
14673,720575940627203977,right,T5a,26,1,-3,-3,0,"1,-3"
14674,720575940640540891,right,T5a,27,0,-25,-13,-12,"0,-25"
14675,720575940617516985,right,T5a,28,5,6,-2,8,"5,6"
14676,720575940624436750,right,T5a,29,-1,-3,-1,-2,"-1,-3"
14677,720575940626993427,right,T5a,30,6,16,2,14,"6,16"
14678,720575940643399584,right,T5a,31,0,16,8,8,"0,16"
14679,720575940634622059,right,T5a,32,0,12,6,6,"0,12"
14680,720575940627479825,right,T5a,33,3,18,6,12,"3,18"
14681,720575940630756712,right,T5a,34,6,18,3,15,"6,18"
14682,720575940620734061,right,T5a,35,1,-24,-13,-11,"1,-24"
14683,720575940641368309,right,T5a,36,6,8,-2,10,"6,8"
14684,720575940640486133,right,T5a,37,1,5,1,4,"1,5"
14685,720575940626642698,right,T5a,38,0,-2,-1,-1,"0,-2"
14686,720575940626322988,right,T5a,39,0,20,10,10,"0,20"
14687,720575940621582794,right,T5a,40,-2,-6,-1,-5,"-2,-6"
14688,720575940627861521,right,T5a,41,-3,28,17,11,"-3,28"
14689,720575940636885823,right,T5a,42,-1,14,8,6,"-1,14"
14690,720575940621404144,right,T5a,43,-5,18,14,4,"-5,18"
14691,720575940636478063,right,T5a,44,5,-10,-10,0,"5,-10"
14692,720575940605374910,right,T5a,45,-5,-1,4,-5,"-5,-1"
14693,720575940624454743,right,T5a,46,-5,15,12,3,"-5,15"
14694,720575940602737598,right,T5a,48,-4,-22,-7,-15,"-4,-22"
14695,720575940636191845,right,T5a,49,4,-4,-6,2,"4,-4"
14696,720575940635302580,right,T5a,50,-2,21,12,9,"-2,21"
14697,720575940631671400,right,T5a,51,0,-19,-10,-9,"0,-19"
14698,720575940621708570,right,T5a,53,5,14,2,12,"5,14"
14699,720575940631163904,right,T5a,54,-4,3,5,-2,"-4,3"
14700,720575940628007015,right,T5a,55,-4,-11,-2,-9,"-4,-11"
14701,720575940645651252,right,T5a,56,1,-13,-8,-5,"1,-13"
14702,720575940627330063,right,T5a,57,6,-11,-12,1,"6,-11"
14703,720575940621597445,right,T5a,58,3,12,3,9,"3,12"
14704,720575940630262735,right,T5a,59,-2,2,3,-1,"-2,2"
14705,720575940625659066,right,T5a,61,-4,-4,2,-6,"-4,-4"
14706,720575940630805096,right,T5a,62,0,-29,-15,-14,"0,-29"
14707,720575940625507161,right,T5a,63,4,12,2,10,"4,12"
14708,720575940625272909,right,T5a,64,4,-23,-16,-7,"4,-23"
14709,720575940622409875,right,T5a,65,-1,28,15,13,"-1,28"
14710,720575940641424091,right,T5a,66,2,15,5,10,"2,15"
14711,720575940623124938,right,T5a,67,-2,-13,-5,-8,"-2,-13"
14712,720575940620068628,right,T5a,68,3,16,5,11,"3,16"
14713,720575940612353450,right,T5a,69,1,8,3,5,"1,8"
14714,720575940619988359,right,T5a,70,-4,21,14,7,"-4,21"
14715,720575940629833472,right,T5a,71,-2,-3,0,-3,"-2,-3"
14716,720575940605886338,right,T5a,72,0,-28,-14,-14,"0,-28"
14717,720575940626039068,right,T5a,73,2,2,-1,3,"2,2"
14718,720575940629838080,right,T5a,74,-1,-9,-4,-5,"-1,-9"
14719,720575940629424758,right,T5a,75,-6,14,13,1,"-6,14"
14720,720575940625645242,right,T5a,76,-3,-4,1,-5,"-3,-4"
14721,720575940614192790,right,T5a,77,2,-5,-5,0,"2,-5"
14722,720575940635736943,right,T5a,79,2,1,-2,3,"2,1"
14723,720575940628852891,right,T5a,80,4,13,2,11,"4,13"
14724,720575940632375379,right,T5a,81,6,-2,-7,5,"6,-2"
14725,720575940624700344,right,T5a,82,-7,7,10,-3,"-7,7"
14726,720575940616188021,right,T5a,83,2,-21,-13,-8,"2,-21"
14727,720575940624135688,right,T5a,84,-2,12,8,4,"-2,12"
14728,720575940620577360,right,T5a,85,4,-22,-15,-7,"4,-22"
14729,720575940608895427,right,T5a,86,-5,-7,1,-8,"-5,-7"
14730,720575940619558791,right,T5a,87,1,11,4,7,"1,11"
14731,720575940612577685,right,T5a,88,7,4,-5,9,"7,4"
14732,720575940611985331,right,T5a,89,1,-19,-11,-8,"1,-19"
14733,720575940623484679,right,T5a,90,-4,5,6,-1,"-4,5"
14734,720575940627676934,right,T5a,91,-1,6,4,2,"-1,6"
14735,720575940613351917,right,T5a,92,0,9,4,5,"0,9"
14736,720575940633160674,right,T5a,93,-6,3,7,-4,"-6,3"
14737,720575940617284130,right,T5a,94,5,18,4,14,"5,18"
14738,720575940632395859,right,T5a,96,1,-10,-6,-4,"1,-10"
14739,720575940617141204,right,T5a,97,-5,2,6,-4,"-5,2"
14740,720575940621852874,right,T5a,98,-1,-12,-5,-7,"-1,-12"
14741,720575940639159118,right,T5a,99,4,15,3,12,"4,15"
14742,720575940628299563,right,T5a,100,2,-10,-7,-3,"2,-10"
14743,720575940627951815,right,T5a,102,3,13,3,10,"3,13"
14744,720575940655100577,right,T5a,103,7,9,-3,12,"7,9"
14745,720575940604544358,right,T5a,104,-1,-27,-13,-14,"-1,-27"
14746,720575940626589768,right,T5a,105,3,22,8,14,"3,22"
14747,720575940627032197,right,T5a,106,-7,11,12,-1,"-7,11"
14748,720575940633415137,right,T5a,107,8,-2,-9,7,"8,-2"
14749,720575940632899501,right,T5a,108,-3,-12,-3,-9,"-3,-12"
14750,720575940614599234,right,T5a,109,4,-5,-7,2,"4,-5"
14751,720575940627289109,right,T5a,110,-7,0,7,-7,"-7,0"
14752,720575940621891964,right,T5a,111,2,-24,-14,-10,"2,-24"
14753,720575940620079808,right,T5a,112,-6,1,6,-5,"-6,1"
14754,720575940639447101,right,T5a,113,-2,4,4,0,"-2,4"
14755,720575940638280006,right,T5a,114,2,-13,-9,-4,"2,-13"
14756,720575940624683708,right,T5a,115,-4,2,5,-3,"-4,2"
14757,720575940623867115,right,T5a,116,-1,-8,-3,-5,"-1,-8"
14758,720575940626004170,right,T5a,117,-8,-2,7,-9,"-8,-2"
14759,720575940619937812,right,T5a,118,3,1,-3,4,"3,1"
14760,720575940633482777,right,T5a,119,-2,6,5,1,"-2,6"
14761,720575940630653515,right,T5a,120,-1,-1,0,-1,"-1,-1"
14762,720575940630651991,right,T5a,122,-5,9,9,0,"-5,9"
14763,720575940638036806,right,T5a,124,1,-7,-5,-2,"1,-7"
14764,720575940631550250,right,T5a,125,5,9,-1,10,"5,9"
14765,720575940624141803,right,T5a,126,3,11,2,9,"3,11"
14766,720575940609798130,right,T5a,127,0,15,7,8,"0,15"
14767,720575940599729862,right,T5a,129,0,-13,-7,-6,"0,-13"
14768,720575940616527633,right,T5a,130,2,12,4,8,"2,12"
14769,720575940628608003,right,T5a,131,-6,20,16,4,"-6,20"
14770,720575940629369722,right,T5a,132,2,4,0,4,"2,4"
14771,720575940622137164,right,T5a,133,-3,20,13,7,"-3,20"
14772,720575940624715557,right,T5a,135,-3,-22,-8,-14,"-3,-22"
14773,720575940619450701,right,T5a,136,0,3,1,2,"0,3"
14774,720575940633801573,right,T5a,137,5,-7,-9,2,"5,-7"
14775,720575940627464220,right,T5a,138,0,27,13,14,"0,27"
14776,720575940622276106,right,T5a,139,1,-14,-8,-6,"1,-14"
14777,720575940622675753,right,T5a,140,3,8,1,7,"3,8"
14778,720575940622498952,right,T5a,142,-2,-18,-7,-11,"-2,-18"
14779,720575940614829718,right,T5a,143,-4,16,12,4,"-4,16"
14780,720575940627364623,right,T5a,144,7,-11,-13,2,"7,-11"
14781,720575940627354696,right,T5a,145,0,4,2,2,"0,4"
14782,720575940613976482,right,T5a,146,1,-6,-4,-2,"1,-6"
14783,720575940623880119,right,T5a,147,1,21,9,12,"1,21"
14784,720575940636224107,right,T5a,148,-7,-11,1,-12,"-7,-11"
14785,720575940615147571,right,T5a,149,6,-14,-13,-1,"6,-14"
14786,720575940632124975,right,T5a,150,-8,5,10,-5,"-8,5"
14787,720575940618752853,right,T5a,151,-3,-14,-4,-10,"-3,-14"
14788,720575940608386827,right,T5a,152,3,-15,-11,-4,"3,-15"
14789,720575940631130655,right,T5a,153,8,0,-8,8,"8,0"
14790,720575940619916564,right,T5a,154,-8,0,8,-8,"-8,0"
14791,720575940634103777,right,T5a,156,-9,1,9,-8,"-9,1"
14792,720575940617196759,right,T5a,157,-1,-7,-3,-4,"-1,-7"
14793,720575940621431028,right,T5a,158,3,-5,-6,1,"3,-5"
14794,720575940618493509,right,T5a,159,7,7,-4,11,"7,7"
14795,720575940623433772,right,T5a,160,-2,20,12,8,"-2,20"
14796,720575940621469052,right,T5a,161,4,-14,-11,-3,"4,-14"
14797,720575940615618354,right,T5a,162,-4,-2,3,-5,"-4,-2"
14798,720575940613543314,right,T5a,164,-1,-2,0,-2,"-1,-2"
14799,720575940629829687,right,T5a,165,4,16,4,12,"4,16"
14800,720575940616580865,right,T5a,166,0,18,9,9,"0,18"
14801,720575940622363341,right,T5a,167,0,-17,-9,-8,"0,-17"
14802,720575940629107984,right,T5a,168,-1,17,9,8,"-1,17"
14803,720575940628569538,right,T5a,169,0,-18,-9,-9,"0,-18"
14804,720575940646090787,right,T5a,170,-5,1,5,-4,"-5,1"
14805,720575940621438964,right,T5a,171,6,-20,-16,-4,"6,-20"
14806,720575940622389430,right,T5a,172,1,22,10,12,"1,22"
14807,720575940627075721,right,T5a,173,2,-25,-15,-10,"2,-25"
14808,720575940634733722,right,T5a,174,4,-15,-12,-3,"4,-15"
14809,720575940603373916,right,T5a,175,-6,-7,2,-9,"-6,-7"
14810,720575940636935390,right,T5a,176,-2,13,8,5,"-2,13"
14811,720575940630145500,right,T5a,177,-2,-1,1,-2,"-2,-1"
14812,720575940628977018,right,T5a,178,2,11,3,8,"2,11"
14813,720575940627621909,right,T5a,179,-5,-16,-3,-13,"-5,-16"
14814,720575940623025944,right,T5a,180,2,-27,-16,-11,"2,-27"
14815,720575940625076880,right,T5a,181,1,-4,-3,-1,"1,-4"
14816,720575940612051825,right,T5a,182,7,-10,-12,2,"7,-10"
14817,720575940626520540,right,T5a,183,-5,-15,-3,-12,"-5,-15"
14818,720575940612761523,right,T5a,184,-6,-5,3,-8,"-6,-5"
14819,720575940627159685,right,T5a,185,2,-11,-8,-3,"2,-11"
14820,720575940612621530,right,T5a,186,-1,26,14,12,"-1,26"
14821,720575940623669036,right,T5a,187,3,21,7,14,"3,21"
14822,720575940625571465,right,T5a,188,-5,17,13,4,"-5,17"
14823,720575940638088026,right,T5a,189,6,13,0,13,"6,13"
14824,720575940621608481,right,T5a,190,-3,-5,0,-5,"-3,-5"
14825,720575940618069077,right,T5a,191,-1,-11,-5,-6,"-1,-11"
14826,720575940631101215,right,T5a,192,7,10,-2,12,"7,10"
14827,720575940625779898,right,T5a,193,-5,4,7,-3,"-5,4"
14828,720575940624362988,right,T5a,194,0,-5,-3,-2,"0,-5"
14829,720575940617462502,right,T5a,195,-3,-1,2,-3,"-3,-1"
14830,720575940624719818,right,T5a,196,-1,8,5,3,"-1,8"
14831,720575940640909520,right,T5a,198,6,2,-5,7,"6,2"
14832,720575940614223010,right,T5a,199,0,-12,-6,-6,"0,-12"
14833,720575940635282868,right,T5a,200,-5,12,11,1,"-5,12"
14834,720575940630306767,right,T5a,202,-1,27,14,13,"-1,27"
14835,720575940626813577,right,T5a,203,3,-1,-4,3,"3,-1"
14836,720575940624267338,right,T5a,204,5,-2,-6,4,"5,-2"
14837,720575940639634083,right,T5a,205,5,-6,-8,2,"5,-6"
14838,720575940642568608,right,T5a,206,-3,5,5,0,"-3,5"
14839,720575940628282170,right,T5a,207,1,29,13,16,"1,29"
14840,720575940631650664,right,T5a,208,5,-21,-16,-5,"5,-21"
14841,720575940623864759,right,T5a,209,-3,-8,-1,-7,"-3,-8"
14842,720575940606417609,right,T5a,210,-6,8,10,-2,"-6,8"
14843,720575940628653415,right,T5a,211,-7,-1,6,-7,"-7,-1"
14844,720575940620550004,right,T5a,212,2,-16,-10,-6,"2,-16"
14845,720575940630363387,right,T5a,213,3,-4,-5,1,"3,-4"
14846,720575940627478760,right,T5a,214,-5,3,6,-3,"-5,3"
14847,720575940620544096,right,T5a,215,6,7,-3,10,"6,7"
14848,720575940629759788,right,T5a,216,2,19,7,12,"2,19"
14849,720575940612337893,right,T5a,217,6,15,1,14,"6,15"
14850,720575940623943403,right,T5a,218,2,10,3,7,"2,10"
14851,720575940605413129,right,T5a,219,6,-4,-8,4,"6,-4"
14852,720575940627250436,right,T5a,220,2,-6,-5,-1,"2,-6"
14853,720575940621307887,right,T5a,221,-7,3,8,-5,"-7,3"
14854,720575940631705807,right,T5a,222,-3,26,16,10,"-3,26"
14855,720575940640749520,right,T5a,223,-2,26,15,11,"-2,26"
14856,720575940606864514,right,T5a,224,0,5,2,3,"0,5"
14857,720575940613545768,right,T5a,225,2,-26,-15,-11,"2,-26"
14858,720575940623194406,right,T5a,226,5,19,4,15,"5,19"
14859,720575940626805129,right,T5a,227,-7,5,9,-4,"-7,5"
14860,720575940619923476,right,T5a,228,-7,1,7,-6,"-7,1"
14861,720575940634736535,right,T5a,229,5,2,-4,6,"5,2"
14862,720575940631227434,right,T5a,230,2,9,2,7,"2,9"
14863,720575940631781736,right,T5a,231,4,-12,-10,-2,"4,-12"
14864,720575940630387318,right,T5a,232,-4,13,10,3,"-4,13"
14865,720575940644394400,right,T5a,233,4,-13,-11,-2,"4,-13"
14866,720575940623952381,right,T5a,234,1,3,0,3,"1,3"
14867,720575940621236556,right,T5a,235,4,11,1,10,"4,11"
14868,720575940611937266,right,T5a,236,-1,4,3,1,"-1,4"
14869,720575940636087732,right,T5a,237,-2,27,15,12,"-2,27"
14870,720575940642209421,right,T5a,238,-8,-3,6,-9,"-8,-3"
14871,720575940603761836,right,T5a,239,-6,6,9,-3,"-6,6"
14872,720575940623118374,right,T5a,240,-4,-3,2,-5,"-4,-3"
14873,720575940620611009,right,T5a,241,2,-17,-11,-6,"2,-17"
14874,720575940634759066,right,T5a,242,-4,6,7,-1,"-4,6"
14875,720575940621005421,right,T5a,243,-1,-21,-10,-11,"-1,-21"
14876,720575940614660829,right,T5a,244,-4,-12,-2,-10,"-4,-12"
14877,720575940624229384,right,T5a,245,-5,-3,3,-6,"-5,-3"
14878,720575940608667605,right,T5a,246,-4,15,11,4,"-4,15"
14879,720575940616024866,right,T5a,247,-4,-15,-4,-11,"-4,-15"
14880,720575940631947079,right,T5a,249,2,-12,-8,-4,"2,-12"
14881,720575940627483335,right,T5a,250,-1,1,1,0,"-1,1"
14882,720575940620179137,right,T5a,251,-1,-14,-6,-8,"-1,-14"
14883,720575940615451551,right,T5a,252,3,23,8,15,"3,23"
14884,720575940616649617,right,T5a,253,5,16,3,13,"5,16"
14885,720575940614743505,right,T5a,254,3,-24,-15,-9,"3,-24"
14886,720575940606534601,right,T5a,255,-6,-13,-1,-12,"-6,-13"
14887,720575940646172963,right,T5a,256,5,-20,-15,-5,"5,-20"
14888,720575940625782116,right,T5a,257,2,21,8,13,"2,21"
14889,720575940632600680,right,T5a,258,-4,-17,-5,-12,"-4,-17"
14890,720575940635003799,right,T5a,259,-7,-5,4,-9,"-7,-5"
14891,720575940620350191,right,T5a,260,-3,19,12,7,"-3,19"
14892,720575940615136322,right,T5a,261,-1,13,7,6,"-1,13"
14893,720575940630084316,right,T5a,262,1,-11,-7,-4,"1,-11"
14894,720575940654245793,right,T5a,263,-3,4,5,-1,"-3,4"
14895,720575940615073503,right,T5a,264,-1,-6,-2,-4,"-1,-6"
14896,720575940630250092,right,T5a,265,-6,-1,5,-6,"-6,-1"
14897,720575940630578294,right,T5a,266,-1,-25,-12,-13,"-1,-25"
14898,720575940633656345,right,T5a,267,-6,2,7,-5,"-6,2"
14899,720575940620591454,right,T5a,268,7,-6,-10,4,"7,-6"
14900,720575940613606013,right,T5a,269,2,-19,-12,-7,"2,-19"
14901,720575940637533581,right,T5a,270,1,-8,-5,-3,"1,-8"
14902,720575940617304788,right,T5a,271,4,6,-1,7,"4,6"
14903,720575940643436960,right,T5a,272,3,-2,-4,2,"3,-2"
14904,720575940623180326,right,T5a,273,-6,23,17,6,"-6,23"
14905,720575940626711941,right,T5a,274,6,4,-4,8,"6,4"
14906,720575940630451543,right,T5a,275,-8,-1,7,-8,"-8,-1"
14907,720575940629060170,right,T5a,276,2,3,-1,4,"2,3"
14908,720575940633410199,right,T5a,277,7,-3,-9,6,"7,-3"
14909,720575940620049573,right,T5a,278,-5,10,10,0,"-5,10"
14910,720575940631900044,right,T5a,279,-4,8,8,0,"-4,8"
14911,720575940639165885,right,T5a,280,-6,-14,-1,-13,"-6,-14"
14912,720575940628445327,right,T5a,282,0,26,13,13,"0,26"
14913,720575940620421614,right,T5a,283,-4,4,6,-2,"-4,4"
14914,720575940625654759,right,T5a,284,0,25,12,13,"0,25"
14915,720575940631632440,right,T5a,286,0,-24,-12,-12,"0,-24"
14916,720575940619707842,right,T5a,287,-5,13,11,2,"-5,13"
14917,720575940641922805,right,T5a,288,-1,30,16,14,"-1,30"
14918,720575940631481593,right,T5a,289,-1,11,6,5,"-1,11"
14919,720575940620747355,right,T5a,290,5,-24,-17,-7,"5,-24"
14920,720575940631911235,right,T5a,291,7,2,-6,8,"7,2"
14921,720575940624722731,right,T5a,292,-4,18,13,5,"-4,18"
14922,720575940619511243,right,T5a,293,4,-17,-13,-4,"4,-17"
14923,720575940623627559,right,T5a,294,1,-20,-11,-9,"1,-20"
14924,720575940608729097,right,T5a,296,1,-18,-10,-8,"1,-18"
14925,720575940639650126,right,T5a,297,7,-9,-12,3,"7,-9"
14926,720575940618642998,right,T5a,298,-5,5,7,-2,"-5,5"
14927,720575940614403218,right,T5a,299,-4,12,10,2,"-4,12"
14928,720575940628076288,right,T5a,300,4,-18,-13,-5,"4,-18"
14929,720575940621121462,right,T5a,301,-5,16,13,3,"-5,16"
14930,720575940620991329,right,T5a,302,2,17,6,11,"2,17"
14931,720575940616716427,right,T5a,303,-5,22,16,6,"-5,22"
14932,720575940609009877,right,T5a,304,6,5,-4,9,"6,5"
14933,720575940627039242,right,T5a,305,-7,4,9,-5,"-7,4"
14934,720575940632293580,right,T5a,306,3,7,0,7,"3,7"
14935,720575940619686360,right,T5a,307,5,-25,-18,-7,"5,-25"
14936,720575940626263634,right,T5a,308,-5,8,9,-1,"-5,8"
14937,720575940636782704,right,T5a,309,-6,12,12,0,"-6,12"
14938,720575940619847757,right,T5a,310,2,22,9,13,"2,22"
14939,720575940613709352,right,T5a,311,-7,15,14,1,"-7,15"
14940,720575940643519648,right,T5a,312,4,-7,-8,1,"4,-7"
14941,720575940627370664,right,T5a,313,7,3,-6,9,"7,3"
14942,720575940627834088,right,T5a,314,-9,5,11,-6,"-9,5"
14943,720575940623674807,right,T5a,315,-3,-6,0,-6,"-3,-6"
14944,720575940630784599,right,T5a,316,5,-4,-7,3,"5,-4"
14945,720575940621642010,right,T5a,317,-5,-4,3,-7,"-5,-4"
14946,720575940621127851,right,T5a,318,4,-19,-14,-5,"4,-19"
14947,720575940629860608,right,T5a,319,-2,5,4,1,"-2,5"
14948,720575940627768775,right,T5a,320,-2,-5,-1,-4,"-2,-5"
14949,720575940640074624,right,T5a,321,8,4,-6,10,"8,4"
14950,720575940621183508,right,T5a,322,2,26,11,15,"2,26"
14951,720575940643674312,right,T5a,324,3,24,9,15,"3,24"
14952,720575940600150793,right,T5a,325,5,1,-5,6,"5,1"
14953,720575940622818184,right,T5a,326,2,16,6,10,"2,16"
14954,720575940609226453,right,T5a,327,5,3,-4,7,"5,3"
14955,720575940608724163,right,T5a,328,5,-9,-10,1,"5,-9"
14956,720575940626820538,right,T5a,329,0,24,12,12,"0,24"
14957,720575940609896750,right,T5a,330,3,3,-2,5,"3,3"
14958,720575940599704006,right,T5a,331,1,-15,-9,-6,"1,-15"
14959,720575940607114882,right,T5a,332,4,-26,-17,-9,"4,-26"
14960,720575940613733860,right,T5a,333,0,-21,-11,-10,"0,-21"
14961,720575940629950482,right,T5a,334,1,-26,-14,-12,"1,-26"
14962,720575940632661452,right,T5a,335,2,8,2,6,"2,8"
14963,720575940626365005,right,T5a,336,0,23,11,12,"0,23"
14964,720575940610555204,right,T5a,337,-5,-6,2,-8,"-5,-6"
14965,720575940629425602,right,T5a,338,-1,0,1,-1,"-1,0"
14966,720575940620447623,right,T5a,339,6,11,-1,12,"6,11"
14967,720575940614260734,right,T5a,340,-4,17,12,5,"-4,17"
14968,720575940625124360,right,T5a,341,6,-17,-15,-2,"6,-17"
14969,720575940622366218,right,T5a,342,2,-15,-10,-5,"2,-15"
14970,720575940627576125,right,T5a,343,-3,27,16,11,"-3,27"
14971,720575940632462244,right,T5a,344,-2,-15,-6,-9,"-2,-15"
14972,720575940625619493,right,T5a,345,3,-12,-9,-3,"3,-12"
14973,720575940624525715,right,T5a,346,-7,-9,2,-11,"-7,-9"
14974,720575940626217093,right,T5a,347,-5,-13,-2,-11,"-5,-13"
14975,720575940611491555,right,T5a,348,3,14,4,10,"3,14"
14976,720575940632033298,right,T5a,349,-5,-14,-2,-12,"-5,-14"
14977,720575940649446777,right,T5a,350,1,15,6,9,"1,15"
14978,720575940622029150,right,T5a,351,-1,-17,-8,-9,"-1,-17"
14979,720575940631750671,right,T5a,352,-2,28,16,12,"-2,28"
14980,720575940626951468,right,T5a,353,2,24,10,14,"2,24"
14981,720575940636405349,right,T5a,354,-2,-26,-11,-15,"-2,-26"
14982,720575940626667928,right,T5a,355,-7,-6,4,-10,"-7,-6"
14983,720575940616917516,right,T5a,356,0,22,11,11,"0,22"
14984,720575940620961974,right,T5a,357,4,17,4,13,"4,17"
14985,720575940629924924,right,T5a,358,-3,17,11,6,"-3,17"
14986,720575940631520056,right,T5a,359,2,23,9,14,"2,23"
14987,720575940647270276,right,T5a,360,-5,19,14,5,"-5,19"
14988,720575940637531277,right,T5a,361,0,-7,-4,-3,"0,-7"
14989,720575940612371351,right,T5a,362,2,-20,-12,-8,"2,-20"
14990,720575940616231641,right,T5a,363,7,-4,-9,5,"7,-4"
14991,720575940628016970,right,T5a,364,4,4,-2,6,"4,4"
14992,720575940617180857,right,T5a,365,4,7,-1,8,"4,7"
14993,720575940631139072,right,T5a,367,-6,-15,-2,-13,"-6,-15"
14994,720575940602577598,right,T5a,368,-4,-20,-6,-14,"-4,-20"
14995,720575940617572609,right,T5a,369,5,-5,-8,3,"5,-5"
14996,720575940646265635,right,T5a,370,-3,21,13,8,"-3,21"
14997,720575940620034932,right,T5a,371,6,-5,-9,4,"6,-5"
14998,720575940626516757,right,T5a,372,1,-2,-2,0,"1,-2"
14999,720575940637976922,right,T5a,373,1,-21,-12,-9,"1,-21"
15000,720575940627043736,right,T5a,374,2,13,4,9,"2,13"
15001,720575940618717819,right,T5a,375,-6,7,9,-2,"-6,7"
15002,720575940615067067,right,T5a,377,0,7,3,4,"0,7"
15003,720575940631651641,right,T5a,378,-3,18,12,6,"-3,18"
15004,720575940613940703,right,T5a,379,3,-17,-12,-5,"3,-17"
15005,720575940636090548,right,T5a,380,-1,29,15,14,"-1,29"
15006,720575940622493320,right,T5a,382,3,-6,-6,0,"3,-6"
15007,720575940638363206,right,T5a,383,-6,11,11,0,"-6,11"
15008,720575940627420303,right,T5a,384,-6,-2,5,-7,"-6,-2"
15009,720575940642008205,right,T5a,385,-3,-18,-6,-12,"-3,-18"
15010,720575940615301023,right,T5a,386,-6,19,15,4,"-6,19"
15011,720575940626099970,right,T5a,387,-1,-15,-7,-8,"-1,-15"
15012,720575940637721919,right,T5a,388,3,19,6,13,"3,19"
15013,720575940625490234,right,T5a,390,-6,-9,1,-10,"-6,-9"
15014,720575940622786840,right,T5a,391,4,-3,-6,3,"4,-3"
15015,720575940626553177,right,T5a,392,-4,7,7,0,"-4,7"
15016,720575940617762049,right,T5a,393,-1,22,12,10,"-1,22"
15017,720575940629134844,right,T5a,394,-7,-8,3,-11,"-7,-8"
15018,720575940628095484,right,T5a,395,0,-22,-11,-11,"0,-22"
15019,720575940621909213,right,T5a,396,-1,10,6,4,"-1,10"
15020,720575940627535047,right,T5a,397,-3,-19,-7,-12,"-3,-19"
15021,720575940624669621,right,T5a,398,-3,22,14,8,"-3,22"
15022,720575940611397474,right,T5a,400,1,-29,-16,-13,"1,-29"
15023,720575940618832720,right,T5a,401,-2,-19,-8,-11,"-2,-19"
15024,720575940619831117,right,T5a,402,3,26,10,16,"3,26"
15025,720575940625512848,right,T5a,403,-2,-12,-4,-8,"-2,-12"
15026,720575940617322304,right,T5a,404,-1,20,11,9,"-1,20"
15027,720575940629631735,right,T5a,405,3,10,2,8,"3,10"
15028,720575940612379287,right,T5a,406,1,-25,-14,-11,"1,-25"
15029,720575940638102640,right,T5a,407,-5,-10,0,-10,"-5,-10"
15030,720575940628898860,right,T5a,408,-6,-4,4,-8,"-6,-4"
15031,720575940624561127,right,T5a,409,0,-3,-2,-1,"0,-3"
15032,720575940638947150,right,T5a,410,-2,-2,1,-3,"-2,-2"
15033,720575940644837143,right,T5a,411,-5,-19,-5,-14,"-5,-19"
15034,720575940626727966,right,T5a,413,-2,-7,-2,-5,"-2,-7"
15035,720575940618658171,right,T5a,414,4,21,6,15,"4,21"
15036,720575940633685146,right,T5a,415,6,12,0,12,"6,12"
15037,720575940612370069,right,T5a,416,3,-8,-7,-1,"3,-8"
15038,720575940621261744,right,T5a,417,-6,-10,1,-11,"-6,-10"
15039,720575940606727042,right,T5a,418,-2,15,9,6,"-2,15"
15040,720575940621971276,right,T5a,419,-3,-11,-3,-8,"-3,-11"
15041,720575940614283935,right,T5a,420,6,-3,-8,5,"6,-3"
15042,720575940654390689,right,T5a,421,-1,12,7,5,"-1,12"
15043,720575940615700492,right,T5a,422,-7,-4,5,-9,"-7,-4"
15044,720575940631561272,right,T5a,423,3,-18,-12,-6,"3,-18"
15045,720575940627896326,right,T5a,424,-3,-2,2,-4,"-3,-2"
15046,720575940624486032,right,T5a,425,3,20,7,13,"3,20"
15047,720575940620869040,right,T5a,426,-3,0,3,-3,"-3,0"
15048,720575940616917772,right,T5a,428,-2,23,13,10,"-2,23"
15049,720575940611790193,right,T5a,429,-2,14,9,5,"-2,14"
15050,720575940622236381,right,T5a,430,-3,-7,-1,-6,"-3,-7"
15051,720575940629436030,right,T5a,431,-2,-10,-3,-7,"-2,-10"
15052,720575940630009047,right,T5a,432,-5,7,8,-1,"-5,7"
15053,720575940632197407,right,T5a,433,0,-8,-4,-4,"0,-8"
15054,720575940612249698,right,T5a,434,-3,7,6,1,"-3,7"
15055,720575940634690411,right,T5a,435,5,-17,-14,-3,"5,-17"
15056,720575940624079624,right,T5a,436,0,-15,-8,-7,"0,-15"
15057,720575940610723026,right,T5a,437,-3,12,9,3,"-3,12"
15058,720575940626995998,right,T5a,438,2,27,11,16,"2,27"
15059,720575940648482937,right,T5a,439,-3,-9,-2,-7,"-3,-9"
15060,720575940629859663,right,T5a,440,1,23,10,13,"1,23"
15061,720575940615327197,right,T5a,441,3,-16,-11,-5,"3,-16"
15062,720575940622413055,right,T5a,442,-5,25,17,8,"-5,25"
15063,720575940630723685,right,T5a,444,4,-10,-9,-1,"4,-10"
15064,720575940615467682,right,T5a,445,-2,8,6,2,"-2,8"
15065,720575940621729374,right,T5a,447,-1,2,2,0,"-1,2"
15066,720575940643168909,right,T5a,448,0,30,15,15,"0,30"
15067,720575940632628684,right,T5a,449,6,-16,-14,-2,"6,-16"
15068,720575940630083706,right,T5a,450,2,-9,-7,-2,"2,-9"
15069,720575940629598658,right,T5a,451,4,20,6,14,"4,20"
15070,720575940638331718,right,T5a,452,1,-9,-6,-3,"1,-9"
15071,720575940616122674,right,T5a,453,3,25,9,16,"3,25"
15072,720575940614271185,right,T5a,454,5,-12,-11,-1,"5,-12"
15073,720575940620881226,right,T5a,455,7,-7,-11,4,"7,-7"
15074,720575940638886628,right,T5a,456,0,21,10,11,"0,21"
15075,720575940638442328,right,T5a,457,-2,17,10,7,"-2,17"
15076,720575940623372874,right,T5a,458,5,0,-5,5,"5,0"
15077,720575940618009318,right,T5a,459,5,-3,-7,4,"5,-3"
15078,720575940624217319,right,T5a,460,-3,-20,-7,-13,"-3,-20"
15079,720575940634482272,right,T5a,461,7,-5,-10,5,"7,-5"
15080,720575940628403194,right,T5a,462,-1,18,10,8,"-1,18"
15081,720575940631469931,right,T5a,463,5,17,3,14,"5,17"
15082,720575940621357552,right,T5a,464,4,0,-4,4,"4,0"
15083,720575940621910772,right,T5a,465,3,0,-3,3,"3,0"
15084,720575940654695841,right,T5a,466,1,14,6,8,"1,14"
15085,720575940614663530,right,T5a,467,-2,-20,-8,-12,"-2,-20"
15086,720575940616568577,right,T5a,468,-3,11,8,3,"-3,11"
15087,720575940629886524,right,T5a,469,-7,13,13,0,"-7,13"
15088,720575940615355754,right,T5a,470,4,-9,-9,0,"4,-9"
15089,720575940636516526,right,T5a,471,3,-26,-16,-10,"3,-26"
15090,720575940620734958,right,T5a,472,1,25,11,14,"1,25"
15091,720575940629569218,right,T5a,473,-4,23,15,8,"-4,23"
15092,720575940606681278,right,T5a,474,-3,-17,-6,-11,"-3,-17"
15093,720575940631929647,right,T5a,475,-4,-1,3,-4,"-4,-1"
15094,720575940627471503,right,T5a,476,-1,15,8,7,"-1,15"
15095,720575940614162338,right,T5a,477,-3,2,4,-2,"-3,2"
15096,720575940626440025,right,T5a,479,-2,10,7,3,"-2,10"
15097,720575940634061419,right,T5a,480,3,-19,-13,-6,"3,-19"
15098,720575940622265932,right,T5a,481,4,-8,-8,0,"4,-8"
15099,720575940634846815,right,T5a,482,1,17,7,10,"1,17"
15100,720575940621325594,right,T5a,483,2,-7,-6,-1,"2,-7"
15101,720575940627159429,right,T5a,484,3,-9,-8,-1,"3,-9"
15102,720575940622108584,right,T5a,485,-3,-3,1,-4,"-3,-3"
15103,720575940620995766,right,T5a,486,0,1,0,1,"0,1"
15104,720575940629534012,right,T5a,487,1,-1,-2,1,"1,-1"
15105,720575940632109855,right,T5a,488,7,5,-5,10,"7,5"
15106,720575940612605462,right,T5a,489,-3,10,8,2,"-3,10"
15107,720575940631809091,right,T5a,491,7,-1,-8,7,"7,-1"
15108,720575940617789524,right,T5a,492,-7,-2,6,-8,"-7,-2"
15109,720575940620136613,right,T5a,493,-3,23,14,9,"-3,23"
15110,720575940643169933,right,T5a,494,0,29,14,15,"0,29"
15111,720575940615730875,right,T5a,496,7,8,-3,11,"7,8"
15112,720575940635121818,right,T5a,497,6,1,-6,7,"6,1"
15113,720575940626447813,right,T5a,498,6,10,-1,11,"6,10"
15114,720575940620767329,right,T5a,499,5,10,0,10,"5,10"
15115,720575940630706302,right,T5a,500,7,-8,-11,3,"7,-8"
15116,720575940617365990,right,T5a,501,1,2,0,2,"1,2"
15117,720575940634954009,right,T5a,502,5,8,-1,9,"5,8"
15118,720575940632229540,right,T5a,503,3,17,5,12,"3,17"
15119,720575940635234484,right,T5a,504,-2,9,6,3,"-2,9"
15120,720575940609006857,right,T5a,506,1,-12,-7,-5,"1,-12"
15121,720575940624609275,right,T5a,507,-5,-12,-1,-11,"-5,-12"
15122,720575940635561663,right,T5a,508,-5,11,10,1,"-5,11"
15123,720575940618161126,right,T5a,509,-4,10,9,1,"-4,10"
15124,720575940610235342,right,T5a,510,-2,11,7,4,"-2,11"
15125,720575940653602038,right,T5a,511,5,-11,-11,0,"5,-11"
15126,720575940606555522,right,T5a,512,6,0,-6,6,"6,0"
15127,720575940649800825,right,T5a,514,-4,-10,-1,-9,"-4,-10"
15128,720575940632251729,right,T5a,515,-8,-7,4,-11,"-8,-7"
15129,720575940618493253,right,T5a,517,6,3,-5,8,"6,3"
15130,720575940621445723,right,T5a,518,-4,22,15,7,"-4,22"
15131,720575940643614408,right,T5a,519,-5,-5,2,-7,"-5,-5"
15132,720575940617604820,right,T5a,521,6,-9,-11,2,"6,-9"
15133,720575940618154304,right,T5a,522,-4,0,4,-4,"-4,0"
15134,720575940642802592,right,T5a,523,2,14,5,9,"2,14"
15135,720575940630757371,right,T5a,524,4,-20,-14,-6,"4,-20"
15136,720575940636938586,right,T5a,525,-1,-20,-9,-11,"-1,-20"
15137,720575940628737323,right,T5a,526,0,-10,-5,-5,"0,-10"
15138,720575940614577117,right,T5a,527,-4,-8,0,-8,"-4,-8"
15139,720575940616769297,right,T5a,528,2,7,1,6,"2,7"
15140,720575940624329546,right,T5a,529,2,-2,-3,1,"2,-2"
15141,720575940613118887,right,T5a,530,-3,-13,-4,-9,"-3,-13"
15142,720575940617743901,right,T5a,531,1,0,-1,1,"1,0"
15143,720575940626282371,right,T5a,532,-8,7,11,-4,"-8,7"
15144,720575940617720404,right,T5a,533,0,-16,-8,-8,"0,-16"
15145,720575940619757392,right,T5a,534,3,2,-2,4,"3,2"
15146,720575940630322688,right,T5a,535,8,-4,-10,6,"8,-4"
15147,720575940611460826,right,T5a,536,3,4,-1,5,"3,4"
15148,720575940617745698,right,T5a,537,0,-23,-12,-11,"0,-23"
15149,720575940620195776,right,T5a,538,-4,1,4,-3,"-4,1"
15150,720575940634835551,right,T5a,539,-6,15,13,2,"-6,15"
15151,720575940622908745,right,T5a,540,-2,-9,-3,-6,"-2,-9"
15152,720575940606738562,right,T5a,541,-4,14,11,3,"-4,14"
15153,720575940618942843,right,T5a,542,6,-13,-13,0,"6,-13"
15154,720575940627133457,right,T5a,543,-1,-4,-1,-3,"-1,-4"
15155,720575940624722702,right,T5a,545,5,11,0,11,"5,11"
15156,720575940617150676,right,T5a,546,3,6,0,6,"3,6"
15157,720575940610639729,right,T5a,547,-1,21,11,10,"-1,21"
15158,720575940616274971,right,T5a,548,1,-16,-9,-7,"1,-16"
15159,720575940652131574,right,T5a,549,0,-9,-5,-4,"0,-9"
15160,720575940631729967,right,T5a,550,-2,3,3,0,"-2,3"
15161,720575940627467516,right,T5a,551,-4,-9,-1,-8,"-4,-9"
15162,720575940607685387,right,T5a,552,4,-1,-5,4,"4,-1"
15163,720575940626150402,right,T5a,553,-3,16,11,5,"-3,16"
15164,720575940643507104,right,T5a,555,-4,9,8,1,"-4,9"
15165,720575940627449340,right,T5a,556,0,10,5,5,"0,10"
15166,720575940618755638,right,T5a,557,6,-10,-11,1,"6,-10"
15167,720575940604432864,right,T5a,558,-4,-21,-7,-14,"-4,-21"
15168,720575940622151756,right,T5a,560,-7,14,14,0,"-7,14"
15169,720575940613372979,right,T5a,561,5,7,-2,9,"5,7"
15170,720575940640595875,right,T5a,562,-5,-2,4,-6,"-5,-2"
15171,720575940624632103,right,T5a,563,5,-13,-12,-1,"5,-13"
15172,720575940639784563,right,T5a,564,3,-23,-15,-8,"3,-23"
15173,720575940627231498,right,T5a,565,0,-26,-13,-13,"0,-26"
15174,720575940626716958,right,T5a,566,5,-8,-9,1,"5,-8"
15175,720575940639689379,right,T5a,567,-2,22,13,9,"-2,22"
15176,720575940631569256,right,T5a,568,-6,-8,2,-10,"-6,-8"
15177,720575940627573035,right,T5a,569,6,6,-3,9,"6,6"
15178,720575940660085121,right,T5a,570,2,25,10,15,"2,25"
15179,720575940625766346,right,T5a,571,0,-14,-7,-7,"0,-14"
15180,720575940629567358,right,T5a,572,-8,3,9,-6,"-8,3"
15181,720575940627562920,right,T5a,573,4,14,3,11,"4,14"
15182,720575940637759295,right,T5a,574,-6,5,8,-3,"-6,5"
15183,720575940610984398,right,T5a,575,6,9,-2,11,"6,9"
15184,720575940623276364,right,T5a,576,0,28,14,14,"0,28"
15185,720575940620311791,right,T5a,577,5,-14,-12,-2,"5,-14"
15186,720575940652196342,right,T5a,578,4,-11,-10,-1,"4,-11"
15187,720575940634115952,right,T5a,580,-2,-23,-10,-13,"-2,-23"
15188,720575940611490606,right,T5a,581,3,9,1,8,"3,9"
15189,720575940621545920,right,T5a,582,-1,23,12,11,"-1,23"
15190,720575940624467082,right,T5a,583,3,-25,-16,-9,"3,-25"
15191,720575940619795533,right,T5a,584,4,23,7,16,"4,23"
15192,720575940617252923,right,T5a,585,-1,-23,-11,-12,"-1,-23"
15193,720575940634835610,right,T5a,586,2,18,7,11,"2,18"
15194,720575940616391797,right,T5a,587,4,22,7,15,"4,22"
15195,720575940637182309,right,T5a,588,1,4,1,3,"1,4"
15196,720575940619544661,right,T5a,589,-1,-5,-2,-3,"-1,-5"
15197,720575940634345626,right,T5a,590,1,9,3,6,"1,9"
15198,720575940630467269,right,T5a,591,3,-3,-5,2,"3,-3"
15199,720575940609160457,right,T5a,592,3,-28,-17,-11,"3,-28"
15200,720575940620018523,right,T5a,593,3,-14,-10,-4,"3,-14"
15201,720575940624847034,right,T5a,594,7,-16,-15,-1,"7,-16"
15202,720575940626944286,right,T5a,595,7,-12,-13,1,"7,-12"
15203,720575940635218327,right,T5a,596,-4,-16,-4,-12,"-4,-16"
15204,720575940646961284,right,T5a,597,4,1,-4,5,"4,1"
15205,720575940633575134,right,T5a,599,-1,9,5,4,"-1,9"
15206,720575940632429794,right,T5a,600,3,-10,-8,-2,"3,-10"
15207,720575940631306552,right,T5a,601,1,16,7,9,"1,16"
15208,720575940631495348,right,T5a,602,4,-2,-5,3,"4,-2"
15209,720575940634033308,right,T5a,603,-3,-23,-9,-14,"-3,-23"
15210,720575940626662174,right,T5a,605,3,15,4,11,"3,15"
15211,720575940620237702,right,T5a,606,-1,-19,-9,-10,"-1,-19"
15212,720575940644929828,right,T5a,607,1,18,8,10,"1,18"
15213,720575940629542930,right,T5a,608,1,10,4,6,"1,10"
15214,720575940611449749,right,T5a,609,-2,0,2,-2,"-2,0"
15215,720575940631928376,right,T5a,611,-1,-18,-8,-10,"-1,-18"
15216,720575940617735380,right,T5a,612,-3,-26,-10,-16,"-3,-26"
15217,720575940610713810,right,T5a,614,-2,-8,-2,-6,"-2,-8"
15218,720575940624211197,right,T5a,615,-7,-7,3,-10,"-7,-7"
15219,720575940631498307,right,T5a,616,-3,15,10,5,"-3,15"
15220,720575940623023145,right,T5a,617,-2,-17,-7,-10,"-2,-17"
15221,720575940628513796,right,T5a,618,-1,24,13,11,"-1,24"
15222,720575940627705603,right,T5a,619,-4,-19,-6,-13,"-4,-19"
15223,720575940638288436,right,T5a,620,7,1,-7,8,"7,1"
15224,720575940621106368,right,T5a,621,1,24,11,13,"1,24"
15225,720575940628315197,right,T5a,622,-5,20,15,5,"-5,20"
15226,720575940620380654,right,T5a,623,1,13,5,8,"1,13"
15227,720575940614092138,right,T5a,624,1,-17,-10,-7,"1,-17"
15228,720575940623311203,right,T5a,625,-2,24,14,10,"-2,24"
15229,720575940603365980,right,T5a,626,-5,-8,1,-9,"-5,-8"
15230,720575940643686935,right,T5a,627,0,-1,-1,0,"0,-1"
15231,720575940608668867,right,T5a,628,0,0,0,0,"0,0"
15232,720575940621163892,right,T5a,629,4,24,8,16,"4,24"
15233,720575940636161381,right,T5a,630,4,8,0,8,"4,8"
15234,720575940628061321,right,T5a,631,1,26,12,14,"1,26"
15235,720575940639312949,right,T5a,632,3,-20,-13,-7,"3,-20"
15236,720575940629657210,right,T5a,633,-1,-24,-11,-13,"-1,-24"
15237,720575940623133130,right,T5a,634,-3,-15,-5,-10,"-3,-15"
15238,720575940625191100,right,T5a,635,6,-6,-9,3,"6,-6"
15239,720575940642025357,right,T5a,636,0,6,3,3,"0,6"
15240,720575940626978137,right,T5a,637,3,-21,-14,-7,"3,-21"
15241,720575940639972597,right,T5a,638,-1,7,4,3,"-1,7"
15242,720575940630688207,right,T5a,639,-4,19,13,6,"-4,19"
15243,720575940654576289,right,T5a,640,-1,-16,-7,-9,"-1,-16"
15244,720575940639720782,right,T5a,641,-8,-5,5,-10,"-8,-5"
15245,720575940623940154,right,T5a,642,-5,-11,-1,-10,"-5,-11"
15246,720575940617137937,right,T5a,643,6,14,1,13,"6,14"
15247,720575940626044734,right,T5a,644,-6,18,15,3,"-6,18"
15248,720575940627862545,right,T5a,645,-4,27,17,10,"-4,27"
15249,720575940637290341,right,T5a,646,6,17,2,15,"6,17"
15250,720575940614715357,right,T5a,647,-4,-7,0,-7,"-4,-7"
15251,720575940615363122,right,T5a,648,1,7,2,5,"1,7"
15252,720575940613497384,right,T5a,649,-1,5,3,2,"-1,5"
15253,720575940614328978,right,T5a,650,-3,-25,-10,-15,"-3,-25"
15254,720575940615072735,right,T5a,651,-4,-5,1,-6,"-4,-5"
15255,720575940624608763,right,T5a,652,-6,-11,0,-11,"-6,-11"
15256,720575940622197530,right,T5a,653,-6,-12,0,-12,"-6,-12"
15257,720575940622241494,right,T5a,654,-3,8,7,1,"-3,8"
15258,720575940623355389,right,T5a,655,6,-1,-7,6,"6,-1"
15259,720575940605980262,right,T5a,656,0,-11,-6,-5,"0,-11"
15260,720575940647503748,right,T5a,657,-2,-25,-11,-14,"-2,-25"
15261,720575940623872329,right,T5a,658,1,20,9,11,"1,20"
15262,720575940606624642,right,T5a,659,-4,-6,1,-7,"-4,-6"
15263,720575940633648782,right,T5a,660,2,28,12,16,"2,28"
15264,720575940629962300,right,T5a,661,-3,14,10,4,"-3,14"
15265,720575940623919689,right,T5a,662,2,-1,-3,2,"2,-1"
15266,720575940626723091,right,T5a,663,0,8,4,4,"0,8"
15267,720575940620955457,right,T5a,664,1,-27,-15,-12,"1,-27"
15268,720575940624306663,right,T5a,665,7,-2,-8,6,"7,-2"
15269,720575940629116401,right,T5a,666,7,-13,-14,1,"7,-13"
15270,720575940605535177,right,T5a,667,1,-28,-15,-13,"1,-28"
15271,720575940631275863,right,T5a,668,1,19,8,11,"1,19"
15272,720575940639471950,right,T5a,669,4,-16,-12,-4,"4,-16"
15273,720575940639034739,right,T5a,670,5,5,-3,8,"5,5"
15274,720575940643806880,right,T5a,671,-4,-23,-8,-15,"-4,-23"
15275,720575940633717855,right,T5a,672,-8,11,13,-2,"-8,11"
15276,720575940634429119,right,T5a,673,2,5,0,5,"2,5"
15277,720575940644589591,right,T5a,676,-3,-21,-8,-13,"-3,-21"
15278,720575940625844666,right,T5a,677,0,11,5,6,"0,11"
15279,720575940615235138,right,T5a,678,3,-7,-7,0,"3,-7"
15280,720575940617197140,right,T5a,679,4,18,5,13,"4,18"
15281,720575940616396703,right,T5a,680,-1,25,13,12,"-1,25"
15282,720575940621616734,right,T5a,681,-2,-21,-9,-12,"-2,-21"
15283,720575940626586370,right,T5a,682,6,-8,-10,2,"6,-8"
15284,720575940621298949,right,T5a,683,2,6,1,5,"2,6"
15285,720575940634784410,right,T5a,684,-6,17,14,3,"-6,17"
15286,720575940622752205,right,T5a,685,-5,-9,0,-9,"-5,-9"
15287,720575940627946250,right,T5a,686,5,-22,-16,-6,"5,-22"
15288,720575940608528341,right,T5a,687,-6,-3,4,-7,"-6,-3"
15289,720575940639055157,right,T5a,688,-7,10,12,-2,"-7,10"
15290,720575940611904218,right,T5a,689,-2,18,11,7,"-2,18"
15291,720575940605756844,right,T5a,692,-4,24,16,8,"-4,24"
15292,720575940635528440,right,T5a,693,-3,25,15,10,"-3,25"
15293,720575940621617391,right,T5a,694,4,3,-3,6,"4,3"
15294,720575940617272020,right,T5a,695,-6,10,11,-1,"-6,10"
15295,720575940621009904,right,T5a,696,-2,16,10,6,"-2,16"
15296,720575940622593663,right,T5a,697,1,-22,-12,-10,"1,-22"
15297,720575940623802859,right,T5a,698,6,-7,-10,3,"6,-7"
15298,720575940621602081,right,T5a,699,-5,0,5,-5,"-5,0"
15299,720575940631901267,right,T5a,700,5,15,2,13,"5,15"
15300,720575940624351818,right,T5a,701,0,-4,-2,-2,"0,-4"
15301,720575940608404235,right,T5a,703,-3,1,3,-2,"-3,1"
15302,720575940626953274,right,T5a,704,-7,8,11,-3,"-7,8"
15303,720575940635465407,right,T5a,705,1,1,-1,2,"1,1"
15304,720575940644937416,right,T5a,707,-2,25,14,11,"-2,25"
15305,720575940618322971,right,T5a,709,-2,-24,-10,-14,"-2,-24"
15306,720575940603940012,right,T5a,710,4,-25,-17,-8,"4,-25"
15307,720575940627153939,right,T5a,711,-1,19,10,9,"-1,19"
15308,720575940621999484,right,T5a,712,-7,12,13,-1,"-7,12"
15309,720575940631091730,right,T5a,713,-6,16,14,2,"-6,16"
15310,720575940617275665,right,T5a,714,5,12,1,11,"5,12"
15311,720575940645691700,right,T5a,715,4,10,1,9,"4,10"
15312,720575940625571858,right,T5a,716,4,-6,-7,1,"4,-6"
15313,720575940627004682,right,T5a,717,2,-22,-13,-9,"2,-22"
15314,720575940605392160,right,T5a,718,-5,24,17,7,"-5,24"
15315,720575940627331856,right,T5a,719,1,27,12,15,"1,27"
15316,720575940628541456,right,T5a,720,-5,21,15,6,"-5,21"
15317,720575940624156430,right,T5a,721,5,13,1,12,"5,13"
15318,720575940626071738,right,T5a,722,6,-15,-14,-1,"6,-15"
15319,720575940604774572,right,T5a,723,-2,-11,-4,-7,"-2,-11"
15320,720575940617988097,right,T5a,724,4,2,-3,5,"4,2"
15321,720575940623806459,right,T5a,725,-3,-24,-9,-15,"-3,-24"
15322,720575940615368498,right,T5a,726,2,-28,-16,-12,"2,-28"
15323,720575940629299355,right,T5a,727,7,6,-4,10,"7,6"
15324,720575940621021536,right,T5a,728,7,12,-1,13,"7,12"
15325,720575940628376085,right,T5a,729,-3,29,17,12,"-3,29"
15326,720575940624776892,right,T5a,730,7,0,-7,7,"7,0"
15327,720575940622988070,right,T5a,731,-6,9,10,-1,"-6,9"
15328,720575940618730107,right,T5a,732,-3,6,6,0,"-3,6"
15329,720575940642644788,right,T5a,734,2,0,-2,2,"2,0"
15330,720575940623719980,right,T5a,737,0,19,9,10,"0,19"
15331,720575940633354321,right,T5a,738,-3,13,9,4,"-3,13"
15332,720575940636156046,right,T5a,739,-7,2,8,-6,"-7,2"
15333,720575940614219670,right,T5a,741,-2,-14,-5,-9,"-2,-14"
15334,720575940633299808,right,T5a,742,-4,11,9,2,"-4,11"
15335,720575940606736830,right,T5a,743,6,-19,-16,-3,"6,-19"
15336,720575940613419006,right,T5a,744,-4,25,16,9,"-4,25"
15337,720575940616045279,right,T5a,745,0,13,6,7,"0,13"
15338,720575940642937140,right,T5a,746,-3,3,4,-1,"-3,3"
15339,720575940633329886,right,T5a,747,0,2,1,1,"0,2"
15340,720575940611002210,right,T5a,748,-4,20,14,6,"-4,20"
15341,720575940642939956,right,T5a,749,-2,1,2,-1,"-2,1"
15342,720575940614205336,right,T5a,750,4,-24,-16,-8,"4,-24"
15343,720575940637671487,right,T5a,751,1,6,2,4,"1,6"
15344,720575940635797134,right,T5a,752,-2,7,5,2,"-2,7"
15345,720575940635373560,right,T5a,753,-3,24,15,9,"-3,24"
15346,720575940638000061,right,T5a,754,-1,-13,-6,-7,"-1,-13"
15347,720575940626305892,right,T5a,755,4,19,5,14,"4,19"
15348,720575940633316633,right,T5a,756,5,20,5,15,"5,20"
15349,720575940637529229,right,T5a,757,0,-6,-3,-3,"0,-6"
15350,720575940623381578,right,T5a,758,5,-1,-6,5,"5,-1"
15351,720575940620994656,right,T5a,759,7,14,0,14,"7,14"
15352,720575940626858748,right,T5a,760,0,17,8,9,"0,17"
15353,720575940626571484,right,T5a,761,-4,-18,-5,-13,"-4,-18"
15354,720575940617722525,right,T5a,762,0,14,7,7,"0,14"
15355,720575940636375182,right,T5a,763,-5,14,12,2,"-5,14"
15356,720575940624012040,right,T5a,765,-3,9,7,2,"-3,9"
15357,720575940630449628,right,T5a,766,2,-4,-4,0,"2,-4"
15358,720575940635751103,right,T5a,767,1,28,13,15,"1,28"
15359,720575940623826249,right,T5a,768,3,5,-1,6,"3,5"
15360,720575940640545243,right,T5a,769,4,-27,-18,-9,"4,-27"
15361,720575940609226709,right,T5a,770,5,4,-3,7,"5,4"
15362,720575940618345729,right,T5a,771,3,-27,-17,-10,"3,-27"
15363,720575940618943053,right,T5a,772,1,12,5,7,"1,12"
15364,720575940631814248,right,T5a,773,5,-19,-15,-4,"5,-19"
15365,720575940621172033,right,T5a,775,5,22,6,16,"5,22"
15366,720575940626400770,right,T5a,776,5,21,5,16,"5,21"
15367,720575940640062115,right,T5a,778,4,25,8,17,"4,25"
15368,720575940622937323,right,T5a,779,5,24,7,17,"5,24"
15369,720575940622395263,right,T5a,780,-6,25,18,7,"-6,25"
15370,720575940623950889,right,T5a,781,-5,26,18,8,"-5,26"
15371,720575940627525181,right,T5a,782,-5,27,18,9,"-5,27"
15372,720575940638713690,right,T5a,783,-4,28,18,10,"-4,28"
15373,720575940633038748,right,T5a,784,-4,29,18,11,"-4,29"
15374,720575940630118338,right,T5a,785,-3,30,18,12,"-3,30"
15375,720575940634404322,right,T5a,786,-2,30,17,13,"-2,30"
15376,720575940630305756,right,T5a,787,3,28,11,17,"3,28"
15377,720575940633615807,right,T5a,790,-2,-27,-12,-15,"-2,-27"
15378,720575940619871597,right,T5a,792,8,2,-7,9,"8,2"
15379,720575940621291440,right,T5a,793,8,-6,-11,5,"8,-6"
15380,720575940621094895,right,T5a,795,6,-21,-17,-4,"6,-21"
15381,720575940633655694,right,T5a,796,4,26,9,17,"4,26"
15382,720575940624041451,right,T5b,1,-6,13,12,1,"-6,13"
15383,720575940639294323,right,T5b,2,-8,2,9,-7,"-8,2"
15384,720575940631192620,right,T5b,3,6,-12,-12,0,"6,-12"
15385,720575940626502756,right,T5b,4,-5,-21,-6,-15,"-5,-21"
15386,720575940620526757,right,T5b,5,-1,16,9,7,"-1,16"
15387,720575940625876226,right,T5b,6,-2,-4,0,-4,"-2,-4"
15388,720575940625371024,right,T5b,7,-6,-6,3,-9,"-6,-6"
15389,720575940644320200,right,T5b,8,-4,26,17,9,"-4,26"
15390,720575940631548714,right,T5b,9,4,9,0,9,"4,9"
15391,720575940633697983,right,T5b,10,5,-15,-13,-2,"5,-15"
15392,720575940617634233,right,T5b,11,7,-14,-14,0,"7,-14"
15393,720575940628920219,right,T5b,12,-7,9,11,-2,"-7,9"
15394,720575940623544712,right,T5b,13,-1,-26,-12,-14,"-1,-26"
15395,720575940627814410,right,T5b,14,0,-27,-14,-13,"0,-27"
15396,720575940613499857,right,T5b,15,2,-3,-4,1,"2,-3"
15397,720575940630604047,right,T5b,16,-2,-16,-6,-10,"-2,-16"
15398,720575940620241755,right,T5b,17,1,-5,-4,-1,"1,-5"
15399,720575940619022757,right,T5b,18,5,-16,-13,-3,"5,-16"
15400,720575940627814163,right,T5b,19,-7,17,15,2,"-7,17"
15401,720575940623926527,right,T5b,20,3,-11,-9,-2,"3,-11"
15402,720575940624752316,right,T5b,21,-2,19,11,8,"-2,19"
15403,720575940627124746,right,T5b,22,-1,3,2,1,"-1,3"
15404,720575940605084774,right,T5b,23,-3,-16,-5,-11,"-3,-16"
15405,720575940619209664,right,T5b,24,-1,-10,-4,-6,"-1,-10"
15406,720575940628237041,right,T5b,25,-9,3,10,-7,"-9,3"
15407,720575940640254928,right,T5b,26,1,-3,-3,0,"1,-3"
15408,720575940634942143,right,T5b,27,0,-25,-13,-12,"0,-25"
15409,720575940611041459,right,T5b,28,5,6,-2,8,"5,6"
15410,720575940622385869,right,T5b,29,-1,-3,-1,-2,"-1,-3"
15411,720575940612342770,right,T5b,30,6,16,2,14,"6,16"
15412,720575940624961328,right,T5b,31,0,16,8,8,"0,16"
15413,720575940610213582,right,T5b,32,0,12,6,6,"0,12"
15414,720575940618240769,right,T5b,33,3,18,6,12,"3,18"
15415,720575940626835545,right,T5b,34,6,18,3,15,"6,18"
15416,720575940612354711,right,T5b,35,1,-24,-13,-11,"1,-24"
15417,720575940633499929,right,T5b,36,6,8,-2,10,"6,8"
15418,720575940633548510,right,T5b,37,1,5,1,4,"1,5"
15419,720575940621776901,right,T5b,38,0,-2,-1,-1,"0,-2"
15420,720575940605903532,right,T5b,39,0,20,10,10,"0,20"
15421,720575940628431632,right,T5b,40,-2,-6,-1,-5,"-2,-6"
15422,720575940646797347,right,T5b,41,-3,28,17,11,"-3,28"
15423,720575940620387137,right,T5b,42,-1,14,8,6,"-1,14"
15424,720575940632416398,right,T5b,43,-5,18,14,4,"-5,18"
15425,720575940605793894,right,T5b,44,5,-10,-10,0,"5,-10"
15426,720575940649335929,right,T5b,45,-5,-1,4,-5,"-5,-1"
15427,720575940607035314,right,T5b,46,-5,15,12,3,"-5,15"
15428,720575940612145301,right,T5b,47,-9,-1,8,-9,"-9,-1"
15429,720575940612768405,right,T5b,48,-4,-22,-7,-15,"-4,-22"
15430,720575940636764078,right,T5b,49,4,-4,-6,2,"4,-4"
15431,720575940623053261,right,T5b,50,-2,21,12,9,"-2,21"
15432,720575940616904889,right,T5b,51,0,-19,-10,-9,"0,-19"
15433,720575940631310351,right,T5b,52,-1,-22,-10,-12,"-1,-22"
15434,720575940636214903,right,T5b,53,5,14,2,12,"5,14"
15435,720575940637439972,right,T5b,54,-4,3,5,-2,"-4,3"
15436,720575940633773919,right,T5b,55,-4,-11,-2,-9,"-4,-11"
15437,720575940617832758,right,T5b,56,1,-13,-8,-5,"1,-13"
15438,720575940629473324,right,T5b,57,6,-11,-12,1,"6,-11"
15439,720575940608472797,right,T5b,58,3,12,3,9,"3,12"
15440,720575940621915350,right,T5b,59,-2,2,3,-1,"-2,2"
15441,720575940627635972,right,T5b,60,-8,8,12,-4,"-8,8"
15442,720575940623164307,right,T5b,61,-4,-4,2,-6,"-4,-4"
15443,720575940617396497,right,T5b,63,4,12,2,10,"4,12"
15444,720575940624829989,right,T5b,64,4,-23,-16,-7,"4,-23"
15445,720575940617821881,right,T5b,65,-1,28,15,13,"-1,28"
15446,720575940631256338,right,T5b,66,2,15,5,10,"2,15"
15447,720575940659807361,right,T5b,67,-2,-13,-5,-8,"-2,-13"
15448,720575940630024779,right,T5b,68,3,16,5,11,"3,16"
15449,720575940619075661,right,T5b,69,1,8,3,5,"1,8"
15450,720575940639237710,right,T5b,70,-4,21,14,7,"-4,21"
15451,720575940626740404,right,T5b,71,-2,-3,0,-3,"-2,-3"
15452,720575940631813391,right,T5b,72,0,-28,-14,-14,"0,-28"
15453,720575940621399284,right,T5b,73,2,2,-1,3,"2,2"
15454,720575940621522122,right,T5b,74,-1,-9,-4,-5,"-1,-9"
15455,720575940635287476,right,T5b,75,-6,14,13,1,"-6,14"
15456,720575940621749416,right,T5b,76,-3,-4,1,-5,"-3,-4"
15457,720575940624335434,right,T5b,77,2,-5,-5,0,"2,-5"
15458,720575940616846934,right,T5b,78,2,20,8,12,"2,20"
15459,720575940613674291,right,T5b,79,2,1,-2,3,"2,1"
15460,720575940623126762,right,T5b,80,4,13,2,11,"4,13"
15461,720575940600071689,right,T5b,81,6,-2,-7,5,"6,-2"
15462,720575940632734637,right,T5b,82,-7,7,10,-3,"-7,7"
15463,720575940620766561,right,T5b,83,2,-21,-13,-8,"2,-21"
15464,720575940621890518,right,T5b,84,-2,12,8,4,"-2,12"
15465,720575940607583939,right,T5b,85,4,-22,-15,-7,"4,-22"
15466,720575940620656598,right,T5b,86,-5,-7,1,-8,"-5,-7"
15467,720575940621694049,right,T5b,87,1,11,4,7,"1,11"
15468,720575940627431940,right,T5b,88,7,4,-5,9,"7,4"
15469,720575940619165525,right,T5b,89,1,-19,-11,-8,"1,-19"
15470,720575940624646076,right,T5b,90,-4,5,6,-1,"-4,5"
15471,720575940633235225,right,T5b,91,-1,6,4,2,"-1,6"
15472,720575940637557481,right,T5b,92,0,9,4,5,"0,9"
15473,720575940627378965,right,T5b,93,-6,3,7,-4,"-6,3"
15474,720575940632213924,right,T5b,94,5,18,4,14,"5,18"
15475,720575940628800006,right,T5b,95,4,-21,-15,-6,"4,-21"
15476,720575940624436238,right,T5b,96,1,-10,-6,-4,"1,-10"
15477,720575940630382966,right,T5b,97,-5,2,6,-4,"-5,2"
15478,720575940633234658,right,T5b,98,-1,-12,-5,-7,"-1,-12"
15479,720575940622254162,right,T5b,99,4,15,3,12,"4,15"
15480,720575940627058186,right,T5b,100,2,-10,-7,-3,"2,-10"
15481,720575940614427542,right,T5b,101,-7,6,10,-4,"-7,6"
15482,720575940625968228,right,T5b,102,3,13,3,10,"3,13"
15483,720575940613876370,right,T5b,104,-1,-27,-13,-14,"-1,-27"
15484,720575940627790076,right,T5b,105,3,22,8,14,"3,22"
15485,720575940635286196,right,T5b,106,-7,11,12,-1,"-7,11"
15486,720575940631958097,right,T5b,108,-3,-12,-3,-9,"-3,-12"
15487,720575940616919109,right,T5b,109,4,-5,-7,2,"4,-5"
15488,720575940617100044,right,T5b,110,-7,0,7,-7,"-7,0"
15489,720575940619335407,right,T5b,111,2,-24,-14,-10,"2,-24"
15490,720575940628532267,right,T5b,112,-6,1,6,-5,"-6,1"
15491,720575940630321401,right,T5b,113,-2,4,4,0,"-2,4"
15492,720575940624048898,right,T5b,114,2,-13,-9,-4,"2,-13"
15493,720575940620190959,right,T5b,115,-4,2,5,-3,"-4,2"
15494,720575940646191395,right,T5b,116,-1,-8,-3,-5,"-1,-8"
15495,720575940604875744,right,T5b,117,-8,-2,7,-9,"-8,-2"
15496,720575940642648116,right,T5b,118,3,1,-3,4,"3,1"
15497,720575940624011784,right,T5b,119,-2,6,5,1,"-2,6"
15498,720575940619167147,right,T5b,120,-1,-1,0,-1,"-1,-1"
15499,720575940621390975,right,T5b,121,-8,4,10,-6,"-8,4"
15500,720575940632577934,right,T5b,122,-5,9,9,0,"-5,9"
15501,720575940635171695,right,T5b,123,-8,10,13,-3,"-8,10"
15502,720575940614224126,right,T5b,124,1,-7,-5,-2,"1,-7"
15503,720575940628304643,right,T5b,125,5,9,-1,10,"5,9"
15504,720575940616929595,right,T5b,126,3,11,2,9,"3,11"
15505,720575940618137165,right,T5b,127,0,15,7,8,"0,15"
15506,720575940618404312,right,T5b,128,3,-22,-14,-8,"3,-22"
15507,720575940622283786,right,T5b,129,0,-13,-7,-6,"0,-13"
15508,720575940640999309,right,T5b,130,2,12,4,8,"2,12"
15509,720575940609341141,right,T5b,131,-6,20,16,4,"-6,20"
15510,720575940622777385,right,T5b,132,2,4,0,4,"2,4"
15511,720575940629318351,right,T5b,133,-3,20,13,7,"-3,20"
15512,720575940634202480,right,T5b,134,-5,-18,-4,-14,"-5,-18"
15513,720575940638036452,right,T5b,135,-3,-22,-8,-14,"-3,-22"
15514,720575940632397599,right,T5b,136,0,3,1,2,"0,3"
15515,720575940628421105,right,T5b,137,5,-7,-9,2,"5,-7"
15516,720575940619867259,right,T5b,138,0,27,13,14,"0,27"
15517,720575940622282762,right,T5b,139,1,-14,-8,-6,"1,-14"
15518,720575940628270083,right,T5b,140,3,8,1,7,"3,8"
15519,720575940623036362,right,T5b,142,-2,-18,-7,-11,"-2,-18"
15520,720575940608162652,right,T5b,143,-4,16,12,4,"-4,16"
15521,720575940638608606,right,T5b,144,7,-11,-13,2,"7,-11"
15522,720575940626778311,right,T5b,145,0,4,2,2,"0,4"
15523,720575940628842951,right,T5b,146,1,-6,-4,-2,"1,-6"
15524,720575940617470609,right,T5b,147,1,21,9,12,"1,21"
15525,720575940636118895,right,T5b,148,-7,-11,1,-12,"-7,-11"
15526,720575940609043925,right,T5b,149,6,-14,-13,-1,"6,-14"
15527,720575940627139410,right,T5b,150,-8,5,10,-5,"-8,5"
15528,720575940623207608,right,T5b,151,-3,-14,-4,-10,"-3,-14"
15529,720575940622756707,right,T5b,155,-8,13,14,-1,"-8,13"
15530,720575940625641418,right,T5b,156,-9,1,9,-8,"-9,1"
15531,720575940613640421,right,T5b,157,-1,-7,-3,-4,"-1,-7"
15532,720575940627550120,right,T5b,158,3,-5,-6,1,"3,-5"
15533,720575940620528736,right,T5b,159,7,7,-4,11,"7,7"
15534,720575940610557048,right,T5b,160,-2,20,12,8,"-2,20"
15535,720575940623280127,right,T5b,161,4,-14,-11,-3,"4,-14"
15536,720575940623571383,right,T5b,162,-4,-2,3,-5,"-4,-2"
15537,720575940634895002,right,T5b,163,-9,7,12,-5,"-9,7"
15538,720575940605353905,right,T5b,164,-1,-2,0,-2,"-1,-2"
15539,720575940614411154,right,T5b,165,4,16,4,12,"4,16"
15540,720575940634834330,right,T5b,166,0,18,9,9,"0,18"
15541,720575940634421099,right,T5b,167,0,-17,-9,-8,"0,-17"
15542,720575940623325624,right,T5b,168,-1,17,9,8,"-1,17"
15543,720575940628090353,right,T5b,169,0,-18,-9,-9,"0,-18"
15544,720575940628187978,right,T5b,170,-5,1,5,-4,"-5,1"
15545,720575940633297107,right,T5b,171,6,-20,-16,-4,"6,-20"
15546,720575940633395999,right,T5b,172,1,22,10,12,"1,22"
15547,720575940638575192,right,T5b,173,2,-25,-15,-10,"2,-25"
15548,720575940628856836,right,T5b,174,4,-15,-12,-3,"4,-15"
15549,720575940616396917,right,T5b,175,-6,-7,2,-9,"-6,-7"
15550,720575940634164702,right,T5b,176,-2,13,8,5,"-2,13"
15551,720575940649361785,right,T5b,177,-2,-1,1,-2,"-2,-1"
15552,720575940623598311,right,T5b,178,2,11,3,8,"2,11"
15553,720575940623296507,right,T5b,179,-5,-16,-3,-13,"-5,-16"
15554,720575940634034457,right,T5b,180,2,-27,-16,-11,"2,-27"
15555,720575940612882669,right,T5b,181,1,-4,-3,-1,"1,-4"
15556,720575940623248010,right,T5b,183,-5,-15,-3,-12,"-5,-15"
15557,720575940630955700,right,T5b,184,-6,-5,3,-8,"-6,-5"
15558,720575940611608946,right,T5b,185,2,-11,-8,-3,"2,-11"
15559,720575940606734002,right,T5b,187,3,21,7,14,"3,21"
15560,720575940629961175,right,T5b,188,-5,17,13,4,"-5,17"
15561,720575940646927924,right,T5b,189,6,13,0,13,"6,13"
15562,720575940630375542,right,T5b,190,-3,-5,0,-5,"-3,-5"
15563,720575940606499017,right,T5b,191,-1,-11,-5,-6,"-1,-11"
15564,720575940605492670,right,T5b,193,-5,4,7,-3,"-5,4"
15565,720575940622043560,right,T5b,194,0,-5,-3,-2,"0,-5"
15566,720575940620353518,right,T5b,195,-3,-1,2,-3,"-3,-1"
15567,720575940610515698,right,T5b,196,-1,8,5,3,"-1,8"
15568,720575940636302990,right,T5b,197,0,-20,-10,-10,"0,-20"
15569,720575940612751513,right,T5b,198,6,2,-5,7,"6,2"
15570,720575940624430094,right,T5b,199,0,-12,-6,-6,"0,-12"
15571,720575940631281706,right,T5b,200,-5,12,11,1,"-5,12"
15572,720575940624033515,right,T5b,201,-8,9,12,-3,"-8,9"
15573,720575940629156938,right,T5b,202,-1,27,14,13,"-1,27"
15574,720575940617301177,right,T5b,203,3,-1,-4,3,"3,-1"
15575,720575940609600580,right,T5b,204,5,-2,-6,4,"5,-2"
15576,720575940628657451,right,T5b,205,5,-6,-8,2,"5,-6"
15577,720575940618112069,right,T5b,206,-3,5,5,0,"-3,5"
15578,720575940638971364,right,T5b,207,1,29,13,16,"1,29"
15579,720575940627348841,right,T5b,208,5,-21,-16,-5,"5,-21"
15580,720575940604105137,right,T5b,209,-3,-8,-1,-7,"-3,-8"
15581,720575940613876718,right,T5b,210,-6,8,10,-2,"-6,8"
15582,720575940649314169,right,T5b,211,-7,-1,6,-7,"-7,-1"
15583,720575940622362890,right,T5b,212,2,-16,-10,-6,"2,-16"
15584,720575940617110233,right,T5b,213,3,-4,-5,1,"3,-4"
15585,720575940629379194,right,T5b,214,-5,3,6,-3,"-5,3"
15586,720575940630299127,right,T5b,215,6,7,-3,10,"6,7"
15587,720575940622626985,right,T5b,216,2,19,7,12,"2,19"
15588,720575940617180049,right,T5b,217,6,15,1,14,"6,15"
15589,720575940622441181,right,T5b,218,2,10,3,7,"2,10"
15590,720575940626245890,right,T5b,219,6,-4,-8,4,"6,-4"
15591,720575940630619599,right,T5b,220,2,-6,-5,-1,"2,-6"
15592,720575940609553476,right,T5b,221,-7,3,8,-5,"-7,3"
15593,720575940647822468,right,T5b,222,-3,26,16,10,"-3,26"
15594,720575940633486765,right,T5b,223,-2,26,15,11,"-2,26"
15595,720575940605096550,right,T5b,224,0,5,2,3,"0,5"
15596,720575940622874385,right,T5b,226,5,19,4,15,"5,19"
15597,720575940632632365,right,T5b,227,-7,5,9,-4,"-7,5"
15598,720575940614638442,right,T5b,228,-7,1,7,-6,"-7,1"
15599,720575940641634612,right,T5b,229,5,2,-4,6,"5,2"
15600,720575940634970743,right,T5b,230,2,9,2,7,"2,9"
15601,720575940635109983,right,T5b,231,4,-12,-10,-2,"4,-12"
15602,720575940623841461,right,T5b,232,-4,13,10,3,"-4,13"
15603,720575940614722541,right,T5b,233,4,-13,-11,-2,"4,-13"
15604,720575940623004454,right,T5b,234,1,3,0,3,"1,3"
15605,720575940610188494,right,T5b,235,4,11,1,10,"4,11"
15606,720575940628588135,right,T5b,236,-1,4,3,1,"-1,4"
15607,720575940631006012,right,T5b,237,-2,27,15,12,"-2,27"
15608,720575940633748706,right,T5b,238,-8,-3,6,-9,"-8,-3"
15609,720575940631829644,right,T5b,239,-6,6,9,-3,"-6,6"
15610,720575940615665458,right,T5b,240,-4,-3,2,-5,"-4,-3"
15611,720575940630067676,right,T5b,241,2,-17,-11,-6,"2,-17"
15612,720575940609663812,right,T5b,242,-4,6,7,-1,"-4,6"
15613,720575940624823700,right,T5b,243,-1,-21,-10,-11,"-1,-21"
15614,720575940614590429,right,T5b,244,-4,-12,-2,-10,"-4,-12"
15615,720575940625936740,right,T5b,245,-5,-3,3,-6,"-5,-3"
15616,720575940622620705,right,T5b,246,-4,15,11,4,"-4,15"
15617,720575940636271758,right,T5b,247,-4,-15,-4,-11,"-4,-15"
15618,720575940620333038,right,T5b,248,-6,0,6,-6,"-6,0"
15619,720575940617185403,right,T5b,249,2,-12,-8,-4,"2,-12"
15620,720575940640536053,right,T5b,250,-1,1,1,0,"-1,1"
15621,720575940621853386,right,T5b,251,-1,-14,-6,-8,"-1,-14"
15622,720575940625504601,right,T5b,252,3,23,8,15,"3,23"
15623,720575940633764959,right,T5b,253,5,16,3,13,"5,16"
15624,720575940612906904,right,T5b,254,3,-24,-15,-9,"3,-24"
15625,720575940611805333,right,T5b,255,-6,-13,-1,-12,"-6,-13"
15626,720575940614296214,right,T5b,256,5,-20,-15,-5,"5,-20"
15627,720575940615560278,right,T5b,257,2,21,8,13,"2,21"
15628,720575940627087930,right,T5b,258,-4,-17,-5,-12,"-4,-17"
15629,720575940632452909,right,T5b,259,-7,-5,4,-9,"-7,-5"
15630,720575940626435459,right,T5b,260,-3,19,12,7,"-3,19"
15631,720575940624993836,right,T5b,261,-1,13,7,6,"-1,13"
15632,720575940639907517,right,T5b,262,1,-11,-7,-4,"1,-11"
15633,720575940631703341,right,T5b,263,-3,4,5,-1,"-3,4"
15634,720575940617382740,right,T5b,264,-1,-6,-2,-4,"-1,-6"
15635,720575940620274566,right,T5b,265,-6,-1,5,-6,"-6,-1"
15636,720575940615026070,right,T5b,266,-1,-25,-12,-13,"-1,-25"
15637,720575940637727066,right,T5b,267,-6,2,7,-5,"-6,2"
15638,720575940629788542,right,T5b,268,7,-6,-10,4,"7,-6"
15639,720575940643819812,right,T5b,269,2,-19,-12,-7,"2,-19"
15640,720575940627372565,right,T5b,270,1,-8,-5,-3,"1,-8"
15641,720575940623927559,right,T5b,271,4,6,-1,7,"4,6"
15642,720575940600124169,right,T5b,272,3,-2,-4,2,"3,-2"
15643,720575940629260035,right,T5b,273,-6,23,17,6,"-6,23"
15644,720575940624601392,right,T5b,274,6,4,-4,8,"6,4"
15645,720575940654389921,right,T5b,275,-8,-1,7,-8,"-8,-1"
15646,720575940613673779,right,T5b,276,2,3,-1,4,"2,3"
15647,720575940610294979,right,T5b,277,7,-3,-9,6,"7,-3"
15648,720575940611561109,right,T5b,278,-5,10,10,0,"-5,10"
15649,720575940608334345,right,T5b,279,-4,8,8,0,"-4,8"
15650,720575940606077374,right,T5b,280,-6,-14,-1,-13,"-6,-14"
15651,720575940632454957,right,T5b,281,-9,2,10,-8,"-9,2"
15652,720575940642465499,right,T5b,282,0,26,13,13,"0,26"
15653,720575940623551565,right,T5b,283,-4,4,6,-2,"-4,4"
15654,720575940621107136,right,T5b,284,0,25,12,13,"0,25"
15655,720575940612110946,right,T5b,285,6,-18,-15,-3,"6,-18"
15656,720575940627661640,right,T5b,286,0,-24,-12,-12,"0,-24"
15657,720575940617845533,right,T5b,287,-5,13,11,2,"-5,13"
15658,720575940619726727,right,T5b,289,-1,11,6,5,"-1,11"
15659,720575940627584787,right,T5b,290,5,-24,-17,-7,"5,-24"
15660,720575940641563700,right,T5b,291,7,2,-6,8,"7,2"
15661,720575940627212618,right,T5b,292,-4,18,13,5,"-4,18"
15662,720575940615313373,right,T5b,293,4,-17,-13,-4,"4,-17"
15663,720575940630264919,right,T5b,294,1,-20,-11,-9,"1,-20"
15664,720575940626260780,right,T5b,295,-2,29,16,13,"-2,29"
15665,720575940613056218,right,T5b,296,1,-18,-10,-8,"1,-18"
15666,720575940642021773,right,T5b,298,-5,5,7,-2,"-5,5"
15667,720575940629847808,right,T5b,299,-4,12,10,2,"-4,12"
15668,720575940624101709,right,T5b,300,4,-18,-13,-5,"4,-18"
15669,720575940619211480,right,T5b,301,-5,16,13,3,"-5,16"
15670,720575940620645709,right,T5b,302,2,17,6,11,"2,17"
15671,720575940621605997,right,T5b,303,-5,22,16,6,"-5,22"
15672,720575940631024209,right,T5b,304,6,5,-4,9,"6,5"
15673,720575940636419502,right,T5b,305,-7,4,9,-5,"-7,4"
15674,720575940619501982,right,T5b,306,3,7,0,7,"3,7"
15675,720575940639550928,right,T5b,307,5,-25,-18,-7,"5,-25"
15676,720575940620876935,right,T5b,308,-5,8,9,-1,"-5,8"
15677,720575940617251001,right,T5b,309,-6,12,12,0,"-6,12"
15678,720575940629755947,right,T5b,310,2,22,9,13,"2,22"
15679,720575940621720158,right,T5b,311,-7,15,14,1,"-7,15"
15680,720575940631235343,right,T5b,312,4,-7,-8,1,"4,-7"
15681,720575940622710655,right,T5b,313,7,3,-6,9,"7,3"
15682,720575940630204636,right,T5b,314,-9,5,11,-6,"-9,5"
15683,720575940625217661,right,T5b,315,-3,-6,0,-6,"-3,-6"
15684,720575940632682067,right,T5b,316,5,-4,-7,3,"5,-4"
15685,720575940605306726,right,T5b,317,-5,-4,3,-7,"-5,-4"
15686,720575940636011127,right,T5b,318,4,-19,-14,-5,"4,-19"
15687,720575940630341371,right,T5b,319,-2,5,4,1,"-2,5"
15688,720575940620415809,right,T5b,320,-2,-5,-1,-4,"-2,-5"
15689,720575940619868539,right,T5b,322,2,26,11,15,"2,26"
15690,720575940616219353,right,T5b,323,-7,-13,0,-13,"-7,-13"
15691,720575940620346900,right,T5b,324,3,24,9,15,"3,24"
15692,720575940638137140,right,T5b,325,5,1,-5,6,"5,1"
15693,720575940623854077,right,T5b,326,2,16,6,10,"2,16"
15694,720575940612186803,right,T5b,327,5,3,-4,7,"5,3"
15695,720575940613291749,right,T5b,328,5,-9,-10,1,"5,-9"
15696,720575940626638384,right,T5b,329,0,24,12,12,"0,24"
15697,720575940640591924,right,T5b,330,3,3,-2,5,"3,3"
15698,720575940626627076,right,T5b,331,1,-15,-9,-6,"1,-15"
15699,720575940625013948,right,T5b,332,4,-26,-17,-9,"4,-26"
15700,720575940631323663,right,T5b,333,0,-21,-11,-10,"0,-21"
15701,720575940616268866,right,T5b,335,2,8,2,6,"2,8"
15702,720575940629388785,right,T5b,336,0,23,11,12,"0,23"
15703,720575940623165608,right,T5b,337,-5,-6,2,-8,"-5,-6"
15704,720575940624434616,right,T5b,338,-1,0,1,-1,"-1,0"
15705,720575940617516729,right,T5b,339,6,11,-1,12,"6,11"
15706,720575940643754952,right,T5b,340,-4,17,12,5,"-4,17"
15707,720575940631188524,right,T5b,341,6,-17,-15,-2,"6,-17"
15708,720575940622639715,right,T5b,342,2,-15,-10,-5,"2,-15"
15709,720575940628362813,right,T5b,343,-3,27,16,11,"-3,27"
15710,720575940616626945,right,T5b,344,-2,-15,-6,-9,"-2,-15"
15711,720575940615040943,right,T5b,345,3,-12,-9,-3,"3,-12"
15712,720575940621010785,right,T5b,346,-7,-9,2,-11,"-7,-9"
15713,720575940605398304,right,T5b,347,-5,-13,-2,-11,"-5,-13"
15714,720575940631306538,right,T5b,348,3,14,4,10,"3,14"
15715,720575940613804083,right,T5b,349,-5,-14,-2,-12,"-5,-14"
15716,720575940621460872,right,T5b,350,1,15,6,9,"1,15"
15717,720575940630306007,right,T5b,351,-1,-17,-8,-9,"-1,-17"
15718,720575940633168548,right,T5b,352,-2,28,16,12,"-2,28"
15719,720575940610896708,right,T5b,353,2,24,10,14,"2,24"
15720,720575940637227998,right,T5b,355,-7,-6,4,-10,"-7,-6"
15721,720575940629434630,right,T5b,356,0,22,11,11,"0,22"
15722,720575940637873636,right,T5b,357,4,17,4,13,"4,17"
15723,720575940621178806,right,T5b,358,-3,17,11,6,"-3,17"
15724,720575940619867771,right,T5b,359,2,23,9,14,"2,23"
15725,720575940623986439,right,T5b,360,-5,19,14,5,"-5,19"
15726,720575940637536653,right,T5b,361,0,-7,-4,-3,"0,-7"
15727,720575940626193283,right,T5b,362,2,-20,-12,-8,"2,-20"
15728,720575940617643810,right,T5b,363,7,-4,-9,5,"7,-4"
15729,720575940617529378,right,T5b,364,4,4,-2,6,"4,4"
15730,720575940629493626,right,T5b,365,4,7,-1,8,"4,7"
15731,720575940635926008,right,T5b,366,-5,-20,-5,-15,"-5,-20"
15732,720575940624823283,right,T5b,367,-6,-15,-2,-13,"-6,-15"
15733,720575940613718824,right,T5b,368,-4,-20,-6,-14,"-4,-20"
15734,720575940615056790,right,T5b,369,5,-5,-8,3,"5,-5"
15735,720575940608492299,right,T5b,370,-3,21,13,8,"-3,21"
15736,720575940640310480,right,T5b,371,6,-5,-9,4,"6,-5"
15737,720575940620348513,right,T5b,372,1,-2,-2,0,"1,-2"
15738,720575940612945686,right,T5b,373,1,-21,-12,-9,"1,-21"
15739,720575940643532704,right,T5b,374,2,13,4,9,"2,13"
15740,720575940613771246,right,T5b,375,-6,7,9,-2,"-6,7"
15741,720575940647828356,right,T5b,376,-7,-10,2,-12,"-7,-10"
15742,720575940614862226,right,T5b,377,0,7,3,4,"0,7"
15743,720575940626719262,right,T5b,379,3,-17,-12,-5,"3,-17"
15744,720575940607688393,right,T5b,380,-1,29,15,14,"-1,29"
15745,720575940625567762,right,T5b,382,3,-6,-6,0,"3,-6"
15746,720575940636188261,right,T5b,383,-6,11,11,0,"-6,11"
15747,720575940632823912,right,T5b,385,-3,-18,-6,-12,"-3,-18"
15748,720575940627141946,right,T5b,386,-6,19,15,4,"-6,19"
15749,720575940619016408,right,T5b,387,-1,-15,-7,-8,"-1,-15"
15750,720575940617473163,right,T5b,388,3,19,6,13,"3,19"
15751,720575940622436641,right,T5b,389,-6,-16,-2,-14,"-6,-16"
15752,720575940628494588,right,T5b,390,-6,-9,1,-10,"-6,-9"
15753,720575940621816140,right,T5b,391,4,-3,-6,3,"4,-3"
15754,720575940632638253,right,T5b,392,-4,7,7,0,"-4,7"
15755,720575940615674262,right,T5b,393,-1,22,12,10,"-1,22"
15756,720575940624801511,right,T5b,394,-7,-8,3,-11,"-7,-8"
15757,720575940609966690,right,T5b,395,0,-22,-11,-11,"0,-22"
15758,720575940618999461,right,T5b,396,-1,10,6,4,"-1,10"
15759,720575940614672786,right,T5b,397,-3,-19,-7,-12,"-3,-19"
15760,720575940609195971,right,T5b,398,-3,22,14,8,"-3,22"
15761,720575940631525839,right,T5b,399,-4,-24,-8,-16,"-4,-24"
15762,720575940616238009,right,T5b,400,1,-29,-16,-13,"1,-29"
15763,720575940614276002,right,T5b,401,-2,-19,-8,-11,"-2,-19"
15764,720575940612861649,right,T5b,402,3,26,10,16,"3,26"
15765,720575940621985482,right,T5b,403,-2,-12,-4,-8,"-2,-12"
15766,720575940638418246,right,T5b,404,-1,20,11,9,"-1,20"
15767,720575940620237039,right,T5b,405,3,10,2,8,"3,10"
15768,720575940635981167,right,T5b,406,1,-25,-14,-11,"1,-25"
15769,720575940622687757,right,T5b,407,-5,-10,0,-10,"-5,-10"
15770,720575940623725385,right,T5b,408,-6,-4,4,-8,"-6,-4"
15771,720575940622044328,right,T5b,409,0,-3,-2,-1,"0,-3"
15772,720575940632081316,right,T5b,410,-2,-2,1,-3,"-2,-2"
15773,720575940616582027,right,T5b,411,-5,-19,-5,-14,"-5,-19"
15774,720575940615218087,right,T5b,412,-6,21,16,5,"-6,21"
15775,720575940604413664,right,T5b,413,-2,-7,-2,-5,"-2,-7"
15776,720575940621690100,right,T5b,414,4,21,6,15,"4,21"
15777,720575940642268045,right,T5b,415,6,12,0,12,"6,12"
15778,720575940630118871,right,T5b,416,3,-8,-7,-1,"3,-8"
15779,720575940621785377,right,T5b,417,-6,-10,1,-11,"-6,-10"
15780,720575940627757800,right,T5b,418,-2,15,9,6,"-2,15"
15781,720575940624677048,right,T5b,419,-3,-11,-3,-8,"-3,-11"
15782,720575940609201347,right,T5b,420,6,-3,-8,5,"6,-3"
15783,720575940628459536,right,T5b,421,-1,12,7,5,"-1,12"
15784,720575940640587472,right,T5b,422,-7,-4,5,-9,"-7,-4"
15785,720575940643722440,right,T5b,423,3,-18,-12,-6,"3,-18"
15786,720575940610587000,right,T5b,424,-3,-2,2,-4,"-3,-2"
15787,720575940629699063,right,T5b,425,3,20,7,13,"3,20"
15788,720575940603873033,right,T5b,426,-3,0,3,-3,"-3,0"
15789,720575940617495508,right,T5b,427,5,-18,-14,-4,"5,-18"
15790,720575940606926722,right,T5b,428,-2,23,13,10,"-2,23"
15791,720575940654512545,right,T5b,429,-2,14,9,5,"-2,14"
15792,720575940622620874,right,T5b,430,-3,-7,-1,-6,"-3,-7"
15793,720575940604427232,right,T5b,431,-2,-10,-3,-7,"-2,-10"
15794,720575940624514547,right,T5b,432,-5,7,8,-1,"-5,7"
15795,720575940630003983,right,T5b,433,0,-8,-4,-4,"0,-8"
15796,720575940611748216,right,T5b,434,-3,7,6,1,"-3,7"
15797,720575940620289729,right,T5b,435,5,-17,-14,-3,"5,-17"
15798,720575940628376679,right,T5b,436,0,-15,-8,-7,"0,-15"
15799,720575940636270181,right,T5b,437,-3,12,9,3,"-3,12"
15800,720575940639536291,right,T5b,439,-3,-9,-2,-7,"-3,-9"
15801,720575940619396933,right,T5b,440,1,23,10,13,"1,23"
15802,720575940622650723,right,T5b,441,3,-16,-11,-5,"3,-16"
15803,720575940621889206,right,T5b,442,-5,25,17,8,"-5,25"
15804,720575940622120268,right,T5b,443,-6,4,8,-4,"-6,4"
15805,720575940620314305,right,T5b,445,-2,8,6,2,"-2,8"
15806,720575940627887888,right,T5b,446,2,-14,-9,-5,"2,-14"
15807,720575940622983146,right,T5b,447,-1,2,2,0,"-1,2"
15808,720575940629461097,right,T5b,448,0,30,15,15,"0,30"
15809,720575940642267021,right,T5b,449,6,-16,-14,-2,"6,-16"
15810,720575940631527480,right,T5b,450,2,-9,-7,-2,"2,-9"
15811,720575940623287081,right,T5b,451,4,20,6,14,"4,20"
15812,720575940626999689,right,T5b,452,1,-9,-6,-3,"1,-9"
15813,720575940633648526,right,T5b,453,3,25,9,16,"3,25"
15814,720575940619355984,right,T5b,454,5,-12,-11,-1,"5,-12"
15815,720575940631856451,right,T5b,455,7,-7,-11,4,"7,-7"
15816,720575940631816143,right,T5b,456,0,21,10,11,"0,21"
15817,720575940609251523,right,T5b,458,5,0,-5,5,"5,0"
15818,720575940609985860,right,T5b,459,5,-3,-7,4,"5,-3"
15819,720575940617694182,right,T5b,460,-3,-20,-7,-13,"-3,-20"
15820,720575940627842792,right,T5b,461,7,-5,-10,5,"7,-5"
15821,720575940622057804,right,T5b,462,-1,18,10,8,"-1,18"
15822,720575940626835801,right,T5b,463,5,17,3,14,"5,17"
15823,720575940621747580,right,T5b,464,4,0,-4,4,"4,0"
15824,720575940640595252,right,T5b,465,3,0,-3,3,"3,0"
15825,720575940624032747,right,T5b,466,1,14,6,8,"1,14"
15826,720575940617586210,right,T5b,467,-2,-20,-8,-12,"-2,-20"
15827,720575940618962136,right,T5b,468,-3,11,8,3,"-3,11"
15828,720575940638375494,right,T5b,469,-7,13,13,0,"-7,13"
15829,720575940613248435,right,T5b,470,4,-9,-9,0,"4,-9"
15830,720575940621949985,right,T5b,471,3,-26,-16,-10,"3,-26"
15831,720575940628549653,right,T5b,472,1,25,11,14,"1,25"
15832,720575940637741402,right,T5b,473,-4,23,15,8,"-4,23"
15833,720575940613889587,right,T5b,474,-3,-17,-6,-11,"-3,-17"
15834,720575940627415976,right,T5b,475,-4,-1,3,-4,"-4,-1"
15835,720575940626403715,right,T5b,476,-1,15,8,7,"-1,15"
15836,720575940608400139,right,T5b,477,-3,2,4,-2,"-3,2"
15837,720575940620380075,right,T5b,478,-7,16,15,1,"-7,16"
15838,720575940608669379,right,T5b,479,-2,10,7,3,"-2,10"
15839,720575940635021759,right,T5b,480,3,-19,-13,-6,"3,-19"
15840,720575940621092212,right,T5b,482,1,17,7,10,"1,17"
15841,720575940620319323,right,T5b,483,2,-7,-6,-1,"2,-7"
15842,720575940610914010,right,T5b,484,3,-9,-8,-1,"3,-9"
15843,720575940633016019,right,T5b,485,-3,-3,1,-4,"-3,-3"
15844,720575940620414794,right,T5b,486,0,1,0,1,"0,1"
15845,720575940630389445,right,T5b,487,1,-1,-2,1,"1,-1"
15846,720575940638471768,right,T5b,488,7,5,-5,10,"7,5"
15847,720575940621011696,right,T5b,489,-3,10,8,2,"-3,10"
15848,720575940630941714,right,T5b,490,-5,6,8,-2,"-5,6"
15849,720575940618207045,right,T5b,491,7,-1,-8,7,"7,-1"
15850,720575940612064997,right,T5b,492,-7,-2,6,-8,"-7,-2"
15851,720575940627063326,right,T5b,493,-3,23,14,9,"-3,23"
15852,720575940614121443,right,T5b,494,0,29,14,15,"0,29"
15853,720575940614974110,right,T5b,495,4,5,-2,7,"4,5"
15854,720575940639618432,right,T5b,497,6,1,-6,7,"6,1"
15855,720575940620428668,right,T5b,498,6,10,-1,11,"6,10"
15856,720575940624593968,right,T5b,499,5,10,0,10,"5,10"
15857,720575940626638110,right,T5b,501,1,2,0,2,"1,2"
15858,720575940616731665,right,T5b,502,5,8,-1,9,"5,8"
15859,720575940606800073,right,T5b,503,3,17,5,12,"3,17"
15860,720575940626441561,right,T5b,504,-2,9,6,3,"-2,9"
15861,720575940617976389,right,T5b,506,1,-12,-7,-5,"1,-12"
15862,720575940626560220,right,T5b,507,-5,-12,-1,-11,"-5,-12"
15863,720575940627773416,right,T5b,508,-5,11,10,1,"-5,11"
15864,720575940629082684,right,T5b,509,-4,10,9,1,"-4,10"
15865,720575940639396003,right,T5b,510,-2,11,7,4,"-2,11"
15866,720575940634400959,right,T5b,511,5,-11,-11,0,"5,-11"
15867,720575940625663280,right,T5b,512,6,0,-6,6,"6,0"
15868,720575940599459782,right,T5b,513,-4,-13,-3,-10,"-4,-13"
15869,720575940628029306,right,T5b,514,-4,-10,-1,-9,"-4,-10"
15870,720575940631913041,right,T5b,515,-8,-7,4,-11,"-8,-7"
15871,720575940612790442,right,T5b,517,6,3,-5,8,"6,3"
15872,720575940620910171,right,T5b,518,-4,22,15,7,"-4,22"
15873,720575940627312456,right,T5b,519,-5,-5,2,-7,"-5,-5"
15874,720575940627426362,right,T5b,520,-2,-22,-9,-13,"-2,-22"
15875,720575940623536020,right,T5b,521,6,-9,-11,2,"6,-9"
15876,720575940643520160,right,T5b,522,-4,0,4,-4,"-4,0"
15877,720575940618652982,right,T5b,523,2,14,5,9,"2,14"
15878,720575940618665339,right,T5b,525,-1,-20,-9,-11,"-1,-20"
15879,720575940646528308,right,T5b,526,0,-10,-5,-5,"0,-10"
15880,720575940631186596,right,T5b,527,-4,-8,0,-8,"-4,-8"
15881,720575940608276233,right,T5b,528,2,7,1,6,"2,7"
15882,720575940622693119,right,T5b,529,2,-2,-3,1,"2,-2"
15883,720575940624675512,right,T5b,530,-3,-13,-4,-9,"-3,-13"
15884,720575940611067505,right,T5b,531,1,0,-1,1,"1,0"
15885,720575940639446104,right,T5b,532,-8,7,11,-4,"-8,7"
15886,720575940624698040,right,T5b,533,0,-16,-8,-8,"0,-16"
15887,720575940642643252,right,T5b,534,3,2,-2,4,"3,2"
15888,720575940610397230,right,T5b,535,8,-4,-10,6,"8,-4"
15889,720575940624804861,right,T5b,536,3,4,-1,5,"3,4"
15890,720575940626240514,right,T5b,537,0,-23,-12,-11,"0,-23"
15891,720575940627254532,right,T5b,538,-4,1,4,-3,"-4,1"
15892,720575940626210844,right,T5b,539,-6,15,13,2,"-6,15"
15893,720575940626012930,right,T5b,540,-2,-9,-3,-6,"-2,-9"
15894,720575940622685795,right,T5b,541,-4,14,11,3,"-4,14"
15895,720575940621342902,right,T5b,542,6,-13,-13,0,"6,-13"
15896,720575940627859655,right,T5b,543,-1,-4,-1,-3,"-1,-4"
15897,720575940609068227,right,T5b,544,3,-13,-10,-3,"3,-13"
15898,720575940628805019,right,T5b,545,5,11,0,11,"5,11"
15899,720575940628933873,right,T5b,546,3,6,0,6,"3,6"
15900,720575940634467064,right,T5b,547,-1,21,11,10,"-1,21"
15901,720575940611976115,right,T5b,548,1,-16,-9,-7,"1,-16"
15902,720575940617211351,right,T5b,549,0,-9,-5,-4,"0,-9"
15903,720575940623950077,right,T5b,550,-2,3,3,0,"-2,3"
15904,720575940630364983,right,T5b,551,-4,-9,-1,-8,"-4,-9"
15905,720575940607859804,right,T5b,552,4,-1,-5,4,"4,-1"
15906,720575940613877299,right,T5b,553,-3,16,11,5,"-3,16"
15907,720575940614332322,right,T5b,555,-4,9,8,1,"-4,9"
15908,720575940618950221,right,T5b,556,0,10,5,5,"0,10"
15909,720575940624913592,right,T5b,557,6,-10,-11,1,"6,-10"
15910,720575940646792739,right,T5b,558,-4,-21,-7,-14,"-4,-21"
15911,720575940620805568,right,T5b,559,-6,22,17,5,"-6,22"
15912,720575940621975420,right,T5b,560,-7,14,14,0,"-7,14"
15913,720575940622079657,right,T5b,561,5,7,-2,9,"5,7"
15914,720575940628863276,right,T5b,562,-5,-2,4,-6,"-5,-2"
15915,720575940620864877,right,T5b,563,5,-13,-12,-1,"5,-13"
15916,720575940617512121,right,T5b,564,3,-23,-15,-8,"3,-23"
15917,720575940640753104,right,T5b,565,0,-26,-13,-13,"0,-26"
15918,720575940625823376,right,T5b,566,5,-8,-9,1,"5,-8"
15919,720575940614598546,right,T5b,567,-2,22,13,9,"-2,22"
15920,720575940635187557,right,T5b,568,-6,-8,2,-10,"-6,-8"
15921,720575940610070596,right,T5b,569,6,6,-3,9,"6,6"
15922,720575940610895684,right,T5b,570,2,25,10,15,"2,25"
15923,720575940599733446,right,T5b,571,0,-14,-7,-7,"0,-14"
15924,720575940634600287,right,T5b,572,-8,3,9,-6,"-8,3"
15925,720575940628081482,right,T5b,573,4,14,3,11,"4,14"
15926,720575940624439015,right,T5b,574,-6,5,8,-3,"-6,5"
15927,720575940620534624,right,T5b,575,6,9,-2,11,"6,9"
15928,720575940621640027,right,T5b,576,0,28,14,14,"0,28"
15929,720575940630246555,right,T5b,577,5,-14,-12,-2,"5,-14"
15930,720575940628618106,right,T5b,578,4,-11,-10,-1,"4,-11"
15931,720575940640625792,right,T5b,579,-3,-10,-2,-8,"-3,-10"
15932,720575940634215836,right,T5b,580,-2,-23,-10,-13,"-2,-23"
15933,720575940616761617,right,T5b,581,3,9,1,8,"3,9"
15934,720575940633683757,right,T5b,582,-1,23,12,11,"-1,23"
15935,720575940632534988,right,T5b,583,3,-25,-16,-9,"3,-25"
15936,720575940626251909,right,T5b,584,4,23,7,16,"4,23"
15937,720575940625939749,right,T5b,585,-1,-23,-11,-12,"-1,-23"
15938,720575940638400582,right,T5b,586,2,18,7,11,"2,18"
15939,720575940632630611,right,T5b,587,4,22,7,15,"4,22"
15940,720575940624885543,right,T5b,588,1,4,1,3,"1,4"
15941,720575940627523527,right,T5b,589,-1,-5,-2,-3,"-1,-5"
15942,720575940623994860,right,T5b,590,1,9,3,6,"1,9"
15943,720575940624292938,right,T5b,591,3,-3,-5,2,"3,-3"
15944,720575940618053147,right,T5b,593,3,-14,-10,-4,"3,-14"
15945,720575940612962730,right,T5b,594,7,-16,-15,-1,"7,-16"
15946,720575940631330263,right,T5b,595,7,-12,-13,1,"7,-12"
15947,720575940626565852,right,T5b,596,-4,-16,-4,-12,"-4,-16"
15948,720575940630029612,right,T5b,597,4,1,-4,5,"4,1"
15949,720575940604411616,right,T5b,598,2,-18,-11,-7,"2,-18"
15950,720575940626065753,right,T5b,599,-1,9,5,4,"-1,9"
15951,720575940636529765,right,T5b,600,3,-10,-8,-2,"3,-10"
15952,720575940605051052,right,T5b,601,1,16,7,9,"1,16"
15953,720575940629208058,right,T5b,602,4,-2,-5,3,"4,-2"
15954,720575940627727016,right,T5b,603,-3,-23,-9,-14,"-3,-23"
15955,720575940627484041,right,T5b,604,-6,-17,-3,-14,"-6,-17"
15956,720575940630884203,right,T5b,605,3,15,4,11,"3,15"
15957,720575940619367872,right,T5b,606,-1,-19,-9,-10,"-1,-19"
15958,720575940619556987,right,T5b,607,1,18,8,10,"1,18"
15959,720575940618939469,right,T5b,608,1,10,4,6,"1,10"
15960,720575940622680456,right,T5b,609,-2,0,2,-2,"-2,0"
15961,720575940632216290,right,T5b,610,2,-23,-14,-9,"2,-23"
15962,720575940626979461,right,T5b,611,-1,-18,-8,-10,"-1,-18"
15963,720575940621321057,right,T5b,612,-3,-26,-10,-16,"-3,-26"
15964,720575940632643501,right,T5b,614,-2,-8,-2,-6,"-2,-8"
15965,720575940605238705,right,T5b,615,-7,-7,3,-10,"-7,-7"
15966,720575940610587972,right,T5b,616,-3,15,10,5,"-3,15"
15967,720575940604778156,right,T5b,617,-2,-17,-7,-10,"-2,-17"
15968,720575940632179983,right,T5b,618,-1,24,13,11,"-1,24"
15969,720575940634346592,right,T5b,619,-4,-19,-6,-13,"-4,-19"
15970,720575940641563188,right,T5b,620,7,1,-7,8,"7,1"
15971,720575940615887775,right,T5b,622,-5,20,15,5,"-5,20"
15972,720575940613219751,right,T5b,623,1,13,5,8,"1,13"
15973,720575940631560504,right,T5b,624,1,-17,-10,-7,"1,-17"
15974,720575940641133557,right,T5b,625,-2,24,14,10,"-2,24"
15975,720575940621645829,right,T5b,626,-5,-8,1,-9,"-5,-8"
15976,720575940614417887,right,T5b,627,0,-1,-1,0,"0,-1"
15977,720575940625204226,right,T5b,628,0,0,0,0,"0,0"
15978,720575940638037318,right,T5b,629,4,24,8,16,"4,24"
15979,720575940644526024,right,T5b,630,4,8,0,8,"4,8"
15980,720575940615247839,right,T5b,632,3,-20,-13,-7,"3,-20"
15981,720575940604084704,right,T5b,633,-1,-24,-11,-13,"-1,-24"
15982,720575940634722239,right,T5b,634,-3,-15,-5,-10,"-3,-15"
15983,720575940630729320,right,T5b,635,6,-6,-9,3,"6,-6"
15984,720575940649801081,right,T5b,636,0,6,3,3,"0,6"
15985,720575940612661418,right,T5b,637,3,-21,-14,-7,"3,-21"
15986,720575940643561888,right,T5b,638,-1,7,4,3,"-1,7"
15987,720575940631501123,right,T5b,639,-4,19,13,6,"-4,19"
15988,720575940621745441,right,T5b,640,-1,-16,-7,-9,"-1,-16"
15989,720575940613020018,right,T5b,641,-8,-5,5,-10,"-8,-5"
15990,720575940624740091,right,T5b,642,-5,-11,-1,-10,"-5,-11"
15991,720575940612489113,right,T5b,643,6,14,1,13,"6,14"
15992,720575940627062291,right,T5b,644,-6,18,15,3,"-6,18"
15993,720575940645277207,right,T5b,645,-4,27,17,10,"-4,27"
15994,720575940641178075,right,T5b,647,-4,-7,0,-7,"-4,-7"
15995,720575940617340736,right,T5b,648,1,7,2,5,"1,7"
15996,720575940625961516,right,T5b,649,-1,5,3,2,"-1,5"
15997,720575940623596435,right,T5b,650,-3,-25,-10,-15,"-3,-25"
15998,720575940621680252,right,T5b,651,-4,-5,1,-6,"-4,-5"
15999,720575940603714652,right,T5b,652,-6,-11,0,-11,"-6,-11"
16000,720575940607204530,right,T5b,653,-6,-12,0,-12,"-6,-12"
16001,720575940635237044,right,T5b,654,-3,8,7,1,"-3,8"
16002,720575940609601092,right,T5b,655,6,-1,-7,6,"6,-1"
16003,720575940619929765,right,T5b,656,0,-11,-6,-5,"0,-11"
16004,720575940635192159,right,T5b,657,-2,-25,-11,-14,"-2,-25"
16005,720575940622981325,right,T5b,658,1,20,9,11,"1,20"
16006,720575940630588367,right,T5b,659,-4,-6,1,-7,"-4,-6"
16007,720575940624885429,right,T5b,660,2,28,12,16,"2,28"
16008,720575940652191734,right,T5b,661,-3,14,10,4,"-3,14"
16009,720575940634890095,right,T5b,662,2,-1,-3,2,"2,-1"
16010,720575940620765025,right,T5b,663,0,8,4,4,"0,8"
16011,720575940630364160,right,T5b,664,1,-27,-15,-12,"1,-27"
16012,720575940612030437,right,T5b,665,7,-2,-8,6,"7,-2"
16013,720575940602140862,right,T5b,667,1,-28,-15,-13,"1,-28"
16014,720575940623023103,right,T5b,668,1,19,8,11,"1,19"
16015,720575940621151809,right,T5b,669,4,-16,-12,-4,"4,-16"
16016,720575940620928321,right,T5b,670,5,5,-3,8,"5,5"
16017,720575940634206576,right,T5b,671,-4,-23,-8,-15,"-4,-23"
16018,720575940630972178,right,T5b,672,-8,11,13,-2,"-8,11"
16019,720575940647036804,right,T5b,673,2,5,0,5,"2,5"
16020,720575940639037006,right,T5b,674,-4,-14,-3,-11,"-4,-14"
16021,720575940638379846,right,T5b,675,-7,19,16,3,"-7,19"
16022,720575940633355987,right,T5b,676,-3,-21,-8,-13,"-3,-21"
16023,720575940617750299,right,T5b,677,0,11,5,6,"0,11"
16024,720575940628083530,right,T5b,678,3,-7,-7,0,"3,-7"
16025,720575940623731396,right,T5b,679,4,18,5,13,"4,18"
16026,720575940628482447,right,T5b,680,-1,25,13,12,"-1,25"
16027,720575940606835074,right,T5b,681,-2,-21,-9,-12,"-2,-21"
16028,720575940621949022,right,T5b,682,6,-8,-10,2,"6,-8"
16029,720575940612660520,right,T5b,683,2,6,1,5,"2,6"
16030,720575940636601572,right,T5b,684,-6,17,14,3,"-6,17"
16031,720575940610865614,right,T5b,685,-5,-9,0,-9,"-5,-9"
16032,720575940633078829,right,T5b,686,5,-22,-16,-6,"5,-22"
16033,720575940630614981,right,T5b,687,-6,-3,4,-7,"-6,-3"
16034,720575940617634594,right,T5b,688,-7,10,12,-2,"-7,10"
16035,720575940616989243,right,T5b,689,-2,18,11,7,"-2,18"
16036,720575940654668193,right,T5b,690,-7,-3,5,-8,"-7,-3"
16037,720575940641171931,right,T5b,691,-9,4,11,-7,"-9,4"
16038,720575940613342873,right,T5b,692,-4,24,16,8,"-4,24"
16039,720575940616809333,right,T5b,693,-3,25,15,10,"-3,25"
16040,720575940631295483,right,T5b,694,4,3,-3,6,"4,3"
16041,720575940638806591,right,T5b,695,-6,10,11,-1,"-6,10"
16042,720575940622765508,right,T5b,696,-2,16,10,6,"-2,16"
16043,720575940630221980,right,T5b,697,1,-22,-12,-10,"1,-22"
16044,720575940625210130,right,T5b,698,6,-7,-10,3,"6,-7"
16045,720575940642467636,right,T5b,699,-5,0,5,-5,"-5,0"
16046,720575940616344849,right,T5b,700,5,15,2,13,"5,15"
16047,720575940644801902,right,T5b,701,0,-4,-2,-2,"0,-4"
16048,720575940615329951,right,T5b,702,-5,23,16,7,"-5,23"
16049,720575940615362866,right,T5b,703,-3,1,3,-2,"-3,1"
16050,720575940643618327,right,T5b,704,-7,8,11,-3,"-7,8"
16051,720575940637406180,right,T5b,705,1,1,-1,2,"1,1"
16052,720575940621915814,right,T5b,707,-2,25,14,11,"-2,25"
16053,720575940606014310,right,T5b,708,-4,-25,-9,-16,"-4,-25"
16054,720575940623337510,right,T5b,709,-2,-24,-10,-14,"-2,-24"
16055,720575940615556255,right,T5b,710,4,-25,-17,-8,"4,-25"
16056,720575940614382226,right,T5b,711,-1,19,10,9,"-1,19"
16057,720575940636384398,right,T5b,712,-7,12,13,-1,"-7,12"
16058,720575940660737921,right,T5b,713,-6,16,14,2,"-6,16"
16059,720575940636024183,right,T5b,714,5,12,1,11,"5,12"
16060,720575940631368259,right,T5b,715,4,10,1,9,"4,10"
16061,720575940631408203,right,T5b,716,4,-6,-7,1,"4,-6"
16062,720575940614708642,right,T5b,717,2,-22,-13,-9,"2,-22"
16063,720575940646796835,right,T5b,718,-5,24,17,7,"-5,24"
16064,720575940610895940,right,T5b,719,1,27,12,15,"1,27"
16065,720575940627254842,right,T5b,720,-5,21,15,6,"-5,21"
16066,720575940638040142,right,T5b,721,5,13,1,12,"5,13"
16067,720575940644916759,right,T5b,722,6,-15,-14,-1,"6,-15"
16068,720575940639771008,right,T5b,723,-2,-11,-4,-7,"-2,-11"
16069,720575940641644084,right,T5b,724,4,2,-3,5,"4,2"
16070,720575940619923029,right,T5b,725,-3,-24,-9,-15,"-3,-24"
16071,720575940633142497,right,T5b,727,7,6,-4,10,"7,6"
16072,720575940630964561,right,T5b,728,7,12,-1,13,"7,12"
16073,720575940647289396,right,T5b,729,-3,29,17,12,"-3,29"
16074,720575940614986719,right,T5b,731,-6,9,10,-1,"-6,9"
16075,720575940605408870,right,T5b,732,-3,6,6,0,"-3,6"
16076,720575940624822771,right,T5b,733,-5,-17,-4,-13,"-5,-17"
16077,720575940627262440,right,T5b,734,2,0,-2,2,"2,0"
16078,720575940636378999,right,T5b,735,1,-23,-13,-10,"1,-23"
16079,720575940612068581,right,T5b,736,-8,1,8,-7,"-8,1"
16080,720575940628576450,right,T5b,737,0,19,9,10,"0,19"
16081,720575940627043859,right,T5b,738,-3,13,9,4,"-3,13"
16082,720575940613606575,right,T5b,739,-7,2,8,-6,"-7,2"
16083,720575940633962853,right,T5b,740,2,-8,-6,-2,"2,-8"
16084,720575940599763910,right,T5b,741,-2,-14,-5,-9,"-2,-14"
16085,720575940627134010,right,T5b,742,-4,11,9,2,"-4,11"
16086,720575940623866153,right,T5b,744,-4,25,16,9,"-4,25"
16087,720575940626101788,right,T5b,745,0,13,6,7,"0,13"
16088,720575940627323157,right,T5b,746,-3,3,4,-1,"-3,3"
16089,720575940625686801,right,T5b,747,0,2,1,1,"0,2"
16090,720575940624556263,right,T5b,748,-4,20,14,6,"-4,20"
16091,720575940620275053,right,T5b,749,-2,1,2,-1,"-2,1"
16092,720575940624313068,right,T5b,750,4,-24,-16,-8,"4,-24"
16093,720575940629472638,right,T5b,751,1,6,2,4,"1,6"
16094,720575940613747562,right,T5b,752,-2,7,5,2,"-2,7"
16095,720575940642665101,right,T5b,753,-3,24,15,9,"-3,24"
16096,720575940616302292,right,T5b,754,-1,-13,-6,-7,"-1,-13"
16097,720575940617880916,right,T5b,755,4,19,5,14,"4,19"
16098,720575940620474817,right,T5b,756,5,20,5,15,"5,20"
16099,720575940613064165,right,T5b,757,0,-6,-3,-3,"0,-6"
16100,720575940627090002,right,T5b,758,5,-1,-6,5,"5,-1"
16101,720575940624323657,right,T5b,759,7,14,0,14,"7,14"
16102,720575940617638814,right,T5b,760,0,17,8,9,"0,17"
16103,720575940633548499,right,T5b,761,-4,-18,-5,-13,"-4,-18"
16104,720575940619232216,right,T5b,762,0,14,7,7,"0,14"
16105,720575940604811692,right,T5b,763,-5,14,12,2,"-5,14"
16106,720575940624757739,right,T5b,764,-8,-6,5,-11,"-8,-6"
16107,720575940631628345,right,T5b,765,-3,9,7,2,"-3,9"
16108,720575940618198395,right,T5b,766,2,-4,-4,0,"2,-4"
16109,720575940616748817,right,T5b,768,3,5,-1,6,"3,5"
16110,720575940643679688,right,T5b,770,5,4,-3,7,"5,4"
16111,720575940646648372,right,T5b,772,1,12,5,7,"1,12"
16112,720575940634866799,right,T5b,773,5,-19,-15,-4,"5,-19"
16113,720575940626161922,right,T5b,774,-8,6,11,-5,"-8,6"
16114,720575940610805858,right,T5b,775,5,22,6,16,"5,22"
16115,720575940639464867,right,T5b,777,6,20,4,16,"6,20"
16116,720575940630560763,right,T5b,778,4,25,8,17,"4,25"
16117,720575940646798883,right,T5b,780,-6,25,18,7,"-6,25"
16118,720575940610367812,right,T5b,781,-5,26,18,8,"-5,26"
16119,720575940627530045,right,T5b,782,-5,27,18,9,"-5,27"
16120,720575940618265940,right,T5b,783,-4,28,18,10,"-4,28"
16121,720575940627521597,right,T5b,784,-4,29,18,11,"-4,29"
16122,720575940621225069,right,T5b,786,-2,30,17,13,"-2,30"
16123,720575940611836309,right,T5b,787,3,28,11,17,"3,28"
16124,720575940616174292,right,T5b,790,-2,-27,-12,-15,"-2,-27"
16125,720575940638991413,right,T5c,1,-6,13,12,1,"-6,13"
16126,720575940620353883,right,T5c,2,-8,2,9,-7,"-8,2"
16127,720575940627191823,right,T5c,3,6,-12,-12,0,"6,-12"
16128,720575940639551797,right,T5c,4,-5,-21,-6,-15,"-5,-21"
16129,720575940640993525,right,T5c,5,-1,16,9,7,"-1,16"
16130,720575940621161640,right,T5c,6,-2,-4,0,-4,"-2,-4"
16131,720575940620162241,right,T5c,7,-6,-6,3,-9,"-6,-6"
16132,720575940629797180,right,T5c,8,-4,26,17,9,"-4,26"
16133,720575940632593735,right,T5c,9,4,9,0,9,"4,9"
16134,720575940626419986,right,T5c,10,5,-15,-13,-2,"5,-15"
16135,720575940632233287,right,T5c,11,7,-14,-14,0,"7,-14"
16136,720575940623059238,right,T5c,12,-7,9,11,-2,"-7,9"
16137,720575940627295896,right,T5c,13,-1,-26,-12,-14,"-1,-26"
16138,720575940619893208,right,T5c,14,0,-27,-14,-13,"0,-27"
16139,720575940621428724,right,T5c,15,2,-3,-4,1,"2,-3"
16140,720575940610814682,right,T5c,16,-2,-16,-6,-10,"-2,-16"
16141,720575940639452750,right,T5c,17,1,-5,-4,-1,"1,-5"
16142,720575940640102528,right,T5c,18,5,-16,-13,-3,"5,-16"
16143,720575940625174605,right,T5c,19,-7,17,15,2,"-7,17"
16144,720575940629421182,right,T5c,20,3,-11,-9,-2,"3,-11"
16145,720575940623790947,right,T5c,21,-2,19,11,8,"-2,19"
16146,720575940627420181,right,T5c,22,-1,3,2,1,"-1,3"
16147,720575940627024698,right,T5c,23,-3,-16,-5,-11,"-3,-16"
16148,720575940641180123,right,T5c,24,-1,-10,-4,-6,"-1,-10"
16149,720575940613086179,right,T5c,25,-9,3,10,-7,"-9,3"
16150,720575940624971341,right,T5c,26,1,-3,-3,0,"1,-3"
16151,720575940622298515,right,T5c,27,0,-25,-13,-12,"0,-25"
16152,720575940609898308,right,T5c,28,5,6,-2,8,"5,6"
16153,720575940633242649,right,T5c,29,-1,-3,-1,-2,"-1,-3"
16154,720575940631493739,right,T5c,30,6,16,2,14,"6,16"
16155,720575940635093785,right,T5c,31,0,16,8,8,"0,16"
16156,720575940624170061,right,T5c,32,0,12,6,6,"0,12"
16157,720575940622010956,right,T5c,33,3,18,6,12,"3,18"
16158,720575940620368043,right,T5c,34,6,18,3,15,"6,18"
16159,720575940621365313,right,T5c,35,1,-24,-13,-11,"1,-24"
16160,720575940620550240,right,T5c,36,6,8,-2,10,"6,8"
16161,720575940622930505,right,T5c,37,1,5,1,4,"1,5"
16162,720575940633332505,right,T5c,38,0,-2,-1,-1,"0,-2"
16163,720575940626942508,right,T5c,39,0,20,10,10,"0,20"
16164,720575940612499222,right,T5c,40,-2,-6,-1,-5,"-2,-6"
16165,720575940624249607,right,T5c,41,-3,28,17,11,"-3,28"
16166,720575940639560867,right,T5c,42,-1,14,8,6,"-1,14"
16167,720575940614724502,right,T5c,43,-5,18,14,4,"-5,18"
16168,720575940627256634,right,T5c,44,5,-10,-10,0,"5,-10"
16169,720575940606592713,right,T5c,45,-5,-1,4,-5,"-5,-1"
16170,720575940620559469,right,T5c,46,-5,15,12,3,"-5,15"
16171,720575940619616203,right,T5c,47,-9,-1,8,-9,"-9,-1"
16172,720575940619692710,right,T5c,48,-4,-22,-7,-15,"-4,-22"
16173,720575940613550376,right,T5c,49,4,-4,-6,2,"4,-4"
16174,720575940615931186,right,T5c,50,-2,21,12,9,"-2,21"
16175,720575940626427544,right,T5c,51,0,-19,-10,-9,"0,-19"
16176,720575940609351516,right,T5c,52,-1,-22,-10,-12,"-1,-22"
16177,720575940616091954,right,T5c,53,5,14,2,12,"5,14"
16178,720575940618314048,right,T5c,54,-4,3,5,-2,"-4,3"
16179,720575940623864503,right,T5c,55,-4,-11,-2,-9,"-4,-11"
16180,720575940635196528,right,T5c,56,1,-13,-8,-5,"1,-13"
16181,720575940640014464,right,T5c,57,6,-11,-12,1,"6,-11"
16182,720575940623116582,right,T5c,58,3,12,3,9,"3,12"
16183,720575940611606165,right,T5c,59,-2,2,3,-1,"-2,2"
16184,720575940605304166,right,T5c,61,-4,-4,2,-6,"-4,-4"
16185,720575940626424005,right,T5c,63,4,12,2,10,"4,12"
16186,720575940629713719,right,T5c,64,4,-23,-16,-7,"4,-23"
16187,720575940637713326,right,T5c,65,-1,28,15,13,"-1,28"
16188,720575940632564781,right,T5c,66,2,15,5,10,"2,15"
16189,720575940616586891,right,T5c,67,-2,-13,-5,-8,"-2,-13"
16190,720575940620944566,right,T5c,68,3,16,5,11,"3,16"
16191,720575940615213983,right,T5c,69,1,8,3,5,"1,8"
16192,720575940623921677,right,T5c,70,-4,21,14,7,"-4,21"
16193,720575940619025601,right,T5c,71,-2,-3,0,-3,"-2,-3"
16194,720575940618119970,right,T5c,72,0,-28,-14,-14,"0,-28"
16195,720575940643808712,right,T5c,73,2,2,-1,3,"2,2"
16196,720575940627215377,right,T5c,74,-1,-9,-4,-5,"-1,-9"
16197,720575940622154828,right,T5c,75,-6,14,13,1,"-6,14"
16198,720575940626923530,right,T5c,76,-3,-4,1,-5,"-3,-4"
16199,720575940624193866,right,T5c,77,2,-5,-5,0,"2,-5"
16200,720575940621111472,right,T5c,78,2,20,8,12,"2,20"
16201,720575940625474435,right,T5c,79,2,1,-2,3,"2,1"
16202,720575940620075941,right,T5c,80,4,13,2,11,"4,13"
16203,720575940632240465,right,T5c,81,6,-2,-7,5,"6,-2"
16204,720575940620765862,right,T5c,82,-7,7,10,-3,"-7,7"
16205,720575940631346892,right,T5c,83,2,-21,-13,-8,"2,-21"
16206,720575940637799231,right,T5c,84,-2,12,8,4,"-2,12"
16207,720575940630092288,right,T5c,85,4,-22,-15,-7,"4,-22"
16208,720575940636074853,right,T5c,86,-5,-7,1,-8,"-5,-7"
16209,720575940619067213,right,T5c,87,1,11,4,7,"1,11"
16210,720575940616667509,right,T5c,88,7,4,-5,9,"7,4"
16211,720575940653680545,right,T5c,89,1,-19,-11,-8,"1,-19"
16212,720575940636536238,right,T5c,90,-4,5,6,-1,"-4,5"
16213,720575940605384736,right,T5c,91,-1,6,4,2,"-1,6"
16214,720575940634414783,right,T5c,92,0,9,4,5,"0,9"
16215,720575940596125868,right,T5c,93,-6,3,7,-4,"-6,3"
16216,720575940633746713,right,T5c,94,5,18,4,14,"5,18"
16217,720575940629804087,right,T5c,95,4,-21,-15,-6,"4,-21"
16218,720575940624746573,right,T5c,96,1,-10,-6,-4,"1,-10"
16219,720575940620572737,right,T5c,97,-5,2,6,-4,"-5,2"
16220,720575940623601993,right,T5c,98,-1,-12,-5,-7,"-1,-12"
16221,720575940659821697,right,T5c,99,4,15,3,12,"4,15"
16222,720575940632442707,right,T5c,100,2,-10,-7,-3,"2,-10"
16223,720575940630594135,right,T5c,101,-7,6,10,-4,"-7,6"
16224,720575940623647975,right,T5c,102,3,13,3,10,"3,13"
16225,720575940619344344,right,T5c,103,7,9,-3,12,"7,9"
16226,720575940630305271,right,T5c,104,-1,-27,-13,-14,"-1,-27"
16227,720575940639916789,right,T5c,105,3,22,8,14,"3,22"
16228,720575940606601417,right,T5c,106,-7,11,12,-1,"-7,11"
16229,720575940604782764,right,T5c,108,-3,-12,-3,-9,"-3,-12"
16230,720575940615280962,right,T5c,109,4,-5,-7,2,"4,-5"
16231,720575940642512692,right,T5c,110,-7,0,7,-7,"-7,0"
16232,720575940625779146,right,T5c,111,2,-24,-14,-10,"2,-24"
16233,720575940608661187,right,T5c,112,-6,1,6,-5,"-6,1"
16234,720575940618475569,right,T5c,113,-2,4,4,0,"-2,4"
16235,720575940620767073,right,T5c,114,2,-13,-9,-4,"2,-13"
16236,720575940605773233,right,T5c,115,-4,2,5,-3,"-4,2"
16237,720575940640646029,right,T5c,116,-1,-8,-3,-5,"-1,-8"
16238,720575940606612098,right,T5c,117,-8,-2,7,-9,"-8,-2"
16239,720575940614147123,right,T5c,118,3,1,-3,4,"3,1"
16240,720575940615611846,right,T5c,119,-2,6,5,1,"-2,6"
16241,720575940629205698,right,T5c,120,-1,-1,0,-1,"-1,-1"
16242,720575940624419303,right,T5c,121,-8,4,10,-6,"-8,4"
16243,720575940636450935,right,T5c,122,-5,9,9,0,"-5,9"
16244,720575940638518325,right,T5c,124,1,-7,-5,-2,"1,-7"
16245,720575940616725009,right,T5c,125,5,9,-1,10,"5,9"
16246,720575940617943124,right,T5c,126,3,11,2,9,"3,11"
16247,720575940628035402,right,T5c,127,0,15,7,8,"0,15"
16248,720575940627798037,right,T5c,128,3,-22,-14,-8,"3,-22"
16249,720575940642712520,right,T5c,129,0,-13,-7,-6,"0,-13"
16250,720575940631505219,right,T5c,130,2,12,4,8,"2,12"
16251,720575940631172665,right,T5c,132,2,4,0,4,"2,4"
16252,720575940621023493,right,T5c,133,-3,20,13,7,"-3,20"
16253,720575940626092290,right,T5c,134,-5,-18,-4,-14,"-5,-18"
16254,720575940638638820,right,T5c,135,-3,-22,-8,-14,"-3,-22"
16255,720575940620148673,right,T5c,136,0,3,1,2,"0,3"
16256,720575940637214349,right,T5c,137,5,-7,-9,2,"5,-7"
16257,720575940619869051,right,T5c,138,0,27,13,14,"0,27"
16258,720575940617634388,right,T5c,139,1,-14,-8,-6,"1,-14"
16259,720575940616819729,right,T5c,140,3,8,1,7,"3,8"
16260,720575940639040846,right,T5c,142,-2,-18,-7,-11,"-2,-18"
16261,720575940640525776,right,T5c,143,-4,16,12,4,"-4,16"
16262,720575940627091593,right,T5c,144,7,-11,-13,2,"7,-11"
16263,720575940632148051,right,T5c,145,0,4,2,2,"0,4"
16264,720575940624226633,right,T5c,146,1,-6,-4,-2,"1,-6"
16265,720575940617254801,right,T5c,147,1,21,9,12,"1,21"
16266,720575940642395533,right,T5c,148,-7,-11,1,-12,"-7,-11"
16267,720575940615901382,right,T5c,149,6,-14,-13,-1,"6,-14"
16268,720575940631277866,right,T5c,150,-8,5,10,-5,"-8,5"
16269,720575940620723521,right,T5c,151,-3,-14,-4,-10,"-3,-14"
16270,720575940635690351,right,T5c,152,3,-15,-11,-4,"3,-15"
16271,720575940622929958,right,T5c,154,-8,0,8,-8,"-8,0"
16272,720575940641056308,right,T5c,156,-9,1,9,-8,"-9,1"
16273,720575940631716781,right,T5c,157,-1,-7,-3,-4,"-1,-7"
16274,720575940624280906,right,T5c,158,3,-5,-6,1,"3,-5"
16275,720575940616250041,right,T5c,159,7,7,-4,11,"7,7"
16276,720575940619804752,right,T5c,160,-2,20,12,8,"-2,20"
16277,720575940637751949,right,T5c,161,4,-14,-11,-3,"4,-14"
16278,720575940625655754,right,T5c,162,-4,-2,3,-5,"-4,-2"
16279,720575940637404132,right,T5c,164,-1,-2,0,-2,"-1,-2"
16280,720575940624922552,right,T5c,165,4,16,4,12,"4,16"
16281,720575940620674125,right,T5c,166,0,18,9,9,"0,18"
16282,720575940630906130,right,T5c,167,0,-17,-9,-8,"0,-17"
16283,720575940620910957,right,T5c,168,-1,17,9,8,"-1,17"
16284,720575940631025995,right,T5c,169,0,-18,-9,-9,"0,-18"
16285,720575940629012839,right,T5c,170,-5,1,5,-4,"-5,1"
16286,720575940628415050,right,T5c,171,6,-20,-16,-4,"6,-20"
16287,720575940620419008,right,T5c,173,2,-25,-15,-10,"2,-25"
16288,720575940615230523,right,T5c,174,4,-15,-12,-3,"4,-15"
16289,720575940630456151,right,T5c,175,-6,-7,2,-9,"-6,-7"
16290,720575940634189790,right,T5c,176,-2,13,8,5,"-2,13"
16291,720575940610065614,right,T5c,177,-2,-1,1,-2,"-2,-1"
16292,720575940622391821,right,T5c,178,2,11,3,8,"2,11"
16293,720575940633400986,right,T5c,179,-5,-16,-3,-13,"-5,-16"
16294,720575940629955778,right,T5c,180,2,-27,-16,-11,"2,-27"
16295,720575940622047656,right,T5c,181,1,-4,-3,-1,"1,-4"
16296,720575940624033353,right,T5c,182,7,-10,-12,2,"7,-10"
16297,720575940624533392,right,T5c,183,-5,-15,-3,-12,"-5,-15"
16298,720575940640806133,right,T5c,184,-6,-5,3,-8,"-6,-5"
16299,720575940602790610,right,T5c,185,2,-11,-8,-3,"2,-11"
16300,720575940606807729,right,T5c,186,-1,26,14,12,"-1,26"
16301,720575940630582523,right,T5c,187,3,21,7,14,"3,21"
16302,720575940617782941,right,T5c,188,-5,17,13,4,"-5,17"
16303,720575940620591494,right,T5c,189,6,13,0,13,"6,13"
16304,720575940618600059,right,T5c,190,-3,-5,0,-5,"-3,-5"
16305,720575940628259689,right,T5c,191,-1,-11,-5,-6,"-1,-11"
16306,720575940616316884,right,T5c,192,7,10,-2,12,"7,10"
16307,720575940621678204,right,T5c,193,-5,4,7,-3,"-5,4"
16308,720575940622048168,right,T5c,194,0,-5,-3,-2,"0,-5"
16309,720575940616936285,right,T5c,195,-3,-1,2,-3,"-3,-1"
16310,720575940605394022,right,T5c,196,-1,8,5,3,"-1,8"
16311,720575940605734944,right,T5c,197,0,-20,-10,-10,"0,-20"
16312,720575940634316439,right,T5c,198,6,2,-5,7,"6,2"
16313,720575940627264168,right,T5c,199,0,-12,-6,-6,"0,-12"
16314,720575940621921916,right,T5c,200,-5,12,11,1,"-5,12"
16315,720575940615745548,right,T5c,201,-8,9,12,-3,"-8,9"
16316,720575940633637805,right,T5c,202,-1,27,14,13,"-1,27"
16317,720575940609274819,right,T5c,203,3,-1,-4,3,"3,-1"
16318,720575940627992519,right,T5c,204,5,-2,-6,4,"5,-2"
16319,720575940619332312,right,T5c,205,5,-6,-8,2,"5,-6"
16320,720575940632541838,right,T5c,206,-3,5,5,0,"-3,5"
16321,720575940630591358,right,T5c,207,1,29,13,16,"1,29"
16322,720575940612463511,right,T5c,208,5,-21,-16,-5,"5,-21"
16323,720575940608954307,right,T5c,209,-3,-8,-1,-7,"-3,-8"
16324,720575940625748426,right,T5c,210,-6,8,10,-2,"-6,8"
16325,720575940620190656,right,T5c,211,-7,-1,6,-7,"-7,-1"
16326,720575940630342907,right,T5c,212,2,-16,-10,-6,"2,-16"
16327,720575940618607262,right,T5c,213,3,-4,-5,1,"3,-4"
16328,720575940613608232,right,T5c,214,-5,3,6,-3,"-5,3"
16329,720575940622383692,right,T5c,215,6,7,-3,10,"6,7"
16330,720575940632211667,right,T5c,216,2,19,7,12,"2,19"
16331,720575940620651361,right,T5c,217,6,15,1,14,"6,15"
16332,720575940610649810,right,T5c,218,2,10,3,7,"2,10"
16333,720575940605413385,right,T5c,219,6,-4,-8,4,"6,-4"
16334,720575940633641186,right,T5c,220,2,-6,-5,-1,"2,-6"
16335,720575940632191652,right,T5c,221,-7,3,8,-5,"-7,3"
16336,720575940627976018,right,T5c,222,-3,26,16,10,"-3,26"
16337,720575940638184937,right,T5c,223,-2,26,15,11,"-2,26"
16338,720575940633685982,right,T5c,224,0,5,2,3,"0,5"
16339,720575940621023926,right,T5c,225,2,-26,-15,-11,"2,-26"
16340,720575940641040781,right,T5c,226,5,19,4,15,"5,19"
16341,720575940625779386,right,T5c,227,-7,5,9,-4,"-7,5"
16342,720575940621552133,right,T5c,228,-7,1,7,-6,"-7,1"
16343,720575940621617647,right,T5c,229,5,2,-4,6,"5,2"
16344,720575940630559991,right,T5c,230,2,9,2,7,"2,9"
16345,720575940628324346,right,T5c,231,4,-12,-10,-2,"4,-12"
16346,720575940620773953,right,T5c,232,-4,13,10,3,"-4,13"
16347,720575940636896909,right,T5c,233,4,-13,-11,-2,"4,-13"
16348,720575940633684446,right,T5c,234,1,3,0,3,"1,3"
16349,720575940606821506,right,T5c,235,4,11,1,10,"4,11"
16350,720575940632272782,right,T5c,236,-1,4,3,1,"-1,4"
16351,720575940620207952,right,T5c,237,-2,27,15,12,"-2,27"
16352,720575940628104710,right,T5c,239,-6,6,9,-3,"-6,6"
16353,720575940626578045,right,T5c,240,-4,-3,2,-5,"-4,-3"
16354,720575940614971005,right,T5c,241,2,-17,-11,-6,"2,-17"
16355,720575940643735752,right,T5c,242,-4,6,7,-1,"-4,6"
16356,720575940604900832,right,T5c,243,-1,-21,-10,-11,"-1,-21"
16357,720575940625859940,right,T5c,244,-4,-12,-2,-10,"-4,-12"
16358,720575940625796282,right,T5c,246,-4,15,11,4,"-4,15"
16359,720575940605371494,right,T5c,247,-4,-15,-4,-11,"-4,-15"
16360,720575940616606779,right,T5c,248,-6,0,6,-6,"-6,0"
16361,720575940637296862,right,T5c,249,2,-12,-8,-4,"2,-12"
16362,720575940623645959,right,T5c,250,-1,1,1,0,"-1,1"
16363,720575940620970081,right,T5c,251,-1,-14,-6,-8,"-1,-14"
16364,720575940622377571,right,T5c,253,5,16,3,13,"5,16"
16365,720575940618229332,right,T5c,254,3,-24,-15,-9,"3,-24"
16366,720575940608253961,right,T5c,255,-6,-13,-1,-12,"-6,-13"
16367,720575940633651737,right,T5c,256,5,-20,-15,-5,"5,-20"
16368,720575940612543146,right,T5c,257,2,21,8,13,"2,21"
16369,720575940631575096,right,T5c,258,-4,-17,-5,-12,"-4,-17"
16370,720575940606622082,right,T5c,259,-7,-5,4,-9,"-7,-5"
16371,720575940631802937,right,T5c,260,-3,19,12,7,"-3,19"
16372,720575940629820972,right,T5c,261,-1,13,7,6,"-1,13"
16373,720575940616740027,right,T5c,262,1,-11,-7,-4,"1,-11"
16374,720575940614246055,right,T5c,263,-3,4,5,-1,"-3,4"
16375,720575940622692621,right,T5c,264,-1,-6,-2,-4,"-1,-6"
16376,720575940649316473,right,T5c,265,-6,-1,5,-6,"-6,-1"
16377,720575940622613206,right,T5c,266,-1,-25,-12,-13,"-1,-25"
16378,720575940630993423,right,T5c,267,-6,2,7,-5,"-6,2"
16379,720575940628275817,right,T5c,268,7,-6,-10,4,"7,-6"
16380,720575940624439539,right,T5c,269,2,-19,-12,-7,"2,-19"
16381,720575940627901258,right,T5c,270,1,-8,-5,-3,"1,-8"
16382,720575940616755985,right,T5c,271,4,6,-1,7,"4,6"
16383,720575940628950588,right,T5c,272,3,-2,-4,2,"3,-2"
16384,720575940605952702,right,T5c,273,-6,23,17,6,"-6,23"
16385,720575940624698300,right,T5c,274,6,4,-4,8,"6,4"
16386,720575940628548943,right,T5c,275,-8,-1,7,-8,"-8,-1"
16387,720575940619308109,right,T5c,276,2,3,-1,4,"2,3"
16388,720575940629223038,right,T5c,277,7,-3,-9,6,"7,-3"
16389,720575940624716302,right,T5c,278,-5,10,10,0,"-5,10"
16390,720575940634184800,right,T5c,279,-4,8,8,0,"-4,8"
16391,720575940634256540,right,T5c,280,-6,-14,-1,-13,"-6,-14"
16392,720575940623955592,right,T5c,282,0,26,13,13,"0,26"
16393,720575940628046086,right,T5c,283,-4,4,6,-2,"-4,4"
16394,720575940618172121,right,T5c,284,0,25,12,13,"0,25"
16395,720575940622088745,right,T5c,285,6,-18,-15,-3,"6,-18"
16396,720575940631740970,right,T5c,286,0,-24,-12,-12,"0,-24"
16397,720575940606577865,right,T5c,287,-5,13,11,2,"-5,13"
16398,720575940630620154,right,T5c,289,-1,11,6,5,"-1,11"
16399,720575940623178751,right,T5c,290,5,-24,-17,-7,"5,-24"
16400,720575940618143261,right,T5c,291,7,2,-6,8,"7,2"
16401,720575940660034945,right,T5c,292,-4,18,13,5,"-4,18"
16402,720575940633670882,right,T5c,293,4,-17,-13,-4,"4,-17"
16403,720575940604457200,right,T5c,294,1,-20,-11,-9,"1,-20"
16404,720575940642007949,right,T5c,296,1,-18,-10,-8,"1,-18"
16405,720575940631884369,right,T5c,298,-5,5,7,-2,"-5,5"
16406,720575940628711415,right,T5c,299,-4,12,10,2,"-4,12"
16407,720575940612255641,right,T5c,300,4,-18,-13,-5,"4,-18"
16408,720575940615837746,right,T5c,301,-5,16,13,3,"-5,16"
16409,720575940617485286,right,T5c,302,2,17,6,11,"2,17"
16410,720575940647828612,right,T5c,303,-5,22,16,6,"-5,22"
16411,720575940605174700,right,T5c,304,6,5,-4,9,"6,5"
16412,720575940617820955,right,T5c,305,-7,4,9,-5,"-7,4"
16413,720575940631694127,right,T5c,306,3,7,0,7,"3,7"
16414,720575940644957732,right,T5c,307,5,-25,-18,-7,"5,-25"
16415,720575940630995983,right,T5c,308,-5,8,9,-1,"-5,8"
16416,720575940634185568,right,T5c,309,-6,12,12,0,"-6,12"
16417,720575940618067739,right,T5c,310,2,22,9,13,"2,22"
16418,720575940627538600,right,T5c,311,-7,15,14,1,"-7,15"
16419,720575940633558047,right,T5c,312,4,-7,-8,1,"4,-7"
16420,720575940633672162,right,T5c,313,7,3,-6,9,"7,3"
16421,720575940628558671,right,T5c,315,-3,-6,0,-6,"-3,-6"
16422,720575940624273226,right,T5c,316,5,-4,-7,3,"5,-4"
16423,720575940631994193,right,T5c,317,-5,-4,3,-7,"-5,-4"
16424,720575940621732336,right,T5c,318,4,-19,-14,-5,"4,-19"
16425,720575940639095374,right,T5c,319,-2,5,4,1,"-2,5"
16426,720575940604511776,right,T5c,320,-2,-5,-1,-4,"-2,-5"
16427,720575940634123219,right,T5c,322,2,26,11,15,"2,26"
16428,720575940613862802,right,T5c,323,-7,-13,0,-13,"-7,-13"
16429,720575940631116847,right,T5c,324,3,24,9,15,"3,24"
16430,720575940631048279,right,T5c,325,5,1,-5,6,"5,1"
16431,720575940608350731,right,T5c,326,2,16,6,10,"2,16"
16432,720575940621817584,right,T5c,327,5,3,-4,7,"5,3"
16433,720575940626586626,right,T5c,328,5,-9,-10,1,"5,-9"
16434,720575940619398981,right,T5c,329,0,24,12,12,"0,24"
16435,720575940629280586,right,T5c,330,3,3,-2,5,"3,3"
16436,720575940622380554,right,T5c,331,1,-15,-9,-6,"1,-15"
16437,720575940631558995,right,T5c,332,4,-26,-17,-9,"4,-26"
16438,720575940639476864,right,T5c,333,0,-21,-11,-10,"0,-21"
16439,720575940612986482,right,T5c,334,1,-26,-14,-12,"1,-26"
16440,720575940631696441,right,T5c,335,2,8,2,6,"2,8"
16441,720575940625655271,right,T5c,336,0,23,11,12,"0,23"
16442,720575940619358155,right,T5c,337,-5,-6,2,-8,"-5,-6"
16443,720575940638496189,right,T5c,338,-1,0,1,-1,"-1,0"
16444,720575940605566310,right,T5c,339,6,11,-1,12,"6,11"
16445,720575940618375232,right,T5c,340,-4,17,12,5,"-4,17"
16446,720575940621194561,right,T5c,342,2,-15,-10,-5,"2,-15"
16447,720575940627576381,right,T5c,343,-3,27,16,11,"-3,27"
16448,720575940623121098,right,T5c,344,-2,-15,-6,-9,"-2,-15"
16449,720575940627823753,right,T5c,345,3,-12,-9,-3,"3,-12"
16450,720575940619925012,right,T5c,346,-7,-9,2,-11,"-7,-9"
16451,720575940629126503,right,T5c,347,-5,-13,-2,-11,"-5,-13"
16452,720575940620778662,right,T5c,348,3,14,4,10,"3,14"
16453,720575940624740347,right,T5c,349,-5,-14,-2,-12,"-5,-14"
16454,720575940627589288,right,T5c,350,1,15,6,9,"1,15"
16455,720575940621798945,right,T5c,351,-1,-17,-8,-9,"-1,-17"
16456,720575940631034455,right,T5c,352,-2,28,16,12,"-2,28"
16457,720575940644666056,right,T5c,354,-2,-26,-11,-15,"-2,-26"
16458,720575940621397697,right,T5c,355,-7,-6,4,-10,"-7,-6"
16459,720575940629047882,right,T5c,356,0,22,11,11,"0,22"
16460,720575940620990561,right,T5c,357,4,17,4,13,"4,17"
16461,720575940619874694,right,T5c,358,-3,17,11,6,"-3,17"
16462,720575940617815481,right,T5c,359,2,23,9,14,"2,23"
16463,720575940613145059,right,T5c,360,-5,19,14,5,"-5,19"
16464,720575940640350835,right,T5c,361,0,-7,-4,-3,"0,-7"
16465,720575940627173263,right,T5c,362,2,-20,-12,-8,"2,-20"
16466,720575940622251945,right,T5c,363,7,-4,-9,5,"7,-4"
16467,720575940617145361,right,T5c,364,4,4,-2,6,"4,4"
16468,720575940629623004,right,T5c,365,4,7,-1,8,"4,7"
16469,720575940615816863,right,T5c,367,-6,-15,-2,-13,"-6,-15"
16470,720575940634877547,right,T5c,368,-4,-20,-6,-14,"-4,-20"
16471,720575940635178091,right,T5c,369,5,-5,-8,3,"5,-5"
16472,720575940630533176,right,T5c,370,-3,21,13,8,"-3,21"
16473,720575940624438542,right,T5c,371,6,-5,-9,4,"6,-5"
16474,720575940624270845,right,T5c,372,1,-2,-2,0,"1,-2"
16475,720575940612376983,right,T5c,373,1,-21,-12,-9,"1,-21"
16476,720575940629525804,right,T5c,374,2,13,4,9,"2,13"
16477,720575940620662622,right,T5c,375,-6,7,9,-2,"-6,7"
16478,720575940618107220,right,T5c,376,-7,-10,2,-12,"-7,-10"
16479,720575940608763147,right,T5c,377,0,7,3,4,"0,7"
16480,720575940639528765,right,T5c,378,-3,18,12,6,"-3,18"
16481,720575940646995508,right,T5c,379,3,-17,-12,-5,"3,-17"
16482,720575940620608895,right,T5c,380,-1,29,15,14,"-1,29"
16483,720575940621405534,right,T5c,382,3,-6,-6,0,"3,-6"
16484,720575940646245923,right,T5c,383,-6,11,11,0,"-6,11"
16485,720575940625571868,right,T5c,385,-3,-18,-6,-12,"-3,-18"
16486,720575940637835610,right,T5c,386,-6,19,15,4,"-6,19"
16487,720575940629639223,right,T5c,387,-1,-15,-7,-8,"-1,-15"
16488,720575940620628818,right,T5c,388,3,19,6,13,"3,19"
16489,720575940611130744,right,T5c,389,-6,-16,-2,-14,"-6,-16"
16490,720575940622119382,right,T5c,390,-6,-9,1,-10,"-6,-9"
16491,720575940629820790,right,T5c,391,4,-3,-6,3,"4,-3"
16492,720575940611785841,right,T5c,392,-4,7,7,0,"-4,7"
16493,720575940628827179,right,T5c,393,-1,22,12,10,"-1,22"
16494,720575940636803418,right,T5c,394,-7,-8,3,-11,"-7,-8"
16495,720575940629419386,right,T5c,395,0,-22,-11,-11,"0,-22"
16496,720575940610406702,right,T5c,396,-1,10,6,4,"-1,10"
16497,720575940602497726,right,T5c,397,-3,-19,-7,-12,"-3,-19"
16498,720575940637850970,right,T5c,398,-3,22,14,8,"-3,22"
16499,720575940629367043,right,T5c,400,1,-29,-16,-13,"1,-29"
16500,720575940613928676,right,T5c,401,-2,-19,-8,-11,"-2,-19"
16501,720575940620928097,right,T5c,402,3,26,10,16,"3,26"
16502,720575940634414999,right,T5c,403,-2,-12,-4,-8,"-2,-12"
16503,720575940634437089,right,T5c,404,-1,20,11,9,"-1,20"
16504,720575940631335978,right,T5c,405,3,10,2,8,"3,10"
16505,720575940631779395,right,T5c,406,1,-25,-14,-11,"1,-25"
16506,720575940627461905,right,T5c,407,-5,-10,0,-10,"-5,-10"
16507,720575940611748314,right,T5c,408,-6,-4,4,-8,"-6,-4"
16508,720575940622711081,right,T5c,409,0,-3,-2,-1,"0,-3"
16509,720575940610076792,right,T5c,410,-2,-2,1,-3,"-2,-2"
16510,720575940612561125,right,T5c,411,-5,-19,-5,-14,"-5,-19"
16511,720575940623132713,right,T5c,412,-6,21,16,5,"-6,21"
16512,720575940624497644,right,T5c,413,-2,-7,-2,-5,"-2,-7"
16513,720575940621635333,right,T5c,414,4,21,6,15,"4,21"
16514,720575940608972995,right,T5c,415,6,12,0,12,"6,12"
16515,720575940609360323,right,T5c,416,3,-8,-7,-1,"3,-8"
16516,720575940625417037,right,T5c,417,-6,-10,1,-11,"-6,-10"
16517,720575940634195934,right,T5c,418,-2,15,9,6,"-2,15"
16518,720575940622780296,right,T5c,419,-3,-11,-3,-8,"-3,-11"
16519,720575940605676041,right,T5c,420,6,-3,-8,5,"6,-3"
16520,720575940622729752,right,T5c,421,-1,12,7,5,"-1,12"
16521,720575940652010998,right,T5c,422,-7,-4,5,-9,"-7,-4"
16522,720575940638050788,right,T5c,423,3,-18,-12,-6,"3,-18"
16523,720575940628787867,right,T5c,424,-3,-2,2,-4,"-3,-2"
16524,720575940623568428,right,T5c,425,3,20,7,13,"3,20"
16525,720575940637784383,right,T5c,426,-3,0,3,-3,"-3,0"
16526,720575940639229757,right,T5c,427,5,-18,-14,-4,"5,-18"
16527,720575940623499308,right,T5c,428,-2,23,13,10,"-2,23"
16528,720575940643701960,right,T5c,429,-2,14,9,5,"-2,14"
16529,720575940612496918,right,T5c,430,-3,-7,-1,-6,"-3,-7"
16530,720575940610680433,right,T5c,431,-2,-10,-3,-7,"-2,-10"
16531,720575940616924741,right,T5c,432,-5,7,8,-1,"-5,7"
16532,720575940635675767,right,T5c,433,0,-8,-4,-4,"0,-8"
16533,720575940627953158,right,T5c,434,-3,7,6,1,"-3,7"
16534,720575940618064965,right,T5c,435,5,-17,-14,-3,"5,-17"
16535,720575940627821255,right,T5c,436,0,-15,-8,-7,"0,-15"
16536,720575940623771319,right,T5c,437,-3,12,9,3,"-3,12"
16537,720575940638019162,right,T5c,438,2,27,11,16,"2,27"
16538,720575940649349497,right,T5c,439,-3,-9,-2,-7,"-3,-9"
16539,720575940612532629,right,T5c,440,1,23,10,13,"1,23"
16540,720575940636240997,right,T5c,441,3,-16,-11,-5,"3,-16"
16541,720575940622786985,right,T5c,442,-5,25,17,8,"-5,25"
16542,720575940612173541,right,T5c,443,-6,4,8,-4,"-6,4"
16543,720575940641485709,right,T5c,444,4,-10,-9,-1,"4,-10"
16544,720575940636882032,right,T5c,445,-2,8,6,2,"-2,8"
16545,720575940637644122,right,T5c,446,2,-14,-9,-5,"2,-14"
16546,720575940622680968,right,T5c,447,-1,2,2,0,"-1,2"
16547,720575940640864464,right,T5c,449,6,-16,-14,-2,"6,-16"
16548,720575940624599539,right,T5c,450,2,-9,-7,-2,"2,-9"
16549,720575940611378552,right,T5c,451,4,20,6,14,"4,20"
16550,720575940621944712,right,T5c,452,1,-9,-6,-3,"1,-9"
16551,720575940619817293,right,T5c,453,3,25,9,16,"3,25"
16552,720575940617234132,right,T5c,454,5,-12,-11,-1,"5,-12"
16553,720575940627820443,right,T5c,455,7,-7,-11,4,"7,-7"
16554,720575940619460811,right,T5c,456,0,21,10,11,"0,21"
16555,720575940632153415,right,T5c,457,-2,17,10,7,"-2,17"
16556,720575940630142521,right,T5c,458,5,0,-5,5,"5,0"
16557,720575940620090544,right,T5c,459,5,-3,-7,4,"5,-3"
16558,720575940619919696,right,T5c,460,-3,-20,-7,-13,"-3,-20"
16559,720575940617069115,right,T5c,462,-1,18,10,8,"-1,18"
16560,720575940647111300,right,T5c,463,5,17,3,14,"5,17"
16561,720575940630249846,right,T5c,464,4,0,-4,4,"4,0"
16562,720575940628013809,right,T5c,465,3,0,-3,3,"3,0"
16563,720575940627977415,right,T5c,466,1,14,6,8,"1,14"
16564,720575940621870881,right,T5c,467,-2,-20,-8,-12,"-2,-20"
16565,720575940625832804,right,T5c,468,-3,11,8,3,"-3,11"
16566,720575940621780250,right,T5c,469,-7,13,13,0,"-7,13"
16567,720575940649629049,right,T5c,470,4,-9,-9,0,"4,-9"
16568,720575940628241226,right,T5c,471,3,-26,-16,-10,"3,-26"
16569,720575940621439615,right,T5c,473,-4,23,15,8,"-4,23"
16570,720575940632361953,right,T5c,474,-3,-17,-6,-11,"-3,-17"
16571,720575940621965388,right,T5c,475,-4,-1,3,-4,"-4,-1"
16572,720575940627455560,right,T5c,476,-1,15,8,7,"-1,15"
16573,720575940625737162,right,T5c,477,-3,2,4,-2,"-3,2"
16574,720575940611693205,right,T5c,478,-7,16,15,1,"-7,16"
16575,720575940627115858,right,T5c,479,-2,10,7,3,"-2,10"
16576,720575940624817191,right,T5c,480,3,-19,-13,-6,"3,-19"
16577,720575940615788742,right,T5c,481,4,-8,-8,0,"4,-8"
16578,720575940609295299,right,T5c,482,1,17,7,10,"1,17"
16579,720575940628029202,right,T5c,483,2,-7,-6,-1,"2,-7"
16580,720575940632540620,right,T5c,484,3,-9,-8,-1,"3,-9"
16581,720575940619213361,right,T5c,485,-3,-3,1,-4,"-3,-3"
16582,720575940624012552,right,T5c,486,0,1,0,1,"0,1"
16583,720575940617261346,right,T5c,487,1,-1,-2,1,"1,-1"
16584,720575940641575988,right,T5c,488,7,5,-5,10,"7,5"
16585,720575940624014060,right,T5c,489,-3,10,8,2,"-3,10"
16586,720575940620766374,right,T5c,490,-5,6,8,-2,"-5,6"
16587,720575940637810997,right,T5c,491,7,-1,-8,7,"7,-1"
16588,720575940606938546,right,T5c,492,-7,-2,6,-8,"-7,-2"
16589,720575940620168395,right,T5c,493,-3,23,14,9,"-3,23"
16590,720575940640002749,right,T5c,494,0,29,14,15,"0,29"
16591,720575940638310259,right,T5c,495,4,5,-2,7,"4,5"
16592,720575940621083995,right,T5c,496,7,8,-3,11,"7,8"
16593,720575940624796908,right,T5c,497,6,1,-6,7,"6,1"
16594,720575940615175903,right,T5c,498,6,10,-1,11,"6,10"
16595,720575940617147409,right,T5c,499,5,10,0,10,"5,10"
16596,720575940628063019,right,T5c,500,7,-8,-11,3,"7,-8"
16597,720575940625774948,right,T5c,501,1,2,0,2,"1,2"
16598,720575940640245888,right,T5c,502,5,8,-1,9,"5,8"
16599,720575940622077052,right,T5c,503,3,17,5,12,"3,17"
16600,720575940630645729,right,T5c,504,-2,9,6,3,"-2,9"
16601,720575940622361098,right,T5c,506,1,-12,-7,-5,"1,-12"
16602,720575940624738043,right,T5c,507,-5,-12,-1,-11,"-5,-12"
16603,720575940627778300,right,T5c,508,-5,11,10,1,"-5,11"
16604,720575940632206244,right,T5c,509,-4,10,9,1,"-4,10"
16605,720575940607627868,right,T5c,510,-2,11,7,4,"-2,11"
16606,720575940629821696,right,T5c,511,5,-11,-11,0,"5,-11"
16607,720575940649760889,right,T5c,512,6,0,-6,6,"6,0"
16608,720575940622875402,right,T5c,513,-4,-13,-3,-10,"-4,-13"
16609,720575940624148883,right,T5c,514,-4,-10,-1,-9,"-4,-10"
16610,720575940616844475,right,T5c,515,-8,-7,4,-11,"-8,-7"
16611,720575940630957007,right,T5c,517,6,3,-5,8,"6,3"
16612,720575940632033996,right,T5c,518,-4,22,15,7,"-4,22"
16613,720575940631927855,right,T5c,519,-5,-5,2,-7,"-5,-5"
16614,720575940627330319,right,T5c,521,6,-9,-11,2,"6,-9"
16615,720575940604324320,right,T5c,522,-4,0,4,-4,"-4,0"
16616,720575940621752397,right,T5c,523,2,14,5,9,"2,14"
16617,720575940628781315,right,T5c,524,4,-20,-14,-6,"4,-20"
16618,720575940627685419,right,T5c,525,-1,-20,-9,-11,"-1,-20"
16619,720575940616136565,right,T5c,526,0,-10,-5,-5,"0,-10"
16620,720575940605550112,right,T5c,527,-4,-8,0,-8,"-4,-8"
16621,720575940623053764,right,T5c,528,2,7,1,6,"2,7"
16622,720575940624209994,right,T5c,529,2,-2,-3,1,"2,-2"
16623,720575940617720916,right,T5c,530,-3,-13,-4,-9,"-3,-13"
16624,720575940627681103,right,T5c,531,1,0,-1,1,"1,0"
16625,720575940621942908,right,T5c,532,-8,7,11,-4,"-8,7"
16626,720575940629771308,right,T5c,533,0,-16,-8,-8,"0,-16"
16627,720575940643616200,right,T5c,534,3,2,-2,4,"3,2"
16628,720575940628997812,right,T5c,535,8,-4,-10,6,"8,-4"
16629,720575940622059525,right,T5c,536,3,4,-1,5,"3,4"
16630,720575940627122718,right,T5c,537,0,-23,-12,-11,"0,-23"
16631,720575940608404747,right,T5c,538,-4,1,4,-3,"-4,1"
16632,720575940632397454,right,T5c,539,-6,15,13,2,"-6,15"
16633,720575940624443367,right,T5c,540,-2,-9,-3,-6,"-2,-9"
16634,720575940607762354,right,T5c,541,-4,14,11,3,"-4,14"
16635,720575940627255818,right,T5c,542,6,-13,-13,0,"6,-13"
16636,720575940629472382,right,T5c,543,-1,-4,-1,-3,"-1,-4"
16637,720575940614952635,right,T5c,544,3,-13,-10,-3,"3,-13"
16638,720575940626857704,right,T5c,545,5,11,0,11,"5,11"
16639,720575940631414120,right,T5c,546,3,6,0,6,"3,6"
16640,720575940638886372,right,T5c,547,-1,21,11,10,"-1,21"
16641,720575940604412896,right,T5c,548,1,-16,-9,-7,"1,-16"
16642,720575940612061170,right,T5c,549,0,-9,-5,-4,"0,-9"
16643,720575940619741131,right,T5c,550,-2,3,3,0,"-2,3"
16644,720575940614447506,right,T5c,551,-4,-9,-1,-8,"-4,-9"
16645,720575940624268692,right,T5c,552,4,-1,-5,4,"4,-1"
16646,720575940634004124,right,T5c,553,-3,16,11,5,"-3,16"
16647,720575940617964379,right,T5c,555,-4,9,8,1,"-4,9"
16648,720575940640136400,right,T5c,556,0,10,5,5,"0,10"
16649,720575940613465750,right,T5c,557,6,-10,-11,1,"6,-10"
16650,720575940629947383,right,T5c,558,-4,-21,-7,-14,"-4,-21"
16651,720575940619749979,right,T5c,559,-6,22,17,5,"-6,22"
16652,720575940625629198,right,T5c,560,-7,14,14,0,"-7,14"
16653,720575940627797992,right,T5c,561,5,7,-2,9,"5,7"
16654,720575940604323808,right,T5c,562,-5,-2,4,-6,"-5,-2"
16655,720575940607827657,right,T5c,563,5,-13,-12,-1,"5,-13"
16656,720575940612451223,right,T5c,564,3,-23,-15,-8,"3,-23"
16657,720575940637962047,right,T5c,565,0,-26,-13,-13,"0,-26"
16658,720575940626049881,right,T5c,566,5,-8,-9,1,"5,-8"
16659,720575940647416708,right,T5c,567,-2,22,13,9,"-2,22"
16660,720575940618052426,right,T5c,568,-6,-8,2,-10,"-6,-8"
16661,720575940638634310,right,T5c,569,6,6,-3,9,"6,6"
16662,720575940619680085,right,T5c,570,2,25,10,15,"2,25"
16663,720575940609344866,right,T5c,571,0,-14,-7,-7,"0,-14"
16664,720575940625998594,right,T5c,572,-8,3,9,-6,"-8,3"
16665,720575940621066177,right,T5c,573,4,14,3,11,"4,14"
16666,720575940634949995,right,T5c,574,-6,5,8,-3,"-6,5"
16667,720575940622564109,right,T5c,575,6,9,-2,11,"6,9"
16668,720575940625825424,right,T5c,576,0,28,14,14,"0,28"
16669,720575940627705621,right,T5c,577,5,-14,-12,-2,"5,-14"
16670,720575940618176027,right,T5c,578,4,-11,-10,-1,"4,-11"
16671,720575940635701103,right,T5c,579,-3,-10,-2,-8,"-3,-10"
16672,720575940630876111,right,T5c,580,-2,-23,-10,-13,"-2,-23"
16673,720575940629546959,right,T5c,581,3,9,1,8,"3,9"
16674,720575940644937160,right,T5c,582,-1,23,12,11,"-1,23"
16675,720575940617588198,right,T5c,583,3,-25,-16,-9,"3,-25"
16676,720575940636594021,right,T5c,584,4,23,7,16,"4,23"
16677,720575940627817948,right,T5c,585,-1,-23,-11,-12,"-1,-23"
16678,720575940630324035,right,T5c,586,2,18,7,11,"2,18"
16679,720575940611140325,right,T5c,587,4,22,7,15,"4,22"
16680,720575940631068227,right,T5c,588,1,4,1,3,"1,4"
16681,720575940622985254,right,T5c,590,1,9,3,6,"1,9"
16682,720575940631330484,right,T5c,591,3,-3,-5,2,"3,-3"
16683,720575940629426046,right,T5c,593,3,-14,-10,-4,"3,-14"
16684,720575940623930375,right,T5c,594,7,-16,-15,-1,"7,-16"
16685,720575940625751677,right,T5c,595,7,-12,-13,1,"7,-12"
16686,720575940635920820,right,T5c,596,-4,-16,-4,-12,"-4,-16"
16687,720575940620792486,right,T5c,597,4,1,-4,5,"4,1"
16688,720575940631633489,right,T5c,598,2,-18,-11,-7,"2,-18"
16689,720575940631912495,right,T5c,599,-1,9,5,4,"-1,9"
16690,720575940624252168,right,T5c,600,3,-10,-8,-2,"3,-10"
16691,720575940633791513,right,T5c,601,1,16,7,9,"1,16"
16692,720575940620076368,right,T5c,602,4,-2,-5,3,"4,-2"
16693,720575940636372599,right,T5c,603,-3,-23,-9,-14,"-3,-23"
16694,720575940613523478,right,T5c,604,-6,-17,-3,-14,"-6,-17"
16695,720575940620435627,right,T5c,605,3,15,4,11,"3,15"
16696,720575940626362755,right,T5c,606,-1,-19,-9,-10,"-1,-19"
16697,720575940615697932,right,T5c,607,1,18,8,10,"1,18"
16698,720575940628564739,right,T5c,608,1,10,4,6,"1,10"
16699,720575940631092291,right,T5c,609,-2,0,2,-2,"-2,0"
16700,720575940637773631,right,T5c,610,2,-23,-14,-9,"2,-23"
16701,720575940614036452,right,T5c,611,-1,-18,-8,-10,"-1,-18"
16702,720575940621681020,right,T5c,614,-2,-8,-2,-6,"-2,-8"
16703,720575940629704058,right,T5c,615,-7,-7,3,-10,"-7,-7"
16704,720575940629151488,right,T5c,616,-3,15,10,5,"-3,15"
16705,720575940614219926,right,T5c,617,-2,-17,-7,-10,"-2,-17"
16706,720575940615982047,right,T5c,618,-1,24,13,11,"-1,24"
16707,720575940611523426,right,T5c,619,-4,-19,-6,-13,"-4,-19"
16708,720575940612687382,right,T5c,620,7,1,-7,8,"7,1"
16709,720575940632384810,right,T5c,621,1,24,11,13,"1,24"
16710,720575940614271919,right,T5c,622,-5,20,15,5,"-5,20"
16711,720575940620653665,right,T5c,623,1,13,5,8,"1,13"
16712,720575940620238063,right,T5c,624,1,-17,-10,-7,"1,-17"
16713,720575940618616733,right,T5c,625,-2,24,14,10,"-2,24"
16714,720575940617622100,right,T5c,626,-5,-8,1,-9,"-5,-8"
16715,720575940631570733,right,T5c,627,0,-1,-1,0,"0,-1"
16716,720575940637062878,right,T5c,628,0,0,0,0,"0,0"
16717,720575940619828813,right,T5c,629,4,24,8,16,"4,24"
16718,720575940607042994,right,T5c,630,4,8,0,8,"4,8"
16719,720575940619868027,right,T5c,631,1,26,12,14,"1,26"
16720,720575940631219364,right,T5c,632,3,-20,-13,-7,"3,-20"
16721,720575940623002893,right,T5c,633,-1,-24,-11,-13,"-1,-24"
16722,720575940629340012,right,T5c,634,-3,-15,-5,-10,"-3,-15"
16723,720575940633024869,right,T5c,635,6,-6,-9,3,"6,-6"
16724,720575940627014474,right,T5c,636,0,6,3,3,"0,6"
16725,720575940612428951,right,T5c,637,3,-21,-14,-7,"3,-21"
16726,720575940627810759,right,T5c,638,-1,7,4,3,"-1,7"
16727,720575940621975329,right,T5c,639,-4,19,13,6,"-4,19"
16728,720575940638016831,right,T5c,640,-1,-16,-7,-9,"-1,-16"
16729,720575940620040528,right,T5c,641,-8,-5,5,-10,"-8,-5"
16730,720575940659856001,right,T5c,642,-5,-11,-1,-10,"-5,-11"
16731,720575940631464811,right,T5c,643,6,14,1,13,"6,14"
16732,720575940630026039,right,T5c,644,-6,18,15,3,"-6,18"
16733,720575940616272962,right,T5c,645,-4,27,17,10,"-4,27"
16734,720575940630617285,right,T5c,647,-4,-7,0,-7,"-4,-7"
16735,720575940632807085,right,T5c,648,1,7,2,5,"1,7"
16736,720575940605335910,right,T5c,649,-1,5,3,2,"-1,5"
16737,720575940623635431,right,T5c,650,-3,-25,-10,-15,"-3,-25"
16738,720575940620866992,right,T5c,651,-4,-5,1,-6,"-4,-5"
16739,720575940624611835,right,T5c,652,-6,-11,0,-11,"-6,-11"
16740,720575940637003365,right,T5c,653,-6,-12,0,-12,"-6,-12"
16741,720575940634664895,right,T5c,654,-3,8,7,1,"-3,8"
16742,720575940639604789,right,T5c,655,6,-1,-7,6,"6,-1"
16743,720575940621631690,right,T5c,656,0,-11,-6,-5,"0,-11"
16744,720575940626642584,right,T5c,657,-2,-25,-11,-14,"-2,-25"
16745,720575940619806305,right,T5c,658,1,20,9,11,"1,20"
16746,720575940617732948,right,T5c,659,-4,-6,1,-7,"-4,-6"
16747,720575940607786251,right,T5c,661,-3,14,10,4,"-3,14"
16748,720575940612775958,right,T5c,662,2,-1,-3,2,"2,-1"
16749,720575940619598502,right,T5c,663,0,8,4,4,"0,8"
16750,720575940628889935,right,T5c,664,1,-27,-15,-12,"1,-27"
16751,720575940630894799,right,T5c,665,7,-2,-8,6,"7,-2"
16752,720575940613100566,right,T5c,667,1,-28,-15,-13,"1,-28"
16753,720575940627170250,right,T5c,668,1,19,8,11,"1,19"
16754,720575940643466912,right,T5c,669,4,-16,-12,-4,"4,-16"
16755,720575940630320087,right,T5c,670,5,5,-3,8,"5,5"
16756,720575940621549377,right,T5c,671,-4,-23,-8,-15,"-4,-23"
16757,720575940633483746,right,T5c,672,-8,11,13,-2,"-8,11"
16758,720575940611461082,right,T5c,673,2,5,0,5,"2,5"
16759,720575940605397536,right,T5c,674,-4,-14,-3,-11,"-4,-14"
16760,720575940618177349,right,T5c,675,-7,19,16,3,"-7,19"
16761,720575940622490444,right,T5c,676,-3,-21,-8,-13,"-3,-21"
16762,720575940623190506,right,T5c,677,0,11,5,6,"0,11"
16763,720575940621898264,right,T5c,678,3,-7,-7,0,"3,-7"
16764,720575940612466329,right,T5c,679,4,18,5,13,"4,18"
16765,720575940621915558,right,T5c,680,-1,25,13,12,"-1,25"
16766,720575940638388314,right,T5c,681,-2,-21,-9,-12,"-2,-21"
16767,720575940630669672,right,T5c,682,6,-8,-10,2,"6,-8"
16768,720575940624057608,right,T5c,683,2,6,1,5,"2,6"
16769,720575940626783740,right,T5c,684,-6,17,14,3,"-6,17"
16770,720575940606466761,right,T5c,685,-5,-9,0,-9,"-5,-9"
16771,720575940622521930,right,T5c,687,-6,-3,4,-7,"-6,-3"
16772,720575940605426278,right,T5c,688,-7,10,12,-2,"-7,10"
16773,720575940614831144,right,T5c,689,-2,18,11,7,"-2,18"
16774,720575940622955561,right,T5c,690,-7,-3,5,-8,"-7,-3"
16775,720575940612962611,right,T5c,691,-9,4,11,-7,"-9,4"
16776,720575940645877358,right,T5c,692,-4,24,16,8,"-4,24"
16777,720575940617368123,right,T5c,693,-3,25,15,10,"-3,25"
16778,720575940640500276,right,T5c,694,4,3,-3,6,"4,3"
16779,720575940637714239,right,T5c,695,-6,10,11,-1,"-6,10"
16780,720575940611558037,right,T5c,696,-2,16,10,6,"-2,16"
16781,720575940616905145,right,T5c,697,1,-22,-12,-10,"1,-22"
16782,720575940612621999,right,T5c,698,6,-7,-10,3,"6,-7"
16783,720575940607033010,right,T5c,699,-5,0,5,-5,"-5,0"
16784,720575940619473089,right,T5c,700,5,15,2,13,"5,15"
16785,720575940626737722,right,T5c,701,0,-4,-2,-2,"0,-4"
16786,720575940610363972,right,T5c,702,-5,23,16,7,"-5,23"
16787,720575940622412253,right,T5c,703,-3,1,3,-2,"-3,1"
16788,720575940623873609,right,T5c,704,-7,8,11,-3,"-7,8"
16789,720575940624010493,right,T5c,705,1,1,-1,2,"1,1"
16790,720575940629977959,right,T5c,706,-7,-12,1,-13,"-7,-12"
16791,720575940630518071,right,T5c,707,-2,25,14,11,"-2,25"
16792,720575940626360869,right,T5c,709,-2,-24,-10,-14,"-2,-24"
16793,720575940633894507,right,T5c,710,4,-25,-17,-8,"4,-25"
16794,720575940626373016,right,T5c,711,-1,19,10,9,"-1,19"
16795,720575940628761423,right,T5c,712,-7,12,13,-1,"-7,12"
16796,720575940636975216,right,T5c,713,-6,16,14,2,"-6,16"
16797,720575940626423493,right,T5c,714,5,12,1,11,"5,12"
16798,720575940617712214,right,T5c,715,4,10,1,9,"4,10"
16799,720575940619528784,right,T5c,716,4,-6,-7,1,"4,-6"
16800,720575940631260175,right,T5c,717,2,-22,-13,-9,"2,-22"
16801,720575940613675542,right,T5c,719,1,27,12,15,"1,27"
16802,720575940640116312,right,T5c,720,-5,21,15,6,"-5,21"
16803,720575940624443832,right,T5c,721,5,13,1,12,"5,13"
16804,720575940617917926,right,T5c,722,6,-15,-14,-1,"6,-15"
16805,720575940638856757,right,T5c,723,-2,-11,-4,-7,"-2,-11"
16806,720575940624623288,right,T5c,724,4,2,-3,5,"4,2"
16807,720575940629807354,right,T5c,725,-3,-24,-9,-15,"-3,-24"
16808,720575940620597524,right,T5c,726,2,-28,-16,-12,"2,-28"
16809,720575940630364012,right,T5c,727,7,6,-4,10,"7,6"
16810,720575940629815490,right,T5c,728,7,12,-1,13,"7,12"
16811,720575940627231262,right,T5c,729,-3,29,17,12,"-3,29"
16812,720575940631991476,right,T5c,730,7,0,-7,7,"7,0"
16813,720575940628351546,right,T5c,731,-6,9,10,-1,"-6,9"
16814,720575940626501676,right,T5c,732,-3,6,6,0,"-3,6"
16815,720575940639509667,right,T5c,733,-5,-17,-4,-13,"-5,-17"
16816,720575940631738415,right,T5c,734,2,0,-2,2,"2,0"
16817,720575940634452080,right,T5c,735,1,-23,-13,-10,"1,-23"
16818,720575940627682556,right,T5c,736,-8,1,8,-7,"-8,1"
16819,720575940606920578,right,T5c,737,0,19,9,10,"0,19"
16820,720575940635244133,right,T5c,738,-3,13,9,4,"-3,13"
16821,720575940638647785,right,T5c,739,-7,2,8,-6,"-7,2"
16822,720575940619816071,right,T5c,740,2,-8,-6,-2,"2,-8"
16823,720575940623041609,right,T5c,741,-2,-14,-5,-9,"-2,-14"
16824,720575940647171204,right,T5c,742,-4,11,9,2,"-4,11"
16825,720575940621383617,right,T5c,744,-4,25,16,9,"-4,25"
16826,720575940628593664,right,T5c,745,0,13,6,7,"0,13"
16827,720575940617576226,right,T5c,746,-3,3,4,-1,"-3,3"
16828,720575940621050608,right,T5c,747,0,2,1,1,"0,2"
16829,720575940611375314,right,T5c,748,-4,20,14,6,"-4,20"
16830,720575940627418133,right,T5c,749,-2,1,2,-1,"-2,1"
16831,720575940631563091,right,T5c,750,4,-24,-16,-8,"4,-24"
16832,720575940633553886,right,T5c,751,1,6,2,4,"1,6"
16833,720575940605725105,right,T5c,752,-2,7,5,2,"-2,7"
16834,720575940630141050,right,T5c,753,-3,24,15,9,"-3,24"
16835,720575940620198127,right,T5c,754,-1,-13,-6,-7,"-1,-13"
16836,720575940639140413,right,T5c,755,4,19,5,14,"4,19"
16837,720575940639448784,right,T5c,756,5,20,5,15,"5,20"
16838,720575940637527693,right,T5c,757,0,-6,-3,-3,"0,-6"
16839,720575940633859482,right,T5c,758,5,-1,-6,5,"5,-1"
16840,720575940627437765,right,T5c,759,7,14,0,14,"7,14"
16841,720575940637005801,right,T5c,760,0,17,8,9,"0,17"
16842,720575940646051460,right,T5c,761,-4,-18,-5,-13,"-4,-18"
16843,720575940623495411,right,T5c,762,0,14,7,7,"0,14"
16844,720575940608343305,right,T5c,763,-5,14,12,2,"-5,14"
16845,720575940613254166,right,T5c,764,-8,-6,5,-11,"-8,-6"
16846,720575940626924681,right,T5c,765,-3,9,7,2,"-3,9"
16847,720575940638428998,right,T5c,766,2,-4,-4,0,"2,-4"
16848,720575940623927303,right,T5c,768,3,5,-1,6,"3,5"
16849,720575940631697000,right,T5c,770,5,4,-3,7,"5,4"
16850,720575940623032652,right,T5c,771,3,-27,-17,-10,"3,-27"
16851,720575940618941261,right,T5c,772,1,12,5,7,"1,12"
16852,720575940607259228,right,T5c,773,5,-19,-15,-4,"5,-19"
16853,720575940624693996,right,T5c,775,5,22,6,16,"5,22"
16854,720575940638050020,right,T5c,778,4,25,8,17,"4,25"
16855,720575940616732722,right,T5c,780,-6,25,18,7,"-6,25"
16856,720575940620333784,right,T5c,784,-4,29,18,11,"-4,29"
16857,720575940612944435,right,T5c,786,-2,30,17,13,"-2,30"
16858,720575940614510899,right,T5c,790,-2,-27,-12,-15,"-2,-27"
16859,720575940641579316,right,T5c,792,8,2,-7,9,"8,2"
16860,720575940628573545,right,T5c,793,8,-6,-11,5,"8,-6"
16861,720575940612207253,right,T5c,795,6,-21,-17,-4,"6,-21"
16862,720575940632062372,right,T5d,2,-8,2,9,-7,"-8,2"
16863,720575940626345490,right,T5d,3,6,-12,-12,0,"6,-12"
16864,720575940623967466,right,T5d,4,-5,-21,-6,-15,"-5,-21"
16865,720575940608020931,right,T5d,5,-1,16,9,7,"-1,16"
16866,720575940627424424,right,T5d,6,-2,-4,0,-4,"-2,-4"
16867,720575940634603711,right,T5d,7,-6,-6,3,-9,"-6,-6"
16868,720575940612407409,right,T5d,8,-4,26,17,9,"-4,26"
16869,720575940620278875,right,T5d,9,4,9,0,9,"4,9"
16870,720575940631748152,right,T5d,10,5,-15,-13,-2,"5,-15"
16871,720575940621519180,right,T5d,12,-7,9,11,-2,"-7,9"
16872,720575940610989944,right,T5d,15,2,-3,-4,1,"2,-3"
16873,720575940607288843,right,T5d,16,-2,-16,-6,-10,"-2,-16"
16874,720575940621702405,right,T5d,17,1,-5,-4,-1,"1,-5"
16875,720575940619600213,right,T5d,18,5,-16,-13,-3,"5,-16"
16876,720575940621193910,right,T5d,19,-7,17,15,2,"-7,17"
16877,720575940618614942,right,T5d,20,3,-11,-9,-2,"3,-11"
16878,720575940626309164,right,T5d,21,-2,19,11,8,"-2,19"
16879,720575940635736687,right,T5d,22,-1,3,2,1,"-1,3"
16880,720575940623784955,right,T5d,23,-3,-16,-5,-11,"-3,-16"
16881,720575940617303014,right,T5d,24,-1,-10,-4,-6,"-1,-10"
16882,720575940622135208,right,T5d,26,1,-3,-3,0,"1,-3"
16883,720575940621938437,right,T5d,27,0,-25,-13,-12,"0,-25"
16884,720575940619513905,right,T5d,28,5,6,-2,8,"5,6"
16885,720575940629466679,right,T5d,29,-1,-3,-1,-2,"-1,-3"
16886,720575940623337471,right,T5d,30,6,16,2,14,"6,16"
16887,720575940621792350,right,T5d,31,0,16,8,8,"0,16"
16888,720575940626727592,right,T5d,32,0,12,6,6,"0,12"
16889,720575940641276891,right,T5d,33,3,18,6,12,"3,18"
16890,720575940630351068,right,T5d,35,1,-24,-13,-11,"1,-24"
16891,720575940638251590,right,T5d,36,6,8,-2,10,"6,8"
16892,720575940633562078,right,T5d,37,1,5,1,4,"1,5"
16893,720575940623072809,right,T5d,38,0,-2,-1,-1,"0,-2"
16894,720575940628604688,right,T5d,39,0,20,10,10,"0,20"
16895,720575940626922754,right,T5d,40,-2,-6,-1,-5,"-2,-6"
16896,720575940626303418,right,T5d,41,-3,28,17,11,"-3,28"
16897,720575940638994485,right,T5d,42,-1,14,8,6,"-1,14"
16898,720575940627537064,right,T5d,43,-5,18,14,4,"-5,18"
16899,720575940632111311,right,T5d,44,5,-10,-10,0,"5,-10"
16900,720575940630470999,right,T5d,45,-5,-1,4,-5,"-5,-1"
16901,720575940613877555,right,T5d,46,-5,15,12,3,"-5,15"
16902,720575940630114938,right,T5d,48,-4,-22,-7,-15,"-4,-22"
16903,720575940642057357,right,T5d,49,4,-4,-6,2,"4,-4"
16904,720575940629048394,right,T5d,50,-2,21,12,9,"-2,21"
16905,720575940636622734,right,T5d,51,0,-19,-10,-9,"0,-19"
16906,720575940627862415,right,T5d,52,-1,-22,-10,-12,"-1,-22"
16907,720575940654958753,right,T5d,53,5,14,2,12,"5,14"
16908,720575940612603926,right,T5d,54,-4,3,5,-2,"-4,3"
16909,720575940621940682,right,T5d,55,-4,-11,-2,-9,"-4,-11"
16910,720575940619244337,right,T5d,56,1,-13,-8,-5,"1,-13"
16911,720575940634065433,right,T5d,57,6,-11,-12,1,"6,-11"
16912,720575940614275070,right,T5d,58,3,12,3,9,"3,12"
16913,720575940641271348,right,T5d,59,-2,2,3,-1,"-2,2"
16914,720575940628006897,right,T5d,61,-4,-4,2,-6,"-4,-4"
16915,720575940626425541,right,T5d,63,4,12,2,10,"4,12"
16916,720575940630812022,right,T5d,64,4,-23,-16,-7,"4,-23"
16917,720575940616234252,right,T5d,65,-1,28,15,13,"-1,28"
16918,720575940626603151,right,T5d,66,2,15,5,10,"2,15"
16919,720575940620127041,right,T5d,67,-2,-13,-5,-8,"-2,-13"
16920,720575940621852307,right,T5d,68,3,16,5,11,"3,16"
16921,720575940621760609,right,T5d,69,1,8,3,5,"1,8"
16922,720575940618377024,right,T5d,70,-4,21,14,7,"-4,21"
16923,720575940609943928,right,T5d,71,-2,-3,0,-3,"-2,-3"
16924,720575940615711650,right,T5d,73,2,2,-1,3,"2,2"
16925,720575940617519773,right,T5d,74,-1,-9,-4,-5,"-1,-9"
16926,720575940636078199,right,T5d,75,-6,14,13,1,"-6,14"
16927,720575940635183028,right,T5d,76,-3,-4,1,-5,"-3,-4"
16928,720575940624489708,right,T5d,77,2,-5,-5,0,"2,-5"
16929,720575940620400774,right,T5d,78,2,20,8,12,"2,20"
16930,720575940615297548,right,T5d,79,2,1,-2,3,"2,1"
16931,720575940617132262,right,T5d,80,4,13,2,11,"4,13"
16932,720575940627470867,right,T5d,81,6,-2,-7,5,"6,-2"
16933,720575940617409349,right,T5d,82,-7,7,10,-3,"-7,7"
16934,720575940613617021,right,T5d,83,2,-21,-13,-8,"2,-21"
16935,720575940619438539,right,T5d,84,-2,12,8,4,"-2,12"
16936,720575940614292478,right,T5d,87,1,11,4,7,"1,11"
16937,720575940634743403,right,T5d,88,7,4,-5,9,"7,4"
16938,720575940632112211,right,T5d,89,1,-19,-11,-8,"1,-19"
16939,720575940630140491,right,T5d,90,-4,5,6,-1,"-4,5"
16940,720575940632536718,right,T5d,91,-1,6,4,2,"-1,6"
16941,720575940630401910,right,T5d,92,0,9,4,5,"0,9"
16942,720575940615678150,right,T5d,93,-6,3,7,-4,"-6,3"
16943,720575940639175989,right,T5d,94,5,18,4,14,"5,18"
16944,720575940616904029,right,T5d,95,4,-21,-15,-6,"4,-21"
16945,720575940612039922,right,T5d,96,1,-10,-6,-4,"1,-10"
16946,720575940624131848,right,T5d,97,-5,2,6,-4,"-5,2"
16947,720575940622942730,right,T5d,98,-1,-12,-5,-7,"-1,-12"
16948,720575940624426900,right,T5d,99,4,15,3,12,"4,15"
16949,720575940621730842,right,T5d,100,2,-10,-7,-3,"2,-10"
16950,720575940620606317,right,T5d,101,-7,6,10,-4,"-7,6"
16951,720575940608442379,right,T5d,102,3,13,3,10,"3,13"
16952,720575940628599237,right,T5d,103,7,9,-3,12,"7,9"
16953,720575940646778147,right,T5d,104,-1,-27,-13,-14,"-1,-27"
16954,720575940622166908,right,T5d,105,3,22,8,14,"3,22"
16955,720575940639578275,right,T5d,106,-7,11,12,-1,"-7,11"
16956,720575940628742148,right,T5d,107,8,-2,-9,7,"8,-2"
16957,720575940624074829,right,T5d,108,-3,-12,-3,-9,"-3,-12"
16958,720575940645459054,right,T5d,109,4,-5,-7,2,"4,-5"
16959,720575940621637146,right,T5d,110,-7,0,7,-7,"-7,0"
16960,720575940627369237,right,T5d,111,2,-24,-14,-10,"2,-24"
16961,720575940647031940,right,T5d,112,-6,1,6,-5,"-6,1"
16962,720575940621691486,right,T5d,113,-2,4,4,0,"-2,4"
16963,720575940615169090,right,T5d,114,2,-13,-9,-4,"2,-13"
16964,720575940616249461,right,T5d,115,-4,2,5,-3,"-4,2"
16965,720575940619936020,right,T5d,116,-1,-8,-3,-5,"-1,-8"
16966,720575940622324604,right,T5d,117,-8,-2,7,-9,"-8,-2"
16967,720575940632237534,right,T5d,118,3,1,-3,4,"3,1"
16968,720575940620778561,right,T5d,119,-2,6,5,1,"-2,6"
16969,720575940624431335,right,T5d,120,-1,-1,0,-1,"-1,-1"
16970,720575940639443288,right,T5d,121,-8,4,10,-6,"-8,4"
16971,720575940623935229,right,T5d,122,-5,9,9,0,"-5,9"
16972,720575940634219616,right,T5d,124,1,-7,-5,-2,"1,-7"
16973,720575940616641931,right,T5d,125,5,9,-1,10,"5,9"
16974,720575940616410129,right,T5d,126,3,11,2,9,"3,11"
16975,720575940621426559,right,T5d,127,0,15,7,8,"0,15"
16976,720575940612907672,right,T5d,128,3,-22,-14,-8,"3,-22"
16977,720575940612758243,right,T5d,129,0,-13,-7,-6,"0,-13"
16978,720575940620778406,right,T5d,130,2,12,4,8,"2,12"
16979,720575940625393456,right,T5d,131,-6,20,16,4,"-6,20"
16980,720575940620273499,right,T5d,132,2,4,0,4,"2,4"
16981,720575940620301483,right,T5d,133,-3,20,13,7,"-3,20"
16982,720575940631649554,right,T5d,135,-3,-22,-8,-14,"-3,-22"
16983,720575940630541519,right,T5d,136,0,3,1,2,"0,3"
16984,720575940634874815,right,T5d,137,5,-7,-9,2,"5,-7"
16985,720575940625549716,right,T5d,138,0,27,13,14,"0,27"
16986,720575940622282506,right,T5d,139,1,-14,-8,-6,"1,-14"
16987,720575940622852605,right,T5d,140,3,8,1,7,"3,8"
16988,720575940617076107,right,T5d,142,-2,-18,-7,-11,"-2,-18"
16989,720575940639595939,right,T5d,143,-4,16,12,4,"-4,16"
16990,720575940613776680,right,T5d,144,7,-11,-13,2,"7,-11"
16991,720575940633345561,right,T5d,145,0,4,2,2,"0,4"
16992,720575940613975970,right,T5d,146,1,-6,-4,-2,"1,-6"
16993,720575940645422884,right,T5d,147,1,21,9,12,"1,21"
16994,720575940620937051,right,T5d,148,-7,-11,1,-12,"-7,-11"
16995,720575940630210103,right,T5d,149,6,-14,-13,-1,"6,-14"
16996,720575940635254520,right,T5d,150,-8,5,10,-5,"-8,5"
16997,720575940621840252,right,T5d,151,-3,-14,-4,-10,"-3,-14"
16998,720575940631536455,right,T5d,152,3,-15,-11,-4,"3,-15"
16999,720575940610397486,right,T5d,156,-9,1,9,-8,"-9,1"
17000,720575940637521037,right,T5d,157,-1,-7,-3,-4,"-1,-7"
17001,720575940620703983,right,T5d,158,3,-5,-6,1,"3,-5"
17002,720575940644889367,right,T5d,159,7,7,-4,11,"7,7"
17003,720575940611900387,right,T5d,160,-2,20,12,8,"-2,20"
17004,720575940639817856,right,T5d,161,4,-14,-11,-3,"4,-14"
17005,720575940613612207,right,T5d,162,-4,-2,3,-5,"-4,-2"
17006,720575940627453692,right,T5d,164,-1,-2,0,-2,"-1,-2"
17007,720575940631440235,right,T5d,165,4,16,4,12,"4,16"
17008,720575940647514676,right,T5d,166,0,18,9,9,"0,18"
17009,720575940618776354,right,T5d,167,0,-17,-9,-8,"0,-17"
17010,720575940632435999,right,T5d,168,-1,17,9,8,"-1,17"
17011,720575940621132246,right,T5d,169,0,-18,-9,-9,"0,-18"
17012,720575940643508384,right,T5d,170,-5,1,5,-4,"-5,1"
17013,720575940628515332,right,T5d,172,1,22,10,12,"1,22"
17014,720575940621571312,right,T5d,173,2,-25,-15,-10,"2,-25"
17015,720575940629720311,right,T5d,174,4,-15,-12,-3,"4,-15"
17016,720575940625799426,right,T5d,175,-6,-7,2,-9,"-6,-7"
17017,720575940620357615,right,T5d,176,-2,13,8,5,"-2,13"
17018,720575940613295400,right,T5d,177,-2,-1,1,-2,"-2,-1"
17019,720575940629525548,right,T5d,178,2,11,3,8,"2,11"
17020,720575940633787327,right,T5d,179,-5,-16,-3,-13,"-5,-16"
17021,720575940626269028,right,T5d,180,2,-27,-16,-11,"2,-27"
17022,720575940630905228,right,T5d,181,1,-4,-3,-1,"1,-4"
17023,720575940632259665,right,T5d,182,7,-10,-12,2,"7,-10"
17024,720575940626510812,right,T5d,183,-5,-15,-3,-12,"-5,-15"
17025,720575940630943668,right,T5d,184,-6,-5,3,-8,"-6,-5"
17026,720575940639768192,right,T5d,185,2,-11,-8,-3,"2,-11"
17027,720575940615838770,right,T5d,188,-5,17,13,4,"-5,17"
17028,720575940643758752,right,T5d,189,6,13,0,13,"6,13"
17029,720575940641373147,right,T5d,190,-3,-5,0,-5,"-3,-5"
17030,720575940622947110,right,T5d,191,-1,-11,-5,-6,"-1,-11"
17031,720575940605758752,right,T5d,192,7,10,-2,12,"7,10"
17032,720575940632070820,right,T5d,193,-5,4,7,-3,"-5,4"
17033,720575940622966506,right,T5d,194,0,-5,-3,-2,"0,-5"
17034,720575940638223686,right,T5d,195,-3,-1,2,-3,"-3,-1"
17035,720575940627471356,right,T5d,196,-1,8,5,3,"-1,8"
17036,720575940621950896,right,T5d,198,6,2,-5,7,"6,2"
17037,720575940630755269,right,T5d,199,0,-12,-6,-6,"0,-12"
17038,720575940621949052,right,T5d,200,-5,12,11,1,"-5,12"
17039,720575940611696248,right,T5d,202,-1,27,14,13,"-1,27"
17040,720575940613601426,right,T5d,203,3,-1,-4,3,"3,-1"
17041,720575940632931764,right,T5d,204,5,-2,-6,4,"5,-2"
17042,720575940633803877,right,T5d,205,5,-6,-8,2,"5,-6"
17043,720575940625942078,right,T5d,206,-3,5,5,0,"-3,5"
17044,720575940626221100,right,T5d,207,1,29,13,16,"1,29"
17045,720575940626982858,right,T5d,208,5,-21,-16,-5,"5,-21"
17046,720575940611895987,right,T5d,209,-3,-8,-1,-7,"-3,-8"
17047,720575940623043327,right,T5d,210,-6,8,10,-2,"-6,8"
17048,720575940619663701,right,T5d,211,-7,-1,6,-7,"-7,-1"
17049,720575940634676122,right,T5d,212,2,-16,-10,-6,"2,-16"
17050,720575940621248500,right,T5d,213,3,-4,-5,1,"3,-4"
17051,720575940627158289,right,T5d,214,-5,3,6,-3,"-5,3"
17052,720575940621306032,right,T5d,215,6,7,-3,10,"6,7"
17053,720575940624500151,right,T5d,216,2,19,7,12,"2,19"
17054,720575940618931277,right,T5d,218,2,10,3,7,"2,10"
17055,720575940623842236,right,T5d,219,6,-4,-8,4,"6,-4"
17056,720575940612695830,right,T5d,220,2,-6,-5,-1,"2,-6"
17057,720575940627997425,right,T5d,221,-7,3,8,-5,"-7,3"
17058,720575940628299581,right,T5d,222,-3,26,16,10,"-3,26"
17059,720575940620443725,right,T5d,223,-2,26,15,11,"-2,26"
17060,720575940616666146,right,T5d,224,0,5,2,3,"0,5"
17061,720575940621627233,right,T5d,226,5,19,4,15,"5,19"
17062,720575940627916487,right,T5d,227,-7,5,9,-4,"-7,5"
17063,720575940620117163,right,T5d,228,-7,1,7,-6,"-7,1"
17064,720575940617009735,right,T5d,229,5,2,-4,6,"5,2"
17065,720575940640065744,right,T5d,230,2,9,2,7,"2,9"
17066,720575940620295105,right,T5d,231,4,-12,-10,-2,"4,-12"
17067,720575940625048653,right,T5d,232,-4,13,10,3,"-4,13"
17068,720575940619202324,right,T5d,233,4,-13,-11,-2,"4,-13"
17069,720575940621183073,right,T5d,234,1,3,0,3,"1,3"
17070,720575940616494865,right,T5d,235,4,11,1,10,"4,11"
17071,720575940624245543,right,T5d,236,-1,4,3,1,"-1,4"
17072,720575940616918028,right,T5d,237,-2,27,15,12,"-2,27"
17073,720575940616479547,right,T5d,239,-6,6,9,-3,"-6,6"
17074,720575940633588761,right,T5d,240,-4,-3,2,-5,"-4,-3"
17075,720575940619793031,right,T5d,241,2,-17,-11,-6,"2,-17"
17076,720575940630359545,right,T5d,242,-4,6,7,-1,"-4,6"
17077,720575940639203300,right,T5d,243,-1,-21,-10,-11,"-1,-21"
17078,720575940622311306,right,T5d,244,-4,-12,-2,-10,"-4,-12"
17079,720575940626804617,right,T5d,245,-5,-3,3,-6,"-5,-3"
17080,720575940609113539,right,T5d,246,-4,15,11,4,"-4,15"
17081,720575940610727266,right,T5d,247,-4,-15,-4,-11,"-4,-15"
17082,720575940639425341,right,T5d,249,2,-12,-8,-4,"2,-12"
17083,720575940621016429,right,T5d,250,-1,1,1,0,"-1,1"
17084,720575940612537366,right,T5d,251,-1,-14,-6,-8,"-1,-14"
17085,720575940631166208,right,T5d,252,3,23,8,15,"3,23"
17086,720575940639404496,right,T5d,253,5,16,3,13,"5,16"
17087,720575940631183012,right,T5d,255,-6,-13,-1,-12,"-6,-13"
17088,720575940627274345,right,T5d,256,5,-20,-15,-5,"5,-20"
17089,720575940626993171,right,T5d,257,2,21,8,13,"2,21"
17090,720575940612927146,right,T5d,258,-4,-17,-5,-12,"-4,-17"
17091,720575940623051400,right,T5d,259,-7,-5,4,-9,"-7,-5"
17092,720575940634382328,right,T5d,260,-3,19,12,7,"-3,19"
17093,720575940617134036,right,T5d,261,-1,13,7,6,"-1,13"
17094,720575940633655194,right,T5d,262,1,-11,-7,-4,"1,-11"
17095,720575940624133640,right,T5d,263,-3,4,5,-1,"-3,4"
17096,720575940631093560,right,T5d,264,-1,-6,-2,-4,"-1,-6"
17097,720575940622808077,right,T5d,265,-6,-1,5,-6,"-6,-1"
17098,720575940618757147,right,T5d,266,-1,-25,-12,-13,"-1,-25"
17099,720575940628656683,right,T5d,267,-6,2,7,-5,"-6,2"
17100,720575940622249249,right,T5d,268,7,-6,-10,4,"7,-6"
17101,720575940616408971,right,T5d,269,2,-19,-12,-7,"2,-19"
17102,720575940637532813,right,T5d,270,1,-8,-5,-3,"1,-8"
17103,720575940629585146,right,T5d,271,4,6,-1,7,"4,6"
17104,720575940629730268,right,T5d,272,3,-2,-4,2,"3,-2"
17105,720575940622912717,right,T5d,273,-6,23,17,6,"-6,23"
17106,720575940644519959,right,T5d,274,6,4,-4,8,"6,4"
17107,720575940629984220,right,T5d,275,-8,-1,7,-8,"-8,-1"
17108,720575940610907204,right,T5d,276,2,3,-1,4,"2,3"
17109,720575940630388086,right,T5d,278,-5,10,10,0,"-5,10"
17110,720575940623071526,right,T5d,279,-4,8,8,0,"-4,8"
17111,720575940606198449,right,T5d,280,-6,-14,-1,-13,"-6,-14"
17112,720575940616397727,right,T5d,282,0,26,13,13,"0,26"
17113,720575940629474686,right,T5d,283,-4,4,6,-2,"-4,4"
17114,720575940615943786,right,T5d,284,0,25,12,13,"0,25"
17115,720575940628047592,right,T5d,285,6,-18,-15,-3,"6,-18"
17116,720575940627409490,right,T5d,286,0,-24,-12,-12,"0,-24"
17117,720575940627448904,right,T5d,287,-5,13,11,2,"-5,13"
17118,720575940620894599,right,T5d,288,-1,30,16,14,"-1,30"
17119,720575940625654003,right,T5d,289,-1,11,6,5,"-1,11"
17120,720575940620806336,right,T5d,290,5,-24,-17,-7,"5,-24"
17121,720575940637676777,right,T5d,291,7,2,-6,8,"7,2"
17122,720575940643754440,right,T5d,292,-4,18,13,5,"-4,18"
17123,720575940619468235,right,T5d,293,4,-17,-13,-4,"4,-17"
17124,720575940626693465,right,T5d,294,1,-20,-11,-9,"1,-20"
17125,720575940627518269,right,T5d,295,-2,29,16,13,"-2,29"
17126,720575940625023536,right,T5d,296,1,-18,-10,-8,"1,-18"
17127,720575940622240470,right,T5d,298,-5,5,7,-2,"-5,5"
17128,720575940631629625,right,T5d,299,-4,12,10,2,"-4,12"
17129,720575940627107134,right,T5d,300,4,-18,-13,-5,"4,-18"
17130,720575940633464033,right,T5d,301,-5,16,13,3,"-5,16"
17131,720575940617861755,right,T5d,302,2,17,6,11,"2,17"
17132,720575940621673754,right,T5d,303,-5,22,16,6,"-5,22"
17133,720575940631775815,right,T5d,305,-7,4,9,-5,"-7,4"
17134,720575940646588212,right,T5d,306,3,7,0,7,"3,7"
17135,720575940615909900,right,T5d,307,5,-25,-18,-7,"5,-25"
17136,720575940627933639,right,T5d,308,-5,8,9,-1,"-5,8"
17137,720575940630356844,right,T5d,309,-6,12,12,0,"-6,12"
17138,720575940609382921,right,T5d,310,2,22,9,13,"2,22"
17139,720575940627152442,right,T5d,311,-7,15,14,1,"-7,15"
17140,720575940633804389,right,T5d,312,4,-7,-8,1,"4,-7"
17141,720575940638064692,right,T5d,313,7,3,-6,9,"7,3"
17142,720575940632206500,right,T5d,314,-9,5,11,-6,"-9,5"
17143,720575940612979171,right,T5d,315,-3,-6,0,-6,"-3,-6"
17144,720575940605686793,right,T5d,316,5,-4,-7,3,"5,-4"
17145,720575940634090080,right,T5d,317,-5,-4,3,-7,"-5,-4"
17146,720575940621485300,right,T5d,319,-2,5,4,1,"-2,5"
17147,720575940622684429,right,T5d,320,-2,-5,-1,-4,"-2,-5"
17148,720575940638888026,right,T5d,322,2,26,11,15,"2,26"
17149,720575940627945724,right,T5d,324,3,24,9,15,"3,24"
17150,720575940637781082,right,T5d,325,5,1,-5,6,"5,1"
17151,720575940623971837,right,T5d,326,2,16,6,10,"2,16"
17152,720575940605996209,right,T5d,327,5,3,-4,7,"5,3"
17153,720575940630258903,right,T5d,328,5,-9,-10,1,"5,-9"
17154,720575940616915468,right,T5d,329,0,24,12,12,"0,24"
17155,720575940624142896,right,T5d,330,3,3,-2,5,"3,3"
17156,720575940611540885,right,T5d,331,1,-15,-9,-6,"1,-15"
17157,720575940645483118,right,T5d,332,4,-26,-17,-9,"4,-26"
17158,720575940609826884,right,T5d,333,0,-21,-11,-10,"0,-21"
17159,720575940618978358,right,T5d,334,1,-26,-14,-12,"1,-26"
17160,720575940614473622,right,T5d,335,2,8,2,6,"2,8"
17161,720575940616917004,right,T5d,336,0,23,11,12,"0,23"
17162,720575940614547602,right,T5d,337,-5,-6,2,-8,"-5,-6"
17163,720575940629836396,right,T5d,338,-1,0,1,-1,"-1,0"
17164,720575940621412852,right,T5d,339,6,11,-1,12,"6,11"
17165,720575940629324026,right,T5d,340,-4,17,12,5,"-4,17"
17166,720575940624722924,right,T5d,341,6,-17,-15,-2,"6,-17"
17167,720575940628266373,right,T5d,342,2,-15,-10,-5,"2,-15"
17168,720575940618256724,right,T5d,343,-3,27,16,11,"-3,27"
17169,720575940606774146,right,T5d,344,-2,-15,-6,-9,"-2,-15"
17170,720575940634727834,right,T5d,345,3,-12,-9,-3,"3,-12"
17171,720575940633035693,right,T5d,346,-7,-9,2,-11,"-7,-9"
17172,720575940628842651,right,T5d,347,-5,-13,-2,-11,"-5,-13"
17173,720575940624516391,right,T5d,348,3,14,4,10,"3,14"
17174,720575940624741371,right,T5d,349,-5,-14,-2,-12,"-5,-14"
17175,720575940623853309,right,T5d,350,1,15,6,9,"1,15"
17176,720575940623090884,right,T5d,351,-1,-17,-8,-9,"-1,-17"
17177,720575940625227708,right,T5d,352,-2,28,16,12,"-2,28"
17178,720575940628775952,right,T5d,353,2,24,10,14,"2,24"
17179,720575940621446772,right,T5d,355,-7,-6,4,-10,"-7,-6"
17180,720575940618787229,right,T5d,356,0,22,11,11,"0,22"
17181,720575940613653394,right,T5d,357,4,17,4,13,"4,17"
17182,720575940605500862,right,T5d,358,-3,17,11,6,"-3,17"
17183,720575940619839821,right,T5d,359,2,23,9,14,"2,23"
17184,720575940628992330,right,T5d,360,-5,19,14,5,"-5,19"
17185,720575940634716058,right,T5d,361,0,-7,-4,-3,"0,-7"
17186,720575940618229312,right,T5d,362,2,-20,-12,-8,"2,-20"
17187,720575940624867571,right,T5d,363,7,-4,-9,5,"7,-4"
17188,720575940617657205,right,T5d,364,4,4,-2,6,"4,4"
17189,720575940608562185,right,T5d,365,4,7,-1,8,"4,7"
17190,720575940642641037,right,T5d,367,-6,-15,-2,-13,"-6,-15"
17191,720575940622390810,right,T5d,368,-4,-20,-6,-14,"-4,-20"
17192,720575940623859463,right,T5d,369,5,-5,-8,3,"5,-5"
17193,720575940645457262,right,T5d,370,-3,21,13,8,"-3,21"
17194,720575940614045858,right,T5d,371,6,-5,-9,4,"6,-5"
17195,720575940631401064,right,T5d,372,1,-2,-2,0,"1,-2"
17196,720575940645448996,right,T5d,373,1,-21,-12,-9,"1,-21"
17197,720575940637094256,right,T5d,374,2,13,4,9,"2,13"
17198,720575940638648553,right,T5d,375,-6,7,9,-2,"-6,7"
17199,720575940631290410,right,T5d,377,0,7,3,4,"0,7"
17200,720575940639592611,right,T5d,378,-3,18,12,6,"-3,18"
17201,720575940626122780,right,T5d,379,3,-17,-12,-5,"3,-17"
17202,720575940632872670,right,T5d,380,-1,29,15,14,"-1,29"
17203,720575940620148416,right,T5d,382,3,-6,-6,0,"3,-6"
17204,720575940633704217,right,T5d,383,-6,11,11,0,"-6,11"
17205,720575940626689917,right,T5d,384,-6,-2,5,-7,"-6,-2"
17206,720575940651801590,right,T5d,385,-3,-18,-6,-12,"-3,-18"
17207,720575940641100021,right,T5d,386,-6,19,15,4,"-6,19"
17208,720575940615142047,right,T5d,387,-1,-15,-7,-8,"-1,-15"
17209,720575940639405885,right,T5d,388,3,19,6,13,"3,19"
17210,720575940632453459,right,T5d,391,4,-3,-6,3,"4,-3"
17211,720575940625674533,right,T5d,392,-4,7,7,0,"-4,7"
17212,720575940623306198,right,T5d,393,-1,22,12,10,"-1,22"
17213,720575940632264775,right,T5d,394,-7,-8,3,-11,"-7,-8"
17214,720575940643786144,right,T5d,395,0,-22,-11,-11,"0,-22"
17215,720575940633784986,right,T5d,396,-1,10,6,4,"-1,10"
17216,720575940625044068,right,T5d,397,-3,-19,-7,-12,"-3,-19"
17217,720575940630802373,right,T5d,398,-3,22,14,8,"-3,22"
17218,720575940631446570,right,T5d,401,-2,-19,-8,-11,"-2,-19"
17219,720575940628881660,right,T5d,402,3,26,10,16,"3,26"
17220,720575940621776842,right,T5d,403,-2,-12,-4,-8,"-2,-12"
17221,720575940629821483,right,T5d,404,-1,20,11,9,"-1,20"
17222,720575940616528145,right,T5d,405,3,10,2,8,"3,10"
17223,720575940643436704,right,T5d,406,1,-25,-14,-11,"1,-25"
17224,720575940610970586,right,T5d,407,-5,-10,0,-10,"-5,-10"
17225,720575940623724873,right,T5d,408,-6,-4,4,-8,"-6,-4"
17226,720575940614283426,right,T5d,409,0,-3,-2,-1,"0,-3"
17227,720575940613226221,right,T5d,410,-2,-2,1,-3,"-2,-2"
17228,720575940655389089,right,T5d,411,-5,-19,-5,-14,"-5,-19"
17229,720575940624917847,right,T5d,412,-6,21,16,5,"-6,21"
17230,720575940627038010,right,T5d,413,-2,-7,-2,-5,"-2,-7"
17231,720575940623363533,right,T5d,414,4,21,6,15,"4,21"
17232,720575940627266566,right,T5d,415,6,12,0,12,"6,12"
17233,720575940626993470,right,T5d,416,3,-8,-7,-1,"3,-8"
17234,720575940627135625,right,T5d,417,-6,-10,1,-11,"-6,-10"
17235,720575940616109825,right,T5d,418,-2,15,9,6,"-2,15"
17236,720575940612360755,right,T5d,419,-3,-11,-3,-8,"-3,-11"
17237,720575940645524846,right,T5d,420,6,-3,-8,5,"6,-3"
17238,720575940619221809,right,T5d,421,-1,12,7,5,"-1,12"
17239,720575940646877236,right,T5d,423,3,-18,-12,-6,"3,-18"
17240,720575940611832538,right,T5d,424,-3,-2,2,-4,"-3,-2"
17241,720575940630582779,right,T5d,425,3,20,7,13,"3,20"
17242,720575940608244316,right,T5d,426,-3,0,3,-3,"-3,0"
17243,720575940628624683,right,T5d,427,5,-18,-14,-4,"5,-18"
17244,720575940643671456,right,T5d,428,-2,23,13,10,"-2,23"
17245,720575940644957640,right,T5d,429,-2,14,9,5,"-2,14"
17246,720575940625754942,right,T5d,430,-3,-7,-1,-6,"-3,-7"
17247,720575940631624760,right,T5d,431,-2,-10,-3,-7,"-2,-10"
17248,720575940613756778,right,T5d,432,-5,7,8,-1,"-5,7"
17249,720575940624487954,right,T5d,433,0,-8,-4,-4,"0,-8"
17250,720575940625953598,right,T5d,434,-3,7,6,1,"-3,7"
17251,720575940623523293,right,T5d,435,5,-17,-14,-3,"5,-17"
17252,720575940617387035,right,T5d,436,0,-15,-8,-7,"0,-15"
17253,720575940634781082,right,T5d,437,-3,12,9,3,"-3,12"
17254,720575940646291822,right,T5d,438,2,27,11,16,"2,27"
17255,720575940613601576,right,T5d,439,-3,-9,-2,-7,"-3,-9"
17256,720575940605931180,right,T5d,440,1,23,10,13,"1,23"
17257,720575940612489166,right,T5d,441,3,-16,-11,-5,"3,-16"
17258,720575940640846208,right,T5d,442,-5,25,17,8,"-5,25"
17259,720575940636237198,right,T5d,444,4,-10,-9,-1,"4,-10"
17260,720575940628539907,right,T5d,445,-2,8,6,2,"-2,8"
17261,720575940646527028,right,T5d,446,2,-14,-9,-5,"2,-14"
17262,720575940627511568,right,T5d,447,-1,2,2,0,"-1,2"
17263,720575940630590590,right,T5d,448,0,30,15,15,"0,30"
17264,720575940626208850,right,T5d,449,6,-16,-14,-2,"6,-16"
17265,720575940654910113,right,T5d,450,2,-9,-7,-2,"2,-9"
17266,720575940622079612,right,T5d,451,4,20,6,14,"4,20"
17267,720575940616205707,right,T5d,452,1,-9,-6,-3,"1,-9"
17268,720575940614552470,right,T5d,454,5,-12,-11,-1,"5,-12"
17269,720575940627579934,right,T5d,456,0,21,10,11,"0,21"
17270,720575940627770344,right,T5d,457,-2,17,10,7,"-2,17"
17271,720575940630971599,right,T5d,459,5,-3,-7,4,"5,-3"
17272,720575940611523938,right,T5d,460,-3,-20,-7,-13,"-3,-20"
17273,720575940620336208,right,T5d,461,7,-5,-10,5,"7,-5"
17274,720575940621521396,right,T5d,462,-1,18,10,8,"-1,18"
17275,720575940623610090,right,T5d,463,5,17,3,14,"5,17"
17276,720575940637881919,right,T5d,464,4,0,-4,4,"4,0"
17277,720575940640505552,right,T5d,465,3,0,-3,3,"3,0"
17278,720575940619466772,right,T5d,466,1,14,6,8,"1,14"
17279,720575940626333954,right,T5d,467,-2,-20,-8,-12,"-2,-20"
17280,720575940625959780,right,T5d,468,-3,11,8,3,"-3,11"
17281,720575940644400164,right,T5d,469,-7,13,13,0,"-7,13"
17282,720575940629622910,right,T5d,470,4,-9,-9,0,"4,-9"
17283,720575940627407125,right,T5d,471,3,-26,-16,-10,"3,-26"
17284,720575940619868795,right,T5d,472,1,25,11,14,"1,25"
17285,720575940632309156,right,T5d,473,-4,23,15,8,"-4,23"
17286,720575940631251743,right,T5d,474,-3,-17,-6,-11,"-3,-17"
17287,720575940625649594,right,T5d,475,-4,-1,3,-4,"-4,-1"
17288,720575940627100170,right,T5d,476,-1,15,8,7,"-1,15"
17289,720575940638861365,right,T5d,477,-3,2,4,-2,"-3,2"
17290,720575940615693766,right,T5d,479,-2,10,7,3,"-2,10"
17291,720575940635666031,right,T5d,480,3,-19,-13,-6,"3,-19"
17292,720575940604487968,right,T5d,481,4,-8,-8,0,"4,-8"
17293,720575940608947651,right,T5d,482,1,17,7,10,"1,17"
17294,720575940623353226,right,T5d,483,2,-7,-6,-1,"2,-7"
17295,720575940635414708,right,T5d,484,3,-9,-8,-1,"3,-9"
17296,720575940618097482,right,T5d,485,-3,-3,1,-4,"-3,-3"
17297,720575940627254020,right,T5d,486,0,1,0,1,"0,1"
17298,720575940614300994,right,T5d,487,1,-1,-2,1,"1,-1"
17299,720575940609835332,right,T5d,488,7,5,-5,10,"7,5"
17300,720575940621696094,right,T5d,489,-3,10,8,2,"-3,10"
17301,720575940627418184,right,T5d,490,-5,6,8,-2,"-5,6"
17302,720575940613997265,right,T5d,491,7,-1,-8,7,"7,-1"
17303,720575940639215950,right,T5d,492,-7,-2,6,-8,"-7,-2"
17304,720575940625426832,right,T5d,493,-3,23,14,9,"-3,23"
17305,720575940617531478,right,T5d,494,0,29,14,15,"0,29"
17306,720575940621794586,right,T5d,495,4,5,-2,7,"4,5"
17307,720575940626979252,right,T5d,497,6,1,-6,7,"6,1"
17308,720575940620551776,right,T5d,498,6,10,-1,11,"6,10"
17309,720575940617171985,right,T5d,499,5,10,0,10,"5,10"
17310,720575940624905616,right,T5d,500,7,-8,-11,3,"7,-8"
17311,720575940627682577,right,T5d,501,1,2,0,2,"1,2"
17312,720575940638581080,right,T5d,502,5,8,-1,9,"5,8"
17313,720575940614395885,right,T5d,503,3,17,5,12,"3,17"
17314,720575940624114923,right,T5d,504,-2,9,6,3,"-2,9"
17315,720575940633185363,right,T5d,506,1,-12,-7,-5,"1,-12"
17316,720575940610742882,right,T5d,507,-5,-12,-1,-11,"-5,-12"
17317,720575940617250489,right,T5d,508,-5,11,10,1,"-5,11"
17318,720575940613925073,right,T5d,509,-4,10,9,1,"-4,10"
17319,720575940629633015,right,T5d,510,-2,11,7,4,"-2,11"
17320,720575940641639899,right,T5d,511,5,-11,-11,0,"5,-11"
17321,720575940623502572,right,T5d,512,6,0,-6,6,"6,0"
17322,720575940610732386,right,T5d,513,-4,-13,-3,-10,"-4,-13"
17323,720575940614689938,right,T5d,514,-4,-10,-1,-9,"-4,-10"
17324,720575940649861753,right,T5d,515,-8,-7,4,-11,"-8,-7"
17325,720575940639765693,right,T5d,517,6,3,-5,8,"6,3"
17326,720575940630683692,right,T5d,518,-4,22,15,7,"-4,22"
17327,720575940611961306,right,T5d,520,-2,-22,-9,-13,"-2,-22"
17328,720575940627097118,right,T5d,521,6,-9,-11,2,"6,-9"
17329,720575940621608993,right,T5d,522,-4,0,4,-4,"-4,0"
17330,720575940606862978,right,T5d,523,2,14,5,9,"2,14"
17331,720575940614582397,right,T5d,524,4,-20,-14,-6,"4,-20"
17332,720575940631550520,right,T5d,525,-1,-20,-9,-11,"-1,-20"
17333,720575940627466748,right,T5d,526,0,-10,-5,-5,"0,-10"
17334,720575940614106791,right,T5d,527,-4,-8,0,-8,"-4,-8"
17335,720575940626609277,right,T5d,528,2,7,1,6,"2,7"
17336,720575940624194378,right,T5d,529,2,-2,-3,1,"2,-2"
17337,720575940610731618,right,T5d,530,-3,-13,-4,-9,"-3,-13"
17338,720575940624347210,right,T5d,531,1,0,-1,1,"1,0"
17339,720575940627521679,right,T5d,532,-8,7,11,-4,"-8,7"
17340,720575940621873610,right,T5d,533,0,-16,-8,-8,"0,-16"
17341,720575940633777247,right,T5d,534,3,2,-2,4,"3,2"
17342,720575940645020526,right,T5d,536,3,4,-1,5,"3,4"
17343,720575940620768347,right,T5d,537,0,-23,-12,-11,"0,-23"
17344,720575940646492212,right,T5d,538,-4,1,4,-3,"-4,1"
17345,720575940618400216,right,T5d,539,-6,15,13,2,"-6,15"
17346,720575940625770073,right,T5d,540,-2,-9,-3,-6,"-2,-9"
17347,720575940659893633,right,T5d,541,-4,14,11,3,"-4,14"
17348,720575940624432615,right,T5d,543,-1,-4,-1,-3,"-1,-4"
17349,720575940627062274,right,T5d,544,3,-13,-10,-3,"3,-13"
17350,720575940624953784,right,T5d,545,5,11,0,11,"5,11"
17351,720575940624207347,right,T5d,546,3,6,0,6,"3,6"
17352,720575940644937672,right,T5d,547,-1,21,11,10,"-1,21"
17353,720575940624921274,right,T5d,548,1,-16,-9,-7,"1,-16"
17354,720575940627819931,right,T5d,549,0,-9,-5,-4,"0,-9"
17355,720575940621466236,right,T5d,550,-2,3,3,0,"-2,3"
17356,720575940605738417,right,T5d,551,-4,-9,-1,-8,"-4,-9"
17357,720575940638639924,right,T5d,552,4,-1,-5,4,"4,-1"
17358,720575940639617443,right,T5d,553,-3,16,11,5,"-3,16"
17359,720575940611556757,right,T5d,555,-4,9,8,1,"-4,9"
17360,720575940623937724,right,T5d,556,0,10,5,5,"0,10"
17361,720575940620932417,right,T5d,557,6,-10,-11,1,"6,-10"
17362,720575940624136636,right,T5d,558,-4,-21,-7,-14,"-4,-21"
17363,720575940617442022,right,T5d,559,-6,22,17,5,"-6,22"
17364,720575940624530151,right,T5d,560,-7,14,14,0,"-7,14"
17365,720575940623153546,right,T5d,561,5,7,-2,9,"5,7"
17366,720575940611746995,right,T5d,562,-5,-2,4,-6,"-5,-2"
17367,720575940642343157,right,T5d,563,5,-13,-12,-1,"5,-13"
17368,720575940608246281,right,T5d,564,3,-23,-15,-8,"3,-23"
17369,720575940620662619,right,T5d,565,0,-26,-13,-13,"0,-26"
17370,720575940639646323,right,T5d,566,5,-8,-9,1,"5,-8"
17371,720575940631347218,right,T5d,567,-2,22,13,9,"-2,22"
17372,720575940614033887,right,T5d,568,-6,-8,2,-10,"-6,-8"
17373,720575940627834511,right,T5d,569,6,6,-3,9,"6,6"
17374,720575940619827277,right,T5d,570,2,25,10,15,"2,25"
17375,720575940621972938,right,T5d,571,0,-14,-7,-7,"0,-14"
17376,720575940633159650,right,T5d,572,-8,3,9,-6,"-8,3"
17377,720575940605334886,right,T5d,573,4,14,3,11,"4,14"
17378,720575940636880240,right,T5d,574,-6,5,8,-3,"-6,5"
17379,720575940620445536,right,T5d,575,6,9,-2,11,"6,9"
17380,720575940610195139,right,T5d,576,0,28,14,14,"0,28"
17381,720575940631111936,right,T5d,577,5,-14,-12,-2,"5,-14"
17382,720575940637765951,right,T5d,578,4,-11,-10,-1,"4,-11"
17383,720575940635344052,right,T5d,579,-3,-10,-2,-8,"-3,-10"
17384,720575940617807650,right,T5d,580,-2,-23,-10,-13,"-2,-23"
17385,720575940612055219,right,T5d,581,3,9,1,8,"3,9"
17386,720575940661041537,right,T5d,582,-1,23,12,11,"-1,23"
17387,720575940643482784,right,T5d,583,3,-25,-16,-9,"3,-25"
17388,720575940619825485,right,T5d,584,4,23,7,16,"4,23"
17389,720575940606986418,right,T5d,586,2,18,7,11,"2,18"
17390,720575940640970997,right,T5d,587,4,22,7,15,"4,22"
17391,720575940631108805,right,T5d,588,1,4,1,3,"1,4"
17392,720575940622081448,right,T5d,589,-1,-5,-2,-3,"-1,-5"
17393,720575940606855810,right,T5d,590,1,9,3,6,"1,9"
17394,720575940626557839,right,T5d,591,3,-3,-5,2,"3,-3"
17395,720575940644671255,right,T5d,593,3,-14,-10,-4,"3,-14"
17396,720575940605712486,right,T5d,594,7,-16,-15,-1,"7,-16"
17397,720575940625386317,right,T5d,596,-4,-16,-4,-12,"-4,-16"
17398,720575940627909361,right,T5d,597,4,1,-4,5,"4,1"
17399,720575940615788603,right,T5d,598,2,-18,-11,-7,"2,-18"
17400,720575940617636609,right,T5d,599,-1,9,5,4,"-1,9"
17401,720575940639544179,right,T5d,600,3,-10,-8,-2,"3,-10"
17402,720575940628681259,right,T5d,601,1,16,7,9,"1,16"
17403,720575940619616080,right,T5d,602,4,-2,-5,3,"4,-2"
17404,720575940637000590,right,T5d,603,-3,-23,-9,-14,"-3,-23"
17405,720575940610238510,right,T5d,605,3,15,4,11,"3,15"
17406,720575940608041923,right,T5d,606,-1,-19,-9,-10,"-1,-19"
17407,720575940644787310,right,T5d,607,1,18,8,10,"1,18"
17408,720575940636733582,right,T5d,608,1,10,4,6,"1,10"
17409,720575940629243191,right,T5d,609,-2,0,2,-2,"-2,0"
17410,720575940612931480,right,T5d,610,2,-23,-14,-9,"2,-23"
17411,720575940626344741,right,T5d,611,-1,-18,-8,-10,"-1,-18"
17412,720575940639481944,right,T5d,614,-2,-8,-2,-6,"-2,-8"
17413,720575940633352127,right,T5d,615,-7,-7,3,-10,"-7,-7"
17414,720575940619438795,right,T5d,616,-3,15,10,5,"-3,15"
17415,720575940614176066,right,T5d,617,-2,-17,-7,-10,"-2,-17"
17416,720575940613570326,right,T5d,618,-1,24,13,11,"-1,24"
17417,720575940619367838,right,T5d,620,7,1,-7,8,"7,1"
17418,720575940630971136,right,T5d,621,1,24,11,13,"1,24"
17419,720575940625344014,right,T5d,622,-5,20,15,5,"-5,20"
17420,720575940630390142,right,T5d,623,1,13,5,8,"1,13"
17421,720575940637760309,right,T5d,624,1,-17,-10,-7,"1,-17"
17422,720575940612115685,right,T5d,625,-2,24,14,10,"-2,24"
17423,720575940620370347,right,T5d,626,-5,-8,1,-9,"-5,-8"
17424,720575940624167143,right,T5d,627,0,-1,-1,0,"0,-1"
17425,720575940621736205,right,T5d,628,0,0,0,0,"0,0"
17426,720575940612081777,right,T5d,629,4,24,8,16,"4,24"
17427,720575940608535876,right,T5d,630,4,8,0,8,"4,8"
17428,720575940643192205,right,T5d,631,1,26,12,14,"1,26"
17429,720575940618627669,right,T5d,632,3,-20,-13,-7,"3,-20"
17430,720575940631563205,right,T5d,633,-1,-24,-11,-13,"-1,-24"
17431,720575940622128586,right,T5d,634,-3,-15,-5,-10,"-3,-15"
17432,720575940615987131,right,T5d,635,6,-6,-9,3,"6,-6"
17433,720575940610811746,right,T5d,636,0,6,3,3,"0,6"
17434,720575940630543055,right,T5d,637,3,-21,-14,-7,"3,-21"
17435,720575940629863680,right,T5d,638,-1,7,4,3,"-1,7"
17436,720575940623892041,right,T5d,639,-4,19,13,6,"-4,19"
17437,720575940618664533,right,T5d,640,-1,-16,-7,-9,"-1,-16"
17438,720575940618654282,right,T5d,641,-8,-5,5,-10,"-8,-5"
17439,720575940635870576,right,T5d,642,-5,-11,-1,-10,"-5,-11"
17440,720575940621378725,right,T5d,643,6,14,1,13,"6,14"
17441,720575940627149322,right,T5d,644,-6,18,15,3,"-6,18"
17442,720575940629260803,right,T5d,645,-4,27,17,10,"-4,27"
17443,720575940623798931,right,T5d,647,-4,-7,0,-7,"-4,-7"
17444,720575940645538356,right,T5d,648,1,7,2,5,"1,7"
17445,720575940605336422,right,T5d,649,-1,5,3,2,"-1,5"
17446,720575940609361621,right,T5d,650,-3,-25,-10,-15,"-3,-25"
17447,720575940627994865,right,T5d,651,-4,-5,1,-6,"-4,-5"
17448,720575940626063292,right,T5d,653,-6,-12,0,-12,"-6,-12"
17449,720575940619670101,right,T5d,654,-3,8,7,1,"-3,8"
17450,720575940635164011,right,T5d,655,6,-1,-7,6,"6,-1"
17451,720575940621169228,right,T5d,656,0,-11,-6,-5,"0,-11"
17452,720575940622785560,right,T5d,658,1,20,9,11,"1,20"
17453,720575940627456529,right,T5d,659,-4,-6,1,-7,"-4,-6"
17454,720575940615490450,right,T5d,660,2,28,12,16,"2,28"
17455,720575940643752392,right,T5d,661,-3,14,10,4,"-3,14"
17456,720575940600866569,right,T5d,662,2,-1,-3,2,"2,-1"
17457,720575940644684823,right,T5d,663,0,8,4,4,"0,8"
17458,720575940629758330,right,T5d,664,1,-27,-15,-12,"1,-27"
17459,720575940620892193,right,T5d,665,7,-2,-8,6,"7,-2"
17460,720575940615580831,right,T5d,667,1,-28,-15,-13,"1,-28"
17461,720575940640567760,right,T5d,668,1,19,8,11,"1,19"
17462,720575940629791232,right,T5d,669,4,-16,-12,-4,"4,-16"
17463,720575940622599267,right,T5d,670,5,5,-3,8,"5,5"
17464,720575940622628702,right,T5d,671,-4,-23,-8,-15,"-4,-23"
17465,720575940630654927,right,T5d,672,-8,11,13,-2,"-8,11"
17466,720575940616906641,right,T5d,673,2,5,0,5,"2,5"
17467,720575940626506716,right,T5d,674,-4,-14,-3,-11,"-4,-14"
17468,720575940636824750,right,T5d,676,-3,-21,-8,-13,"-3,-21"
17469,720575940625811518,right,T5d,677,0,11,5,6,"0,11"
17470,720575940632850643,right,T5d,678,3,-7,-7,0,"3,-7"
17471,720575940645786222,right,T5d,679,4,18,5,13,"4,18"
17472,720575940636918639,right,T5d,680,-1,25,13,12,"-1,25"
17473,720575940631007051,right,T5d,681,-2,-21,-9,-12,"-2,-21"
17474,720575940621132108,right,T5d,682,6,-8,-10,2,"6,-8"
17475,720575940627985905,right,T5d,683,2,6,1,5,"2,6"
17476,720575940607040178,right,T5d,684,-6,17,14,3,"-6,17"
17477,720575940622067572,right,T5d,685,-5,-9,0,-9,"-5,-9"
17478,720575940621828272,right,T5d,687,-6,-3,4,-7,"-6,-3"
17479,720575940615658508,right,T5d,688,-7,10,12,-2,"-7,10"
17480,720575940623869769,right,T5d,689,-2,18,11,7,"-2,18"
17481,720575940605559328,right,T5d,691,-9,4,11,-7,"-9,4"
17482,720575940632709068,right,T5d,692,-4,24,16,8,"-4,24"
17483,720575940628869431,right,T5d,693,-3,25,15,10,"-3,25"
17484,720575940632091812,right,T5d,694,4,3,-3,6,"4,3"
17485,720575940611773282,right,T5d,695,-6,10,11,-1,"-6,10"
17486,720575940634242782,right,T5d,696,-2,16,10,6,"-2,16"
17487,720575940632095313,right,T5d,697,1,-22,-12,-10,"1,-22"
17488,720575940628887375,right,T5d,698,6,-7,-10,3,"6,-7"
17489,720575940630834191,right,T5d,699,-5,0,5,-5,"-5,0"
17490,720575940617311761,right,T5d,700,5,15,2,13,"5,15"
17491,720575940637463262,right,T5d,701,0,-4,-2,-2,"0,-4"
17492,720575940640851584,right,T5d,702,-5,23,16,7,"-5,23"
17493,720575940613294632,right,T5d,703,-3,1,3,-2,"-3,1"
17494,720575940614833002,right,T5d,704,-7,8,11,-3,"-7,8"
17495,720575940624127219,right,T5d,705,1,1,-1,2,"1,1"
17496,720575940626798778,right,T5d,707,-2,25,14,11,"-2,25"
17497,720575940627763855,right,T5d,709,-2,-24,-10,-14,"-2,-24"
17498,720575940630903948,right,T5d,711,-1,19,10,9,"-1,19"
17499,720575940644744727,right,T5d,712,-7,12,13,-1,"-7,12"
17500,720575940616921089,right,T5d,713,-6,16,14,2,"-6,16"
17501,720575940612909265,right,T5d,714,5,12,1,11,"5,12"
17502,720575940631701608,right,T5d,715,4,10,1,9,"4,10"
17503,720575940636067191,right,T5d,716,4,-6,-7,1,"4,-6"
17504,720575940620824667,right,T5d,717,2,-22,-13,-9,"2,-22"
17505,720575940620805824,right,T5d,718,-5,24,17,7,"-5,24"
17506,720575940627397507,right,T5d,719,1,27,12,15,"1,27"
17507,720575940643773128,right,T5d,720,-5,21,15,6,"-5,21"
17508,720575940620102576,right,T5d,721,5,13,1,12,"5,13"
17509,720575940628180935,right,T5d,722,6,-15,-14,-1,"6,-15"
17510,720575940616516235,right,T5d,723,-2,-11,-4,-7,"-2,-11"
17511,720575940625558160,right,T5d,724,4,2,-3,5,"4,2"
17512,720575940626241555,right,T5d,725,-3,-24,-9,-15,"-3,-24"
17513,720575940620553125,right,T5d,726,2,-28,-16,-12,"2,-28"
17514,720575940612561561,right,T5d,728,7,12,-1,13,"7,12"
17515,720575940630905415,right,T5d,729,-3,29,17,12,"-3,29"
17516,720575940621561328,right,T5d,730,7,0,-7,7,"7,0"
17517,720575940608405515,right,T5d,731,-6,9,10,-1,"-6,9"
17518,720575940614014179,right,T5d,732,-3,6,6,0,"-3,6"
17519,720575940629987575,right,T5d,733,-5,-17,-4,-13,"-5,-17"
17520,720575940638562356,right,T5d,734,2,0,-2,2,"2,0"
17521,720575940621548276,right,T5d,735,1,-23,-13,-10,"1,-23"
17522,720575940620840102,right,T5d,736,-8,1,8,-7,"-8,1"
17523,720575940626497284,right,T5d,737,0,19,9,10,"0,19"
17524,720575940624189479,right,T5d,738,-3,13,9,4,"-3,13"
17525,720575940604704940,right,T5d,739,-7,2,8,-6,"-7,2"
17526,720575940627980905,right,T5d,740,2,-8,-6,-2,"2,-8"
17527,720575940623036618,right,T5d,741,-2,-14,-5,-9,"-2,-14"
17528,720575940616828172,right,T5d,742,-4,11,9,2,"-4,11"
17529,720575940628316989,right,T5d,744,-4,25,16,9,"-4,25"
17530,720575940637873471,right,T5d,745,0,13,6,7,"0,13"
17531,720575940637728858,right,T5d,746,-3,3,4,-1,"-3,3"
17532,720575940623368887,right,T5d,747,0,2,1,1,"0,2"
17533,720575940618813563,right,T5d,748,-4,20,14,6,"-4,20"
17534,720575940642940724,right,T5d,749,-2,1,2,-1,"-2,1"
17535,720575940613042802,right,T5d,750,4,-24,-16,-8,"4,-24"
17536,720575940643808535,right,T5d,751,1,6,2,4,"1,6"
17537,720575940625956396,right,T5d,752,-2,7,5,2,"-2,7"
17538,720575940634974103,right,T5d,753,-3,24,15,9,"-3,24"
17539,720575940622290954,right,T5d,754,-1,-13,-6,-7,"-1,-13"
17540,720575940623972605,right,T5d,755,4,19,5,14,"4,19"
17541,720575940623149192,right,T5d,756,5,20,5,15,"5,20"
17542,720575940637541773,right,T5d,757,0,-6,-3,-3,"0,-6"
17543,720575940612072677,right,T5d,758,5,-1,-6,5,"5,-1"
17544,720575940621454256,right,T5d,759,7,14,0,14,"7,14"
17545,720575940614398370,right,T5d,760,0,17,8,9,"0,17"
17546,720575940644428488,right,T5d,761,-4,-18,-5,-13,"-4,-18"
17547,720575940621798494,right,T5d,762,0,14,7,7,"0,14"
17548,720575940637772772,right,T5d,763,-5,14,12,2,"-5,14"
17549,720575940617689561,right,T5d,764,-8,-6,5,-11,"-8,-6"
17550,720575940636865904,right,T5d,765,-3,9,7,2,"-3,9"
17551,720575940660329601,right,T5d,766,2,-4,-4,0,"2,-4"
17552,720575940620815124,right,T5d,767,1,28,13,15,"1,28"
17553,720575940628467243,right,T5d,768,3,5,-1,6,"3,5"
17554,720575940622686819,right,T5d,770,5,4,-3,7,"5,4"
17555,720575940616194772,right,T5d,772,1,12,5,7,"1,12"
17556,720575940626061756,right,T5d,773,5,-19,-15,-4,"5,-19"
17557,720575940619860301,right,T5d,775,5,22,6,16,"5,22"
17558,720575940625257805,right,T5d,776,5,21,5,16,"5,21"
17559,720575940608486921,right,T5d,778,4,25,8,17,"4,25"
17560,720575940631003192,right,T5d,780,-6,25,18,7,"-6,25"
17561,720575940627231006,right,T5d,781,-5,26,18,8,"-5,26"
17562,720575940645628695,right,T5d,782,-5,27,18,9,"-5,27"
17563,720575940616481766,right,T5d,783,-4,28,18,10,"-4,28"
17564,720575940627571773,right,T5d,784,-4,29,18,11,"-4,29"
17565,720575940609208412,right,T5d,786,-2,30,17,13,"-2,30"
17566,720575940615564354,right,T5d,787,3,28,11,17,"3,28"
17567,720575940619890136,right,T5d,790,-2,-27,-12,-15,"-2,-27"
17568,720575940640766004,right,T5d,792,8,2,-7,9,"8,2"
17569,720575940627086681,right,T5d,796,4,26,9,17,"4,26"
17570,720575940619804144,right,Tm1,1,-6,13,12,1,"-6,13"
17571,720575940629500747,right,Tm1,2,-8,2,9,-7,"-8,2"
17572,720575940610239790,right,Tm1,3,6,-12,-12,0,"6,-12"
17573,720575940634233712,right,Tm1,4,-5,-21,-6,-15,"-5,-21"
17574,720575940618007877,right,Tm1,5,-1,16,9,7,"-1,16"
17575,720575940617474777,right,Tm1,6,-2,-4,0,-4,"-2,-4"
17576,720575940616603787,right,Tm1,7,-6,-6,3,-9,"-6,-6"
17577,720575940617161243,right,Tm1,8,-4,26,17,9,"-4,26"
17578,720575940633671469,right,Tm1,9,4,9,0,9,"4,9"
17579,720575940659904385,right,Tm1,10,5,-15,-13,-2,"5,-15"
17580,720575940614365343,right,Tm1,11,7,-14,-14,0,"7,-14"
17581,720575940622368589,right,Tm1,12,-7,9,11,-2,"-7,9"
17582,720575940624379912,right,Tm1,13,-1,-26,-12,-14,"-1,-26"
17583,720575940619724248,right,Tm1,14,0,-27,-14,-13,"0,-27"
17584,720575940609482616,right,Tm1,15,2,-3,-4,1,"2,-3"
17585,720575940632682444,right,Tm1,16,-2,-16,-6,-10,"-2,-16"
17586,720575940620888865,right,Tm1,17,1,-5,-4,-1,"1,-5"
17587,720575940637794281,right,Tm1,18,5,-16,-13,-3,"5,-16"
17588,720575940605179849,right,Tm1,19,-7,17,15,2,"-7,17"
17589,720575940625541936,right,Tm1,20,3,-11,-9,-2,"3,-11"
17590,720575940637734372,right,Tm1,21,-2,19,11,8,"-2,19"
17591,720575940622402742,right,Tm1,22,-1,3,2,1,"-1,3"
17592,720575940623364649,right,Tm1,23,-3,-16,-5,-11,"-3,-16"
17593,720575940642661024,right,Tm1,24,-1,-10,-4,-6,"-1,-10"
17594,720575940644820168,right,Tm1,25,-9,3,10,-7,"-9,3"
17595,720575940620297793,right,Tm1,26,1,-3,-3,0,"1,-3"
17596,720575940628577960,right,Tm1,27,0,-25,-13,-12,"0,-25"
17597,720575940616414523,right,Tm1,29,-1,-3,-1,-2,"-1,-3"
17598,720575940614164655,right,Tm1,30,6,16,2,14,"6,16"
17599,720575940606824834,right,Tm1,31,0,16,8,8,"0,16"
17600,720575940619576661,right,Tm1,32,0,12,6,6,"0,12"
17601,720575940616351686,right,Tm1,33,3,18,6,12,"3,18"
17602,720575940622999245,right,Tm1,34,6,18,3,15,"6,18"
17603,720575940616503739,right,Tm1,35,1,-24,-13,-11,"1,-24"
17604,720575940626924184,right,Tm1,36,6,8,-2,10,"6,8"
17605,720575940635947438,right,Tm1,37,1,5,1,4,"1,5"
17606,720575940632070829,right,Tm1,38,0,-2,-1,-1,"0,-2"
17607,720575940605816422,right,Tm1,39,0,20,10,10,"0,20"
17608,720575940626211621,right,Tm1,40,-2,-6,-1,-5,"-2,-6"
17609,720575940629233884,right,Tm1,41,-3,28,17,11,"-3,28"
17610,720575940622605388,right,Tm1,42,-1,14,8,6,"-1,14"
17611,720575940621199966,right,Tm1,43,-5,18,14,4,"-5,18"
17612,720575940625875282,right,Tm1,44,5,-10,-10,0,"5,-10"
17613,720575940619173997,right,Tm1,45,-5,-1,4,-5,"-5,-1"
17614,720575940615118731,right,Tm1,46,-5,15,12,3,"-5,15"
17615,720575940624525630,right,Tm1,47,-9,-1,8,-9,"-9,-1"
17616,720575940630274663,right,Tm1,48,-4,-22,-7,-15,"-4,-22"
17617,720575940638748093,right,Tm1,49,4,-4,-6,2,"4,-4"
17618,720575940620149627,right,Tm1,50,-2,21,12,9,"-2,21"
17619,720575940627269950,right,Tm1,51,0,-19,-10,-9,"0,-19"
17620,720575940631344914,right,Tm1,52,-1,-22,-10,-12,"-1,-22"
17621,720575940629801770,right,Tm1,53,5,14,2,12,"5,14"
17622,720575940620078196,right,Tm1,54,-4,3,5,-2,"-4,3"
17623,720575940623363050,right,Tm1,55,-4,-11,-2,-9,"-4,-11"
17624,720575940612131058,right,Tm1,56,1,-13,-8,-5,"1,-13"
17625,720575940619041752,right,Tm1,57,6,-11,-12,1,"6,-11"
17626,720575940624616426,right,Tm1,58,3,12,3,9,"3,12"
17627,720575940610229346,right,Tm1,59,-2,2,3,-1,"-2,2"
17628,720575940616638806,right,Tm1,60,-8,8,12,-4,"-8,8"
17629,720575940621326104,right,Tm1,61,-4,-4,2,-6,"-4,-4"
17630,720575940620587224,right,Tm1,62,0,-29,-15,-14,"0,-29"
17631,720575940606441150,right,Tm1,63,4,12,2,10,"4,12"
17632,720575940623925175,right,Tm1,64,4,-23,-16,-7,"4,-23"
17633,720575940621338038,right,Tm1,65,-1,28,15,13,"-1,28"
17634,720575940615842098,right,Tm1,66,2,15,5,10,"2,15"
17635,720575940628535356,right,Tm1,67,-2,-13,-5,-8,"-2,-13"
17636,720575940627304213,right,Tm1,68,3,16,5,11,"3,16"
17637,720575940604541798,right,Tm1,70,-4,21,14,7,"-4,21"
17638,720575940635579255,right,Tm1,71,-2,-3,0,-3,"-2,-3"
17639,720575940638211930,right,Tm1,72,0,-28,-14,-14,"0,-28"
17640,720575940624135242,right,Tm1,73,2,2,-1,3,"2,2"
17641,720575940635648367,right,Tm1,74,-1,-9,-4,-5,"-1,-9"
17642,720575940618089045,right,Tm1,75,-6,14,13,1,"-6,14"
17643,720575940626012493,right,Tm1,76,-3,-4,1,-5,"-3,-4"
17644,720575940628144745,right,Tm1,77,2,-5,-5,0,"2,-5"
17645,720575940613069549,right,Tm1,78,2,20,8,12,"2,20"
17646,720575940629673436,right,Tm1,79,2,1,-2,3,"2,1"
17647,720575940635557271,right,Tm1,80,4,13,2,11,"4,13"
17648,720575940610714578,right,Tm1,81,6,-2,-7,5,"6,-2"
17649,720575940624451172,right,Tm1,82,-7,7,10,-3,"-7,7"
17650,720575940634235036,right,Tm1,83,2,-21,-13,-8,"2,-21"
17651,720575940605152177,right,Tm1,84,-2,12,8,4,"-2,12"
17652,720575940627119119,right,Tm1,85,4,-22,-15,-7,"4,-22"
17653,720575940614829023,right,Tm1,86,-5,-7,1,-8,"-5,-7"
17654,720575940622563077,right,Tm1,87,1,11,4,7,"1,11"
17655,720575940624850412,right,Tm1,89,1,-19,-11,-8,"1,-19"
17656,720575940627248380,right,Tm1,90,-4,5,6,-1,"-4,5"
17657,720575940622827658,right,Tm1,91,-1,6,4,2,"-1,6"
17658,720575940635174648,right,Tm1,93,-6,3,7,-4,"-6,3"
17659,720575940630982139,right,Tm1,94,5,18,4,14,"5,18"
17660,720575940627152911,right,Tm1,95,4,-21,-15,-6,"4,-21"
17661,720575940640270976,right,Tm1,96,1,-10,-6,-4,"1,-10"
17662,720575940629279744,right,Tm1,97,-5,2,6,-4,"-5,2"
17663,720575940635115103,right,Tm1,98,-1,-12,-5,-7,"-1,-12"
17664,720575940633545517,right,Tm1,99,4,15,3,12,"4,15"
17665,720575940632231394,right,Tm1,100,2,-10,-7,-3,"2,-10"
17666,720575940612287027,right,Tm1,101,-7,6,10,-4,"-7,6"
17667,720575940617373248,right,Tm1,102,3,13,3,10,"3,13"
17668,720575940640734883,right,Tm1,103,7,9,-3,12,"7,9"
17669,720575940618429414,right,Tm1,104,-1,-27,-13,-14,"-1,-27"
17670,720575940604151520,right,Tm1,105,3,22,8,14,"3,22"
17671,720575940630377697,right,Tm1,106,-7,11,12,-1,"-7,11"
17672,720575940638857542,right,Tm1,107,8,-2,-9,7,"8,-2"
17673,720575940626018096,right,Tm1,108,-3,-12,-3,-9,"-3,-12"
17674,720575940629894160,right,Tm1,109,4,-5,-7,2,"4,-5"
17675,720575940641800589,right,Tm1,110,-7,0,7,-7,"-7,0"
17676,720575940621149761,right,Tm1,111,2,-24,-14,-10,"2,-24"
17677,720575940630930735,right,Tm1,112,-6,1,6,-5,"-6,1"
17678,720575940622943587,right,Tm1,113,-2,4,4,0,"-2,4"
17679,720575940631716399,right,Tm1,114,2,-13,-9,-4,"2,-13"
17680,720575940623465096,right,Tm1,115,-4,2,5,-3,"-4,2"
17681,720575940635790840,right,Tm1,116,-1,-8,-3,-5,"-1,-8"
17682,720575940622520575,right,Tm1,117,-8,-2,7,-9,"-8,-2"
17683,720575940609566276,right,Tm1,118,3,1,-3,4,"3,1"
17684,720575940629345335,right,Tm1,119,-2,6,5,1,"-2,6"
17685,720575940628746746,right,Tm1,120,-1,-1,0,-1,"-1,-1"
17686,720575940610650853,right,Tm1,121,-8,4,10,-6,"-8,4"
17687,720575940628085322,right,Tm1,122,-5,9,9,0,"-5,9"
17688,720575940628890998,right,Tm1,123,-8,10,13,-3,"-8,10"
17689,720575940621354667,right,Tm1,124,1,-7,-5,-2,"1,-7"
17690,720575940649454201,right,Tm1,125,5,9,-1,10,"5,9"
17691,720575940629211258,right,Tm1,126,3,11,2,9,"3,11"
17692,720575940631146026,right,Tm1,127,0,15,7,8,"0,15"
17693,720575940622990118,right,Tm1,128,3,-22,-14,-8,"3,-22"
17694,720575940636790158,right,Tm1,129,0,-13,-7,-6,"0,-13"
17695,720575940628172796,right,Tm1,130,2,12,4,8,"2,12"
17696,720575940611295510,right,Tm1,131,-6,20,16,4,"-6,20"
17697,720575940617503115,right,Tm1,132,2,4,0,4,"2,4"
17698,720575940636346469,right,Tm1,133,-3,20,13,7,"-3,20"
17699,720575940618194461,right,Tm1,134,-5,-18,-4,-14,"-5,-18"
17700,720575940647521156,right,Tm1,135,-3,-22,-8,-14,"-3,-22"
17701,720575940621820513,right,Tm1,136,0,3,1,2,"0,3"
17702,720575940633159891,right,Tm1,137,5,-7,-9,2,"5,-7"
17703,720575940608883465,right,Tm1,138,0,27,13,14,"0,27"
17704,720575940617830749,right,Tm1,139,1,-14,-8,-6,"1,-14"
17705,720575940625143795,right,Tm1,140,3,8,1,7,"3,8"
17706,720575940619363700,right,Tm1,141,5,-23,-17,-6,"5,-23"
17707,720575940633656801,right,Tm1,142,-2,-18,-7,-11,"-2,-18"
17708,720575940636726117,right,Tm1,143,-4,16,12,4,"-4,16"
17709,720575940626951769,right,Tm1,144,7,-11,-13,2,"7,-11"
17710,720575940647708468,right,Tm1,145,0,4,2,2,"0,4"
17711,720575940607489970,right,Tm1,146,1,-6,-4,-2,"1,-6"
17712,720575940623389162,right,Tm1,147,1,21,9,12,"1,21"
17713,720575940616149249,right,Tm1,148,-7,-11,1,-12,"-7,-11"
17714,720575940617601570,right,Tm1,149,6,-14,-13,-1,"6,-14"
17715,720575940638839529,right,Tm1,150,-8,5,10,-5,"-8,5"
17716,720575940630138368,right,Tm1,151,-3,-14,-4,-10,"-3,-14"
17717,720575940621815462,right,Tm1,152,3,-15,-11,-4,"3,-15"
17718,720575940634740335,right,Tm1,153,8,0,-8,8,"8,0"
17719,720575940626100313,right,Tm1,154,-8,0,8,-8,"-8,0"
17720,720575940617430356,right,Tm1,155,-8,13,14,-1,"-8,13"
17721,720575940621958977,right,Tm1,156,-9,1,9,-8,"-9,1"
17722,720575940622329769,right,Tm1,157,-1,-7,-3,-4,"-1,-7"
17723,720575940612429938,right,Tm1,158,3,-5,-6,1,"3,-5"
17724,720575940624844071,right,Tm1,159,7,7,-4,11,"7,7"
17725,720575940630046684,right,Tm1,160,-2,20,12,8,"-2,20"
17726,720575940646602548,right,Tm1,161,4,-14,-11,-3,"4,-14"
17727,720575940619273419,right,Tm1,162,-4,-2,3,-5,"-4,-2"
17728,720575940615923942,right,Tm1,163,-9,7,12,-5,"-9,7"
17729,720575940630103759,right,Tm1,164,-1,-2,0,-2,"-1,-2"
17730,720575940624448338,right,Tm1,165,4,16,4,12,"4,16"
17731,720575940625361552,right,Tm1,166,0,18,9,9,"0,18"
17732,720575940638947910,right,Tm1,167,0,-17,-9,-8,"0,-17"
17733,720575940629933532,right,Tm1,168,-1,17,9,8,"-1,17"
17734,720575940629431399,right,Tm1,169,0,-18,-9,-9,"0,-18"
17735,720575940629476683,right,Tm1,170,-5,1,5,-4,"-5,1"
17736,720575940627070991,right,Tm1,171,6,-20,-16,-4,"6,-20"
17737,720575940611880666,right,Tm1,172,1,22,10,12,"1,22"
17738,720575940621015888,right,Tm1,173,2,-25,-15,-10,"2,-25"
17739,720575940618745839,right,Tm1,174,4,-15,-12,-3,"4,-15"
17740,720575940610791026,right,Tm1,175,-6,-7,2,-9,"-6,-7"
17741,720575940611401109,right,Tm1,176,-2,13,8,5,"-2,13"
17742,720575940634248639,right,Tm1,177,-2,-1,1,-2,"-2,-1"
17743,720575940622998822,right,Tm1,178,2,11,3,8,"2,11"
17744,720575940627666462,right,Tm1,179,-5,-16,-3,-13,"-5,-16"
17745,720575940629842882,right,Tm1,180,2,-27,-16,-11,"2,-27"
17746,720575940621249445,right,Tm1,181,1,-4,-3,-1,"1,-4"
17747,720575940636138853,right,Tm1,182,7,-10,-12,2,"7,-10"
17748,720575940627430994,right,Tm1,183,-5,-15,-3,-12,"-5,-15"
17749,720575940640994805,right,Tm1,184,-6,-5,3,-8,"-6,-5"
17750,720575940630559788,right,Tm1,185,2,-11,-8,-3,"2,-11"
17751,720575940626245932,right,Tm1,186,-1,26,14,12,"-1,26"
17752,720575940612194201,right,Tm1,187,3,21,7,14,"3,21"
17753,720575940635066798,right,Tm1,188,-5,17,13,4,"-5,17"
17754,720575940623670212,right,Tm1,189,6,13,0,13,"6,13"
17755,720575940632810721,right,Tm1,190,-3,-5,0,-5,"-3,-5"
17756,720575940641655515,right,Tm1,191,-1,-11,-5,-6,"-1,-11"
17757,720575940632072729,right,Tm1,193,-5,4,7,-3,"-5,4"
17758,720575940636527790,right,Tm1,194,0,-5,-3,-2,"0,-5"
17759,720575940623462804,right,Tm1,195,-3,-1,2,-3,"-3,-1"
17760,720575940604885350,right,Tm1,196,-1,8,5,3,"-1,8"
17761,720575940630085676,right,Tm1,197,0,-20,-10,-10,"0,-20"
17762,720575940612923955,right,Tm1,198,6,2,-5,7,"6,2"
17763,720575940639382717,right,Tm1,199,0,-12,-6,-6,"0,-12"
17764,720575940609156188,right,Tm1,200,-5,12,11,1,"-5,12"
17765,720575940617189755,right,Tm1,201,-8,9,12,-3,"-8,9"
17766,720575940631403794,right,Tm1,202,-1,27,14,13,"-1,27"
17767,720575940608148489,right,Tm1,203,3,-1,-4,3,"3,-1"
17768,720575940644061294,right,Tm1,204,5,-2,-6,4,"5,-2"
17769,720575940637587172,right,Tm1,205,5,-6,-8,2,"5,-6"
17770,720575940630149719,right,Tm1,206,-3,5,5,0,"-3,5"
17771,720575940619723643,right,Tm1,207,1,29,13,16,"1,29"
17772,720575940623469448,right,Tm1,208,5,-21,-16,-5,"5,-21"
17773,720575940636861808,right,Tm1,209,-3,-8,-1,-7,"-3,-8"
17774,720575940624016688,right,Tm1,210,-6,8,10,-2,"-6,8"
17775,720575940621966294,right,Tm1,211,-7,-1,6,-7,"-7,-1"
17776,720575940629939516,right,Tm1,212,2,-16,-10,-6,"2,-16"
17777,720575940640460173,right,Tm1,213,3,-4,-5,1,"3,-4"
17778,720575940608361737,right,Tm1,214,-5,3,6,-3,"-5,3"
17779,720575940610094126,right,Tm1,215,6,7,-3,10,"6,7"
17780,720575940620993968,right,Tm1,216,2,19,7,12,"2,19"
17781,720575940625349680,right,Tm1,219,6,-4,-8,4,"6,-4"
17782,720575940637607565,right,Tm1,220,2,-6,-5,-1,"2,-6"
17783,720575940631875147,right,Tm1,221,-7,3,8,-5,"-7,3"
17784,720575940629931642,right,Tm1,222,-3,26,16,10,"-3,26"
17785,720575940626649602,right,Tm1,223,-2,26,15,11,"-2,26"
17786,720575940636381040,right,Tm1,224,0,5,2,3,"0,5"
17787,720575940634090210,right,Tm1,225,2,-26,-15,-11,"2,-26"
17788,720575940624478695,right,Tm1,226,5,19,4,15,"5,19"
17789,720575940612222760,right,Tm1,227,-7,5,9,-4,"-7,5"
17790,720575940620473921,right,Tm1,228,-7,1,7,-6,"-7,1"
17791,720575940615077171,right,Tm1,229,5,2,-4,6,"5,2"
17792,720575940620386725,right,Tm1,230,2,9,2,7,"2,9"
17793,720575940624437799,right,Tm1,231,4,-12,-10,-2,"4,-12"
17794,720575940627043627,right,Tm1,232,-4,13,10,3,"-4,13"
17795,720575940640413757,right,Tm1,233,4,-13,-11,-2,"4,-13"
17796,720575940632227501,right,Tm1,234,1,3,0,3,"1,3"
17797,720575940634286999,right,Tm1,235,4,11,1,10,"4,11"
17798,720575940613266984,right,Tm1,236,-1,4,3,1,"-1,4"
17799,720575940616361740,right,Tm1,237,-2,27,15,12,"-2,27"
17800,720575940631428945,right,Tm1,238,-8,-3,6,-9,"-8,-3"
17801,720575940610395354,right,Tm1,239,-6,6,9,-3,"-6,6"
17802,720575940630787287,right,Tm1,240,-4,-3,2,-5,"-4,-3"
17803,720575940618542539,right,Tm1,241,2,-17,-11,-6,"2,-17"
17804,720575940621852554,right,Tm1,242,-4,6,7,-1,"-4,6"
17805,720575940630238927,right,Tm1,243,-1,-21,-10,-11,"-1,-21"
17806,720575940610116654,right,Tm1,244,-4,-12,-2,-10,"-4,-12"
17807,720575940639466328,right,Tm1,245,-5,-3,3,-6,"-5,-3"
17808,720575940623788779,right,Tm1,246,-4,15,11,4,"-4,15"
17809,720575940612398515,right,Tm1,247,-4,-15,-4,-11,"-4,-15"
17810,720575940639939547,right,Tm1,248,-6,0,6,-6,"-6,0"
17811,720575940617982438,right,Tm1,249,2,-12,-8,-4,"2,-12"
17812,720575940634127770,right,Tm1,250,-1,1,1,0,"-1,1"
17813,720575940620417377,right,Tm1,251,-1,-14,-6,-8,"-1,-14"
17814,720575940612394035,right,Tm1,252,3,23,8,15,"3,23"
17815,720575940622329309,right,Tm1,253,5,16,3,13,"5,16"
17816,720575940630769879,right,Tm1,254,3,-24,-15,-9,"3,-24"
17817,720575940605706086,right,Tm1,255,-6,-13,-1,-12,"-6,-13"
17818,720575940638623046,right,Tm1,256,5,-20,-15,-5,"5,-20"
17819,720575940626899987,right,Tm1,257,2,21,8,13,"2,21"
17820,720575940617969053,right,Tm1,258,-4,-17,-5,-12,"-4,-17"
17821,720575940622509773,right,Tm1,259,-7,-5,4,-9,"-7,-5"
17822,720575940622170582,right,Tm1,260,-3,19,12,7,"-3,19"
17823,720575940643040292,right,Tm1,261,-1,13,7,6,"-1,13"
17824,720575940623882825,right,Tm1,262,1,-11,-7,-4,"1,-11"
17825,720575940630358124,right,Tm1,263,-3,4,5,-1,"-3,4"
17826,720575940628606658,right,Tm1,264,-1,-6,-2,-4,"-1,-6"
17827,720575940633516825,right,Tm1,265,-6,-1,5,-6,"-6,-1"
17828,720575940616230815,right,Tm1,266,-1,-25,-12,-13,"-1,-25"
17829,720575940613942695,right,Tm1,267,-6,2,7,-5,"-6,2"
17830,720575940627019944,right,Tm1,268,7,-6,-10,4,"7,-6"
17831,720575940617190517,right,Tm1,269,2,-19,-12,-7,"2,-19"
17832,720575940630227820,right,Tm1,270,1,-8,-5,-3,"1,-8"
17833,720575940629143546,right,Tm1,272,3,-2,-4,2,"3,-2"
17834,720575940628096680,right,Tm1,273,-6,23,17,6,"-6,23"
17835,720575940628369738,right,Tm1,274,6,4,-4,8,"6,4"
17836,720575940625693284,right,Tm1,275,-8,-1,7,-8,"-8,-1"
17837,720575940611486131,right,Tm1,276,2,3,-1,4,"2,3"
17838,720575940634942615,right,Tm1,277,7,-3,-9,6,"7,-3"
17839,720575940632621278,right,Tm1,278,-5,10,10,0,"-5,10"
17840,720575940615130763,right,Tm1,279,-4,8,8,0,"-4,8"
17841,720575940629041659,right,Tm1,280,-6,-14,-1,-13,"-6,-14"
17842,720575940621483363,right,Tm1,281,-9,2,10,-8,"-9,2"
17843,720575940613587935,right,Tm1,282,0,26,13,13,"0,26"
17844,720575940623433876,right,Tm1,283,-4,4,6,-2,"-4,4"
17845,720575940621146733,right,Tm1,284,0,25,12,13,"0,25"
17846,720575940607815346,right,Tm1,285,6,-18,-15,-3,"6,-18"
17847,720575940636516215,right,Tm1,286,0,-24,-12,-12,"0,-24"
17848,720575940621394714,right,Tm1,287,-5,13,11,2,"-5,13"
17849,720575940611444088,right,Tm1,288,-1,30,16,14,"-1,30"
17850,720575940621948637,right,Tm1,289,-1,11,6,5,"-1,11"
17851,720575940625281267,right,Tm1,290,5,-24,-17,-7,"5,-24"
17852,720575940632486044,right,Tm1,291,7,2,-6,8,"7,2"
17853,720575940640380379,right,Tm1,292,-4,18,13,5,"-4,18"
17854,720575940636544174,right,Tm1,293,4,-17,-13,-4,"4,-17"
17855,720575940627818877,right,Tm1,294,1,-20,-11,-9,"1,-20"
17856,720575940638156772,right,Tm1,295,-2,29,16,13,"-2,29"
17857,720575940628617734,right,Tm1,296,1,-18,-10,-8,"1,-18"
17858,720575940631506474,right,Tm1,297,7,-9,-12,3,"7,-9"
17859,720575940616482955,right,Tm1,298,-5,5,7,-2,"-5,5"
17860,720575940627120940,right,Tm1,299,-4,12,10,2,"-4,12"
17861,720575940631313219,right,Tm1,300,4,-18,-13,-5,"4,-18"
17862,720575940619247963,right,Tm1,301,-5,16,13,3,"-5,16"
17863,720575940615457698,right,Tm1,302,2,17,6,11,"2,17"
17864,720575940625480250,right,Tm1,303,-5,22,16,6,"-5,22"
17865,720575940613586498,right,Tm1,305,-7,4,9,-5,"-7,4"
17866,720575940610123733,right,Tm1,306,3,7,0,7,"3,7"
17867,720575940615755679,right,Tm1,307,5,-25,-18,-7,"5,-25"
17868,720575940628833192,right,Tm1,308,-5,8,9,-1,"-5,8"
17869,720575940633256087,right,Tm1,309,-6,12,12,0,"-6,12"
17870,720575940623638791,right,Tm1,310,2,22,9,13,"2,22"
17871,720575940623223054,right,Tm1,311,-7,15,14,1,"-7,15"
17872,720575940611952114,right,Tm1,312,4,-7,-8,1,"4,-7"
17873,720575940634074208,right,Tm1,313,7,3,-6,9,"7,3"
17874,720575940632571715,right,Tm1,314,-9,5,11,-6,"-9,5"
17875,720575940625824100,right,Tm1,315,-3,-6,0,-6,"-3,-6"
17876,720575940624530446,right,Tm1,316,5,-4,-7,3,"5,-4"
17877,720575940623605833,right,Tm1,317,-5,-4,3,-7,"-5,-4"
17878,720575940622226608,right,Tm1,318,4,-19,-14,-5,"4,-19"
17879,720575940631973580,right,Tm1,319,-2,5,4,1,"-2,5"
17880,720575940625977392,right,Tm1,320,-2,-5,-1,-4,"-2,-5"
17881,720575940631825995,right,Tm1,321,8,4,-6,10,"8,4"
17882,720575940627656956,right,Tm1,322,2,26,11,15,"2,26"
17883,720575940633658849,right,Tm1,323,-7,-13,0,-13,"-7,-13"
17884,720575940625713907,right,Tm1,324,3,24,9,15,"3,24"
17885,720575940637558591,right,Tm1,325,5,1,-5,6,"5,1"
17886,720575940631485035,right,Tm1,326,2,16,6,10,"2,16"
17887,720575940627367496,right,Tm1,327,5,3,-4,7,"5,3"
17888,720575940627375375,right,Tm1,328,5,-9,-10,1,"5,-9"
17889,720575940616994134,right,Tm1,329,0,24,12,12,"0,24"
17890,720575940640876672,right,Tm1,330,3,3,-2,5,"3,3"
17891,720575940619685717,right,Tm1,331,1,-15,-9,-6,"1,-15"
17892,720575940611300818,right,Tm1,332,4,-26,-17,-9,"4,-26"
17893,720575940646915636,right,Tm1,333,0,-21,-11,-10,"0,-21"
17894,720575940629731227,right,Tm1,334,1,-26,-14,-12,"1,-26"
17895,720575940631054610,right,Tm1,335,2,8,2,6,"2,8"
17896,720575940626742814,right,Tm1,336,0,23,11,12,"0,23"
17897,720575940639539619,right,Tm1,337,-5,-6,2,-8,"-5,-6"
17898,720575940621169791,right,Tm1,338,-1,0,1,-1,"-1,0"
17899,720575940623699529,right,Tm1,340,-4,17,12,5,"-4,17"
17900,720575940622769535,right,Tm1,341,6,-17,-15,-2,"6,-17"
17901,720575940619847920,right,Tm1,342,2,-15,-10,-5,"2,-15"
17902,720575940630797164,right,Tm1,343,-3,27,16,11,"-3,27"
17903,720575940635649016,right,Tm1,344,-2,-15,-6,-9,"-2,-15"
17904,720575940621220336,right,Tm1,345,3,-12,-9,-3,"3,-12"
17905,720575940612766378,right,Tm1,346,-7,-9,2,-11,"-7,-9"
17906,720575940625468178,right,Tm1,347,-5,-13,-2,-11,"-5,-13"
17907,720575940627176183,right,Tm1,348,3,14,4,10,"3,14"
17908,720575940624050683,right,Tm1,349,-5,-14,-2,-12,"-5,-14"
17909,720575940634902111,right,Tm1,350,1,15,6,9,"1,15"
17910,720575940616059846,right,Tm1,351,-1,-17,-8,-9,"-1,-17"
17911,720575940637593566,right,Tm1,352,-2,28,16,12,"-2,28"
17912,720575940611597410,right,Tm1,353,2,24,10,14,"2,24"
17913,720575940613239410,right,Tm1,354,-2,-26,-11,-15,"-2,-26"
17914,720575940599333574,right,Tm1,355,-7,-6,4,-10,"-7,-6"
17915,720575940634426905,right,Tm1,356,0,22,11,11,"0,22"
17916,720575940610630098,right,Tm1,357,4,17,4,13,"4,17"
17917,720575940628693248,right,Tm1,358,-3,17,11,6,"-3,17"
17918,720575940617756601,right,Tm1,359,2,23,9,14,"2,23"
17919,720575940618672293,right,Tm1,360,-5,19,14,5,"-5,19"
17920,720575940629157967,right,Tm1,361,0,-7,-4,-3,"0,-7"
17921,720575940614329410,right,Tm1,362,2,-20,-12,-8,"2,-20"
17922,720575940628813415,right,Tm1,363,7,-4,-9,5,"7,-4"
17923,720575940614960815,right,Tm1,364,4,4,-2,6,"4,4"
17924,720575940645433454,right,Tm1,366,-5,-20,-5,-15,"-5,-20"
17925,720575940632324433,right,Tm1,367,-6,-15,-2,-13,"-6,-15"
17926,720575940622949912,right,Tm1,368,-4,-20,-6,-14,"-4,-20"
17927,720575940620874416,right,Tm1,369,5,-5,-8,3,"5,-5"
17928,720575940632564269,right,Tm1,370,-3,21,13,8,"-3,21"
17929,720575940619756423,right,Tm1,371,6,-5,-9,4,"6,-5"
17930,720575940633632339,right,Tm1,372,1,-2,-2,0,"1,-2"
17931,720575940616483131,right,Tm1,373,1,-21,-12,-9,"1,-21"
17932,720575940622990121,right,Tm1,374,2,13,4,9,"2,13"
17933,720575940645803799,right,Tm1,375,-6,7,9,-2,"-6,7"
17934,720575940623552221,right,Tm1,376,-7,-10,2,-12,"-7,-10"
17935,720575940632427576,right,Tm1,377,0,7,3,4,"0,7"
17936,720575940621262356,right,Tm1,378,-3,18,12,6,"-3,18"
17937,720575940628551848,right,Tm1,379,3,-17,-12,-5,"3,-17"
17938,720575940640955088,right,Tm1,380,-1,29,15,14,"-1,29"
17939,720575940637489990,right,Tm1,381,-8,-9,3,-12,"-8,-9"
17940,720575940646442804,right,Tm1,382,3,-6,-6,0,"3,-6"
17941,720575940618976750,right,Tm1,383,-6,11,11,0,"-6,11"
17942,720575940612283601,right,Tm1,384,-6,-2,5,-7,"-6,-2"
17943,720575940629765502,right,Tm1,385,-3,-18,-6,-12,"-3,-18"
17944,720575940613230846,right,Tm1,386,-6,19,15,4,"-6,19"
17945,720575940620477376,right,Tm1,387,-1,-15,-7,-8,"-1,-15"
17946,720575940617536212,right,Tm1,389,-6,-16,-2,-14,"-6,-16"
17947,720575940629766906,right,Tm1,390,-6,-9,1,-10,"-6,-9"
17948,720575940639245912,right,Tm1,391,4,-3,-6,3,"4,-3"
17949,720575940603884512,right,Tm1,392,-4,7,7,0,"-4,7"
17950,720575940623709877,right,Tm1,393,-1,22,12,10,"-1,22"
17951,720575940616206386,right,Tm1,394,-7,-8,3,-11,"-7,-8"
17952,720575940632553892,right,Tm1,395,0,-22,-11,-11,"0,-22"
17953,720575940625885571,right,Tm1,396,-1,10,6,4,"-1,10"
17954,720575940626535445,right,Tm1,397,-3,-19,-7,-12,"-3,-19"
17955,720575940626855468,right,Tm1,398,-3,22,14,8,"-3,22"
17956,720575940627888296,right,Tm1,399,-4,-24,-8,-16,"-4,-24"
17957,720575940631982167,right,Tm1,400,1,-29,-16,-13,"1,-29"
17958,720575940633874899,right,Tm1,401,-2,-19,-8,-11,"-2,-19"
17959,720575940630271292,right,Tm1,402,3,26,10,16,"3,26"
17960,720575940613803571,right,Tm1,403,-2,-12,-4,-8,"-2,-12"
17961,720575940614355507,right,Tm1,404,-1,20,11,9,"-1,20"
17962,720575940611118030,right,Tm1,405,3,10,2,8,"3,10"
17963,720575940615222890,right,Tm1,406,1,-25,-14,-11,"1,-25"
17964,720575940622963299,right,Tm1,407,-5,-10,0,-10,"-5,-10"
17965,720575940619861814,right,Tm1,408,-6,-4,4,-8,"-6,-4"
17966,720575940624321468,right,Tm1,409,0,-3,-2,-1,"0,-3"
17967,720575940621468854,right,Tm1,410,-2,-2,1,-3,"-2,-2"
17968,720575940624302075,right,Tm1,411,-5,-19,-5,-14,"-5,-19"
17969,720575940637221173,right,Tm1,412,-6,21,16,5,"-6,21"
17970,720575940618368925,right,Tm1,413,-2,-7,-2,-5,"-2,-7"
17971,720575940619559600,right,Tm1,414,4,21,6,15,"4,21"
17972,720575940628284267,right,Tm1,415,6,12,0,12,"6,12"
17973,720575940620872641,right,Tm1,416,3,-8,-7,-1,"3,-8"
17974,720575940626080570,right,Tm1,417,-6,-10,1,-11,"-6,-10"
17975,720575940624399591,right,Tm1,418,-2,15,9,6,"-2,15"
17976,720575940645119267,right,Tm1,419,-3,-11,-3,-8,"-3,-11"
17977,720575940626739722,right,Tm1,420,6,-3,-8,5,"6,-3"
17978,720575940617830360,right,Tm1,421,-1,12,7,5,"-1,12"
17979,720575940633816601,right,Tm1,422,-7,-4,5,-9,"-7,-4"
17980,720575940635458228,right,Tm1,423,3,-18,-12,-6,"3,-18"
17981,720575940608839435,right,Tm1,424,-3,-2,2,-4,"-3,-2"
17982,720575940643803415,right,Tm1,425,3,20,7,13,"3,20"
17983,720575940620457045,right,Tm1,426,-3,0,3,-3,"-3,0"
17984,720575940607677826,right,Tm1,427,5,-18,-14,-4,"5,-18"
17985,720575940614334114,right,Tm1,428,-2,23,13,10,"-2,23"
17986,720575940628425475,right,Tm1,429,-2,14,9,5,"-2,14"
17987,720575940625250795,right,Tm1,430,-3,-7,-1,-6,"-3,-7"
17988,720575940627282705,right,Tm1,431,-2,-10,-3,-7,"-2,-10"
17989,720575940630385270,right,Tm1,432,-5,7,8,-1,"-5,7"
17990,720575940610654050,right,Tm1,433,0,-8,-4,-4,"0,-8"
17991,720575940629148775,right,Tm1,434,-3,7,6,1,"-3,7"
17992,720575940605825452,right,Tm1,435,5,-17,-14,-3,"5,-17"
17993,720575940622655702,right,Tm1,436,0,-15,-8,-7,"0,-15"
17994,720575940637205390,right,Tm1,437,-3,12,9,3,"-3,12"
17995,720575940627938820,right,Tm1,438,2,27,11,16,"2,27"
17996,720575940613253799,right,Tm1,439,-3,-9,-2,-7,"-3,-9"
17997,720575940619266763,right,Tm1,440,1,23,10,13,"1,23"
17998,720575940615589051,right,Tm1,441,3,-16,-11,-5,"3,-16"
17999,720575940630562268,right,Tm1,442,-5,25,17,8,"-5,25"
18000,720575940640401293,right,Tm1,443,-6,4,8,-4,"-6,4"
18001,720575940619425877,right,Tm1,444,4,-10,-9,-1,"4,-10"
18002,720575940632786914,right,Tm1,445,-2,8,6,2,"-2,8"
18003,720575940643812296,right,Tm1,446,2,-14,-9,-5,"2,-14"
18004,720575940621513036,right,Tm1,447,-1,2,2,0,"-1,2"
18005,720575940627201308,right,Tm1,448,0,30,15,15,"0,30"
18006,720575940627482639,right,Tm1,449,6,-16,-14,-2,"6,-16"
18007,720575940619572974,right,Tm1,450,2,-9,-7,-2,"2,-9"
18008,720575940650074233,right,Tm1,451,4,20,6,14,"4,20"
18009,720575940616477323,right,Tm1,452,1,-9,-6,-3,"1,-9"
18010,720575940630099959,right,Tm1,453,3,25,9,16,"3,25"
18011,720575940612063667,right,Tm1,454,5,-12,-11,-1,"5,-12"
18012,720575940622625494,right,Tm1,455,7,-7,-11,4,"7,-7"
18013,720575940638865597,right,Tm1,456,0,21,10,11,"0,21"
18014,720575940633146157,right,Tm1,457,-2,17,10,7,"-2,17"
18015,720575940641659444,right,Tm1,458,5,0,-5,5,"5,0"
18016,720575940643694103,right,Tm1,459,5,-3,-7,4,"5,-3"
18017,720575940612379634,right,Tm1,460,-3,-20,-7,-13,"-3,-20"
18018,720575940629984706,right,Tm1,461,7,-5,-10,5,"7,-5"
18019,720575940616652630,right,Tm1,462,-1,18,10,8,"-1,18"
18020,720575940610303857,right,Tm1,463,5,17,3,14,"5,17"
18021,720575940612779493,right,Tm1,464,4,0,-4,4,"4,0"
18022,720575940625807034,right,Tm1,465,3,0,-3,3,"3,0"
18023,720575940624300471,right,Tm1,466,1,14,6,8,"1,14"
18024,720575940615607106,right,Tm1,467,-2,-20,-8,-12,"-2,-20"
18025,720575940620324929,right,Tm1,468,-3,11,8,3,"-3,11"
18026,720575940631025980,right,Tm1,469,-7,13,13,0,"-7,13"
18027,720575940632152524,right,Tm1,470,4,-9,-9,0,"4,-9"
18028,720575940620280411,right,Tm1,471,3,-26,-16,-10,"3,-26"
18029,720575940634222361,right,Tm1,472,1,25,11,14,"1,25"
18030,720575940613300246,right,Tm1,473,-4,23,15,8,"-4,23"
18031,720575940626684803,right,Tm1,474,-3,-17,-6,-11,"-3,-17"
18032,720575940604094240,right,Tm1,475,-4,-1,3,-4,"-4,-1"
18033,720575940626386476,right,Tm1,476,-1,15,8,7,"-1,15"
18034,720575940612151193,right,Tm1,477,-3,2,4,-2,"-3,2"
18035,720575940632735710,right,Tm1,478,-7,16,15,1,"-7,16"
18036,720575940615130931,right,Tm1,479,-2,10,7,3,"-2,10"
18037,720575940634448866,right,Tm1,480,3,-19,-13,-6,"3,-19"
18038,720575940620000960,right,Tm1,481,4,-8,-8,0,"4,-8"
18039,720575940616819771,right,Tm1,482,1,17,7,10,"1,17"
18040,720575940631187364,right,Tm1,483,2,-7,-6,-1,"2,-7"
18041,720575940618156504,right,Tm1,484,3,-9,-8,-1,"3,-9"
18042,720575940642888333,right,Tm1,485,-3,-3,1,-4,"-3,-3"
18043,720575940644140567,right,Tm1,486,0,1,0,1,"0,1"
18044,720575940642870068,right,Tm1,487,1,-1,-2,1,"1,-1"
18045,720575940638177508,right,Tm1,488,7,5,-5,10,"7,5"
18046,720575940632845538,right,Tm1,489,-3,10,8,2,"-3,10"
18047,720575940615440530,right,Tm1,490,-5,6,8,-2,"-5,6"
18048,720575940631978041,right,Tm1,491,7,-1,-8,7,"7,-1"
18049,720575940614212498,right,Tm1,492,-7,-2,6,-8,"-7,-2"
18050,720575940620713387,right,Tm1,493,-3,23,14,9,"-3,23"
18051,720575940620976493,right,Tm1,494,0,29,14,15,"0,29"
18052,720575940623959787,right,Tm1,497,6,1,-6,7,"6,1"
18053,720575940625038087,right,Tm1,498,6,10,-1,11,"6,10"
18054,720575940624319157,right,Tm1,499,5,10,0,10,"5,10"
18055,720575940631025724,right,Tm1,500,7,-8,-11,3,"7,-8"
18056,720575940619789227,right,Tm1,501,1,2,0,2,"1,2"
18057,720575940630341750,right,Tm1,502,5,8,-1,9,"5,8"
18058,720575940622727885,right,Tm1,503,3,17,5,12,"3,17"
18059,720575940653088246,right,Tm1,504,-2,9,6,3,"-2,9"
18060,720575940660287617,right,Tm1,505,6,-22,-17,-5,"6,-22"
18061,720575940626352228,right,Tm1,506,1,-12,-7,-5,"1,-12"
18062,720575940622456589,right,Tm1,507,-5,-12,-1,-11,"-5,-12"
18063,720575940629899324,right,Tm1,508,-5,11,10,1,"-5,11"
18064,720575940627151148,right,Tm1,509,-4,10,9,1,"-4,10"
18065,720575940613062952,right,Tm1,510,-2,11,7,4,"-2,11"
18066,720575940628661903,right,Tm1,511,5,-11,-11,0,"5,-11"
18067,720575940630336727,right,Tm1,512,6,0,-6,6,"6,0"
18068,720575940615078654,right,Tm1,513,-4,-13,-3,-10,"-4,-13"
18069,720575940626808350,right,Tm1,514,-4,-10,-1,-9,"-4,-10"
18070,720575940626449508,right,Tm1,515,-8,-7,4,-11,"-8,-7"
18071,720575940626252388,right,Tm1,516,7,-18,-16,-2,"7,-18"
18072,720575940613134745,right,Tm1,517,6,3,-5,8,"6,3"
18073,720575940618542134,right,Tm1,518,-4,22,15,7,"-4,22"
18074,720575940631562124,right,Tm1,519,-5,-5,2,-7,"-5,-5"
18075,720575940616866443,right,Tm1,520,-2,-22,-9,-13,"-2,-22"
18076,720575940625809789,right,Tm1,521,6,-9,-11,2,"6,-9"
18077,720575940629267834,right,Tm1,522,-4,0,4,-4,"-4,0"
18078,720575940623749355,right,Tm1,523,2,14,5,9,"2,14"
18079,720575940620520724,right,Tm1,524,4,-20,-14,-6,"4,-20"
18080,720575940631972920,right,Tm1,525,-1,-20,-9,-11,"-1,-20"
18081,720575940619016001,right,Tm1,526,0,-10,-5,-5,"0,-10"
18082,720575940631602340,right,Tm1,527,-4,-8,0,-8,"-4,-8"
18083,720575940618896385,right,Tm1,529,2,-2,-3,1,"2,-2"
18084,720575940628048872,right,Tm1,530,-3,-13,-4,-9,"-3,-13"
18085,720575940625406188,right,Tm1,531,1,0,-1,1,"1,0"
18086,720575940653353889,right,Tm1,532,-8,7,11,-4,"-8,7"
18087,720575940617318971,right,Tm1,533,0,-16,-8,-8,"0,-16"
18088,720575940624972617,right,Tm1,534,3,2,-2,4,"3,2"
18089,720575940607060425,right,Tm1,535,8,-4,-10,6,"8,-4"
18090,720575940642403291,right,Tm1,536,3,4,-1,5,"3,4"
18091,720575940620814171,right,Tm1,537,0,-23,-12,-11,"0,-23"
18092,720575940624039108,right,Tm1,538,-4,1,4,-3,"-4,1"
18093,720575940629559570,right,Tm1,539,-6,15,13,2,"-6,15"
18094,720575940617223097,right,Tm1,540,-2,-9,-3,-6,"-2,-9"
18095,720575940627009290,right,Tm1,541,-4,14,11,3,"-4,14"
18096,720575940626039228,right,Tm1,542,6,-13,-13,0,"6,-13"
18097,720575940634722400,right,Tm1,543,-1,-4,-1,-3,"-1,-4"
18098,720575940616455746,right,Tm1,544,3,-13,-10,-3,"3,-13"
18099,720575940628093512,right,Tm1,545,5,11,0,11,"5,11"
18100,720575940609834564,right,Tm1,546,3,6,0,6,"3,6"
18101,720575940625265959,right,Tm1,547,-1,21,11,10,"-1,21"
18102,720575940640255104,right,Tm1,548,1,-16,-9,-7,"1,-16"
18103,720575940619250334,right,Tm1,549,0,-9,-5,-4,"0,-9"
18104,720575940635695864,right,Tm1,550,-2,3,3,0,"-2,3"
18105,720575940617451238,right,Tm1,551,-4,-9,-1,-8,"-4,-9"
18106,720575940613299222,right,Tm1,552,4,-1,-5,4,"4,-1"
18107,720575940627774952,right,Tm1,553,-3,16,11,5,"-3,16"
18108,720575940620473185,right,Tm1,554,-9,-3,7,-10,"-9,-3"
18109,720575940627156524,right,Tm1,555,-4,9,8,1,"-4,9"
18110,720575940619908187,right,Tm1,556,0,10,5,5,"0,10"
18111,720575940649442169,right,Tm1,557,6,-10,-11,1,"6,-10"
18112,720575940623656935,right,Tm1,558,-4,-21,-7,-14,"-4,-21"
18113,720575940610989937,right,Tm1,559,-6,22,17,5,"-6,22"
18114,720575940626913798,right,Tm1,560,-7,14,14,0,"-7,14"
18115,720575940622273974,right,Tm1,561,5,7,-2,9,"5,7"
18116,720575940621200884,right,Tm1,562,-5,-2,4,-6,"-5,-2"
18117,720575940637328350,right,Tm1,563,5,-13,-12,-1,"5,-13"
18118,720575940628102199,right,Tm1,564,3,-23,-15,-8,"3,-23"
18119,720575940623252950,right,Tm1,565,0,-26,-13,-13,"0,-26"
18120,720575940624668942,right,Tm1,566,5,-8,-9,1,"5,-8"
18121,720575940659464577,right,Tm1,567,-2,22,13,9,"-2,22"
18122,720575940634329811,right,Tm1,568,-6,-8,2,-10,"-6,-8"
18123,720575940632750403,right,Tm1,569,6,6,-3,9,"6,6"
18124,720575940617195449,right,Tm1,570,2,25,10,15,"2,25"
18125,720575940621896072,right,Tm1,571,0,-14,-7,-7,"0,-14"
18126,720575940627437511,right,Tm1,572,-8,3,9,-6,"-8,3"
18127,720575940620911837,right,Tm1,573,4,14,3,11,"4,14"
18128,720575940627486809,right,Tm1,574,-6,5,8,-3,"-6,5"
18129,720575940629730298,right,Tm1,575,6,9,-2,11,"6,9"
18130,720575940627479836,right,Tm1,576,0,28,14,14,"0,28"
18131,720575940625432819,right,Tm1,577,5,-14,-12,-2,"5,-14"
18132,720575940613687859,right,Tm1,578,4,-11,-10,-1,"4,-11"
18133,720575940616423366,right,Tm1,579,-3,-10,-2,-8,"-3,-10"
18134,720575940616117772,right,Tm1,580,-2,-23,-10,-13,"-2,-23"
18135,720575940607941298,right,Tm1,581,3,9,1,8,"3,9"
18136,720575940608195339,right,Tm1,582,-1,23,12,11,"-1,23"
18137,720575940624175623,right,Tm1,583,3,-25,-16,-9,"3,-25"
18138,720575940628294218,right,Tm1,584,4,23,7,16,"4,23"
18139,720575940625011785,right,Tm1,585,-1,-23,-11,-12,"-1,-23"
18140,720575940612600529,right,Tm1,586,2,18,7,11,"2,18"
18141,720575940617570193,right,Tm1,587,4,22,7,15,"4,22"
18142,720575940642773300,right,Tm1,588,1,4,1,3,"1,4"
18143,720575940627644412,right,Tm1,589,-1,-5,-2,-3,"-1,-5"
18144,720575940620651174,right,Tm1,590,1,9,3,6,"1,9"
18145,720575940611306962,right,Tm1,591,3,-3,-5,2,"3,-3"
18146,720575940631193404,right,Tm1,592,3,-28,-17,-11,"3,-28"
18147,720575940613193965,right,Tm1,593,3,-14,-10,-4,"3,-14"
18148,720575940627481871,right,Tm1,594,7,-16,-15,-1,"7,-16"
18149,720575940626079269,right,Tm1,595,7,-12,-13,1,"7,-12"
18150,720575940621462388,right,Tm1,596,-4,-16,-4,-12,"-4,-16"
18151,720575940617148509,right,Tm1,597,4,1,-4,5,"4,1"
18152,720575940619972884,right,Tm1,598,2,-18,-11,-7,"2,-18"
18153,720575940620991878,right,Tm1,599,-1,9,5,4,"-1,9"
18154,720575940638727613,right,Tm1,600,3,-10,-8,-2,"3,-10"
18155,720575940627161591,right,Tm1,601,1,16,7,9,"1,16"
18156,720575940618363515,right,Tm1,602,4,-2,-5,3,"4,-2"
18157,720575940612975786,right,Tm1,603,-3,-23,-9,-14,"-3,-23"
18158,720575940615539359,right,Tm1,604,-6,-17,-3,-14,"-6,-17"
18159,720575940620573264,right,Tm1,605,3,15,4,11,"3,15"
18160,720575940613369827,right,Tm1,606,-1,-19,-9,-10,"-1,-19"
18161,720575940621332102,right,Tm1,607,1,18,8,10,"1,18"
18162,720575940619139382,right,Tm1,608,1,10,4,6,"1,10"
18163,720575940616746845,right,Tm1,609,-2,0,2,-2,"-2,0"
18164,720575940631987852,right,Tm1,610,2,-23,-14,-9,"2,-23"
18165,720575940629263003,right,Tm1,611,-1,-18,-8,-10,"-1,-18"
18166,720575940615099242,right,Tm1,612,-3,-26,-10,-16,"-3,-26"
18167,720575940633222495,right,Tm1,613,-8,-4,6,-10,"-8,-4"
18168,720575940638248670,right,Tm1,614,-2,-8,-2,-6,"-2,-8"
18169,720575940625985072,right,Tm1,615,-7,-7,3,-10,"-7,-7"
18170,720575940605709740,right,Tm1,616,-3,15,10,5,"-3,15"
18171,720575940619761287,right,Tm1,617,-2,-17,-7,-10,"-2,-17"
18172,720575940634579135,right,Tm1,618,-1,24,13,11,"-1,24"
18173,720575940622739463,right,Tm1,619,-4,-19,-6,-13,"-4,-19"
18174,720575940617711505,right,Tm1,620,7,1,-7,8,"7,1"
18175,720575940633875117,right,Tm1,621,1,24,11,13,"1,24"
18176,720575940621244003,right,Tm1,622,-5,20,15,5,"-5,20"
18177,720575940629521534,right,Tm1,623,1,13,5,8,"1,13"
18178,720575940621092372,right,Tm1,624,1,-17,-10,-7,"1,-17"
18179,720575940625701612,right,Tm1,625,-2,24,14,10,"-2,24"
18180,720575940631762145,right,Tm1,626,-5,-8,1,-9,"-5,-8"
18181,720575940631593041,right,Tm1,627,0,-1,-1,0,"0,-1"
18182,720575940627387644,right,Tm1,628,0,0,0,0,"0,0"
18183,720575940632236600,right,Tm1,629,4,24,8,16,"4,24"
18184,720575940645464599,right,Tm1,630,4,8,0,8,"4,8"
18185,720575940643191949,right,Tm1,631,1,26,12,14,"1,26"
18186,720575940623365523,right,Tm1,632,3,-20,-13,-7,"3,-20"
18187,720575940611419598,right,Tm1,633,-1,-24,-11,-13,"-1,-24"
18188,720575940613916847,right,Tm1,634,-3,-15,-5,-10,"-3,-15"
18189,720575940611832282,right,Tm1,635,6,-6,-9,3,"6,-6"
18190,720575940629759787,right,Tm1,636,0,6,3,3,"0,6"
18191,720575940606792113,right,Tm1,637,3,-21,-14,-7,"3,-21"
18192,720575940614574061,right,Tm1,638,-1,7,4,3,"-1,7"
18193,720575940621807598,right,Tm1,639,-4,19,13,6,"-4,19"
18194,720575940631501615,right,Tm1,640,-1,-16,-7,-9,"-1,-16"
18195,720575940631110995,right,Tm1,641,-8,-5,5,-10,"-8,-5"
18196,720575940617901268,right,Tm1,642,-5,-11,-1,-10,"-5,-11"
18197,720575940627181047,right,Tm1,643,6,14,1,13,"6,14"
18198,720575940627027289,right,Tm1,644,-6,18,15,3,"-6,18"
18199,720575940647640196,right,Tm1,645,-4,27,17,10,"-4,27"
18200,720575940635089515,right,Tm1,646,6,17,2,15,"6,17"
18201,720575940618377521,right,Tm1,647,-4,-7,0,-7,"-4,-7"
18202,720575940628074089,right,Tm1,648,1,7,2,5,"1,7"
18203,720575940622134960,right,Tm1,649,-1,5,3,2,"-1,5"
18204,720575940626033422,right,Tm1,650,-3,-25,-10,-15,"-3,-25"
18205,720575940615781593,right,Tm1,651,-4,-5,1,-6,"-4,-5"
18206,720575940626907919,right,Tm1,652,-6,-11,0,-11,"-6,-11"
18207,720575940622957923,right,Tm1,653,-6,-12,0,-12,"-6,-12"
18208,720575940626392869,right,Tm1,654,-3,8,7,1,"-3,8"
18209,720575940641560628,right,Tm1,655,6,-1,-7,6,"6,-1"
18210,720575940621904041,right,Tm1,656,0,-11,-6,-5,"0,-11"
18211,720575940642800072,right,Tm1,658,1,20,9,11,"1,20"
18212,720575940626649000,right,Tm1,659,-4,-6,1,-7,"-4,-6"
18213,720575940628906540,right,Tm1,660,2,28,12,16,"2,28"
18214,720575940615981173,right,Tm1,661,-3,14,10,4,"-3,14"
18215,720575940618724893,right,Tm1,662,2,-1,-3,2,"2,-1"
18216,720575940618750491,right,Tm1,664,1,-27,-15,-12,"1,-27"
18217,720575940620248235,right,Tm1,665,7,-2,-8,6,"7,-2"
18218,720575940626595612,right,Tm1,666,7,-13,-14,1,"7,-13"
18219,720575940621934445,right,Tm1,667,1,-28,-15,-13,"1,-28"
18220,720575940636487342,right,Tm1,668,1,19,8,11,"1,19"
18221,720575940629773655,right,Tm1,669,4,-16,-12,-4,"4,-16"
18222,720575940619709745,right,Tm1,671,-4,-23,-8,-15,"-4,-23"
18223,720575940633309082,right,Tm1,672,-8,11,13,-2,"-8,11"
18224,720575940627951528,right,Tm1,673,2,5,0,5,"2,5"
18225,720575940637108446,right,Tm1,674,-4,-14,-3,-11,"-4,-14"
18226,720575940618689349,right,Tm1,675,-7,19,16,3,"-7,19"
18227,720575940626643843,right,Tm1,676,-3,-21,-8,-13,"-3,-21"
18228,720575940643841844,right,Tm1,677,0,11,5,6,"0,11"
18229,720575940610428402,right,Tm1,678,3,-7,-7,0,"3,-7"
18230,720575940634181587,right,Tm1,679,4,18,5,13,"4,18"
18231,720575940620523540,right,Tm1,680,-1,25,13,12,"-1,25"
18232,720575940611345834,right,Tm1,681,-2,-21,-9,-12,"-2,-21"
18233,720575940604895148,right,Tm1,682,6,-8,-10,2,"6,-8"
18234,720575940624813129,right,Tm1,683,2,6,1,5,"2,6"
18235,720575940610647210,right,Tm1,684,-6,17,14,3,"-6,17"
18236,720575940627630123,right,Tm1,685,-5,-9,0,-9,"-5,-9"
18237,720575940614762914,right,Tm1,686,5,-22,-16,-6,"5,-22"
18238,720575940614529386,right,Tm1,687,-6,-3,4,-7,"-6,-3"
18239,720575940613601346,right,Tm1,688,-7,10,12,-2,"-7,10"
18240,720575940633415822,right,Tm1,689,-2,18,11,7,"-2,18"
18241,720575940631049803,right,Tm1,690,-7,-3,5,-8,"-7,-3"
18242,720575940625658899,right,Tm1,691,-9,4,11,-7,"-9,4"
18243,720575940630698690,right,Tm1,692,-4,24,16,8,"-4,24"
18244,720575940620263558,right,Tm1,693,-3,25,15,10,"-3,25"
18245,720575940619527245,right,Tm1,695,-6,10,11,-1,"-6,10"
18246,720575940629849148,right,Tm1,696,-2,16,10,6,"-2,16"
18247,720575940625017863,right,Tm1,697,1,-22,-12,-10,"1,-22"
18248,720575940634620863,right,Tm1,698,6,-7,-10,3,"6,-7"
18249,720575940629020154,right,Tm1,699,-5,0,5,-5,"-5,0"
18250,720575940633128674,right,Tm1,700,5,15,2,13,"5,15"
18251,720575940632033197,right,Tm1,701,0,-4,-2,-2,"0,-4"
18252,720575940616296498,right,Tm1,702,-5,23,16,7,"-5,23"
18253,720575940627176452,right,Tm1,703,-3,1,3,-2,"-3,1"
18254,720575940623570765,right,Tm1,704,-7,8,11,-3,"-7,8"
18255,720575940607931401,right,Tm1,705,1,1,-1,2,"1,1"
18256,720575940624682852,right,Tm1,706,-7,-12,1,-13,"-7,-12"
18257,720575940625129148,right,Tm1,707,-2,25,14,11,"-2,25"
18258,720575940629670394,right,Tm1,708,-4,-25,-9,-16,"-4,-25"
18259,720575940636733040,right,Tm1,709,-2,-24,-10,-14,"-2,-24"
18260,720575940634888599,right,Tm1,710,4,-25,-17,-8,"4,-25"
18261,720575940648375940,right,Tm1,711,-1,19,10,9,"-1,19"
18262,720575940626087980,right,Tm1,712,-7,12,13,-1,"-7,12"
18263,720575940604839084,right,Tm1,713,-6,16,14,2,"-6,16"
18264,720575940614209703,right,Tm1,714,5,12,1,11,"5,12"
18265,720575940615760569,right,Tm1,715,4,10,1,9,"4,10"
18266,720575940637228429,right,Tm1,716,4,-6,-7,1,"4,-6"
18267,720575940617368925,right,Tm1,717,2,-22,-13,-9,"2,-22"
18268,720575940616867894,right,Tm1,718,-5,24,17,7,"-5,24"
18269,720575940630729410,right,Tm1,719,1,27,12,15,"1,27"
18270,720575940626447366,right,Tm1,720,-5,21,15,6,"-5,21"
18271,720575940621526810,right,Tm1,721,5,13,1,12,"5,13"
18272,720575940616134924,right,Tm1,722,6,-15,-14,-1,"6,-15"
18273,720575940639798643,right,Tm1,723,-2,-11,-4,-7,"-2,-11"
18274,720575940634426393,right,Tm1,724,4,2,-3,5,"4,2"
18275,720575940640262272,right,Tm1,725,-3,-24,-9,-15,"-3,-24"
18276,720575940630698618,right,Tm1,726,2,-28,-16,-12,"2,-28"
18277,720575940629868587,right,Tm1,727,7,6,-4,10,"7,6"
18278,720575940615761803,right,Tm1,729,-3,29,17,12,"-3,29"
18279,720575940641585460,right,Tm1,730,7,0,-7,7,"7,0"
18280,720575940633142682,right,Tm1,731,-6,9,10,-1,"-6,9"
18281,720575940627380841,right,Tm1,732,-3,6,6,0,"-3,6"
18282,720575940638139364,right,Tm1,733,-5,-17,-4,-13,"-5,-17"
18283,720575940604009062,right,Tm1,734,2,0,-2,2,"2,0"
18284,720575940619153822,right,Tm1,735,1,-23,-13,-10,"1,-23"
18285,720575940621321864,right,Tm1,736,-8,1,8,-7,"-8,1"
18286,720575940627887354,right,Tm1,737,0,19,9,10,"0,19"
18287,720575940621476357,right,Tm1,738,-3,13,9,4,"-3,13"
18288,720575940631973324,right,Tm1,739,-7,2,8,-6,"-7,2"
18289,720575940613586403,right,Tm1,740,2,-8,-6,-2,"2,-8"
18290,720575940624084917,right,Tm1,741,-2,-14,-5,-9,"-2,-14"
18291,720575940627096876,right,Tm1,742,-4,11,9,2,"-4,11"
18292,720575940632783012,right,Tm1,743,6,-19,-16,-3,"6,-19"
18293,720575940621138902,right,Tm1,744,-4,25,16,9,"-4,25"
18294,720575940627390095,right,Tm1,745,0,13,6,7,"0,13"
18295,720575940643559972,right,Tm1,746,-3,3,4,-1,"-3,3"
18296,720575940619104541,right,Tm1,747,0,2,1,1,"0,2"
18297,720575940634867342,right,Tm1,748,-4,20,14,6,"-4,20"
18298,720575940613830306,right,Tm1,749,-2,1,2,-1,"-2,1"
18299,720575940633848802,right,Tm1,750,4,-24,-16,-8,"4,-24"
18300,720575940613315606,right,Tm1,751,1,6,2,4,"1,6"
18301,720575940624823881,right,Tm1,752,-2,7,5,2,"-2,7"
18302,720575940605324204,right,Tm1,753,-3,24,15,9,"-3,24"
18303,720575940628641730,right,Tm1,754,-1,-13,-6,-7,"-1,-13"
18304,720575940633206483,right,Tm1,755,4,19,5,14,"4,19"
18305,720575940627902716,right,Tm1,756,5,20,5,15,"5,20"
18306,720575940652102134,right,Tm1,757,0,-6,-3,-3,"0,-6"
18307,720575940631116074,right,Tm1,758,5,-1,-6,5,"5,-1"
18308,720575940632600647,right,Tm1,759,7,14,0,14,"7,14"
18309,720575940626170440,right,Tm1,760,0,17,8,9,"0,17"
18310,720575940617915938,right,Tm1,761,-4,-18,-5,-13,"-4,-18"
18311,720575940621757005,right,Tm1,762,0,14,7,7,"0,14"
18312,720575940618384293,right,Tm1,763,-5,14,12,2,"-5,14"
18313,720575940630550575,right,Tm1,764,-8,-6,5,-11,"-8,-6"
18314,720575940626434604,right,Tm1,765,-3,9,7,2,"-3,9"
18315,720575940619114545,right,Tm1,766,2,-4,-4,0,"2,-4"
18316,720575940623583428,right,Tm1,767,1,28,13,15,"1,28"
18317,720575940630918620,right,Tm1,768,3,5,-1,6,"3,5"
18318,720575940634296089,right,Tm1,769,4,-27,-18,-9,"4,-27"
18319,720575940612944819,right,Tm1,770,5,4,-3,7,"5,4"
18320,720575940628555536,right,Tm1,771,3,-27,-17,-10,"3,-27"
18321,720575940636870318,right,Tm1,772,1,12,5,7,"1,12"
18322,720575940612294835,right,Tm1,773,5,-19,-15,-4,"5,-19"
18323,720575940606360962,right,Tm1,774,-8,6,11,-5,"-8,6"
18324,720575940641287413,right,Tm1,775,5,22,6,16,"5,22"
18325,720575940617347414,right,Tm1,778,4,25,8,17,"4,25"
18326,720575940622459376,right,Tm1,779,5,24,7,17,"5,24"
18327,720575940617608539,right,Tm1,780,-6,25,18,7,"-6,25"
18328,720575940617505492,right,Tm1,781,-5,26,18,8,"-5,26"
18329,720575940623078732,right,Tm1,782,-5,27,18,9,"-5,27"
18330,720575940622761054,right,Tm1,783,-4,28,18,10,"-4,28"
18331,720575940622956509,right,Tm1,784,-4,29,18,11,"-4,29"
18332,720575940628400400,right,Tm1,786,-2,30,17,13,"-2,30"
18333,720575940638610502,right,Tm1,787,3,28,11,17,"3,28"
18334,720575940620074832,right,Tm1,788,3,27,10,17,"3,27"
18335,720575940642417805,right,Tm1,789,-3,-27,-11,-16,"-3,-27"
18336,720575940618695965,right,Tm1,790,-2,-27,-12,-15,"-2,-27"
18337,720575940630672581,right,Tm1,791,-1,-28,-13,-15,"-1,-28"
18338,720575940643757216,right,Tm1,792,8,2,-7,9,"8,2"
18339,720575940616958038,right,Tm1,793,8,-6,-11,5,"8,-6"
18340,720575940616566726,right,Tm1,794,5,-26,-18,-8,"5,-26"
18341,720575940648649092,right,Tm1,795,6,-21,-17,-4,"6,-21"
18342,720575940624638391,right,Tm1,796,4,26,9,17,"4,26"
18343,720575940620244741,right,Tm2,1,-6,13,12,1,"-6,13"
18344,720575940630760223,right,Tm2,2,-8,2,9,-7,"-8,2"
18345,720575940624224949,right,Tm2,3,6,-12,-12,0,"6,-12"
18346,720575940612187866,right,Tm2,4,-5,-21,-6,-15,"-5,-21"
18347,720575940612251877,right,Tm2,5,-1,16,9,7,"-1,16"
18348,720575940605913004,right,Tm2,6,-2,-4,0,-4,"-2,-4"
18349,720575940624898540,right,Tm2,7,-6,-6,3,-9,"-6,-6"
18350,720575940635815287,right,Tm2,8,-4,26,17,9,"-4,26"
18351,720575940611189454,right,Tm2,9,4,9,0,9,"4,9"
18352,720575940645122583,right,Tm2,10,5,-15,-13,-2,"5,-15"
18353,720575940638074340,right,Tm2,11,7,-14,-14,0,"7,-14"
18354,720575940622960684,right,Tm2,12,-7,9,11,-2,"-7,9"
18355,720575940637647332,right,Tm2,13,-1,-26,-12,-14,"-1,-26"
18356,720575940628581120,right,Tm2,14,0,-27,-14,-13,"0,-27"
18357,720575940624331082,right,Tm2,15,2,-3,-4,1,"2,-3"
18358,720575940622708151,right,Tm2,16,-2,-16,-6,-10,"-2,-16"
18359,720575940615784507,right,Tm2,17,1,-5,-4,-1,"1,-5"
18360,720575940614053482,right,Tm2,18,5,-16,-13,-3,"5,-16"
18361,720575940613149034,right,Tm2,19,-7,17,15,2,"-7,17"
18362,720575940611702478,right,Tm2,20,3,-11,-9,-2,"3,-11"
18363,720575940647681668,right,Tm2,21,-2,19,11,8,"-2,19"
18364,720575940637262143,right,Tm2,22,-1,3,2,1,"-1,3"
18365,720575940647468164,right,Tm2,23,-3,-16,-5,-11,"-3,-16"
18366,720575940623850008,right,Tm2,24,-1,-10,-4,-6,"-1,-10"
18367,720575940637176885,right,Tm2,25,-9,3,10,-7,"-9,3"
18368,720575940611083413,right,Tm2,26,1,-3,-3,0,"1,-3"
18369,720575940630796908,right,Tm2,27,0,-25,-13,-12,"0,-25"
18370,720575940613740455,right,Tm2,29,-1,-3,-1,-2,"-1,-3"
18371,720575940620874223,right,Tm2,30,6,16,2,14,"6,16"
18372,720575940608129628,right,Tm2,31,0,16,8,8,"0,16"
18373,720575940622689612,right,Tm2,33,3,18,6,12,"3,18"
18374,720575940619218113,right,Tm2,34,6,18,3,15,"6,18"
18375,720575940617922772,right,Tm2,35,1,-24,-13,-11,"1,-24"
18376,720575940621194245,right,Tm2,37,1,5,1,4,"1,5"
18377,720575940631295336,right,Tm2,38,0,-2,-1,-1,"0,-2"
18378,720575940623538729,right,Tm2,39,0,20,10,10,"0,20"
18379,720575940638345542,right,Tm2,40,-2,-6,-1,-5,"-2,-6"
18380,720575940620810177,right,Tm2,41,-3,28,17,11,"-3,28"
18381,720575940626365740,right,Tm2,42,-1,14,8,6,"-1,14"
18382,720575940616899670,right,Tm2,43,-5,18,14,4,"-5,18"
18383,720575940621928547,right,Tm2,44,5,-10,-10,0,"5,-10"
18384,720575940614240819,right,Tm2,45,-5,-1,4,-5,"-5,-1"
18385,720575940619389249,right,Tm2,46,-5,15,12,3,"-5,15"
18386,720575940631659475,right,Tm2,47,-9,-1,8,-9,"-9,-1"
18387,720575940634196592,right,Tm2,48,-4,-22,-7,-15,"-4,-22"
18388,720575940604685740,right,Tm2,49,4,-4,-6,2,"4,-4"
18389,720575940604038880,right,Tm2,50,-2,21,12,9,"-2,21"
18390,720575940618040025,right,Tm2,51,0,-19,-10,-9,"0,-19"
18391,720575940624001032,right,Tm2,52,-1,-22,-10,-12,"-1,-22"
18392,720575940627175415,right,Tm2,53,5,14,2,12,"5,14"
18393,720575940631715671,right,Tm2,54,-4,3,5,-2,"-4,3"
18394,720575940623554963,right,Tm2,55,-4,-11,-2,-9,"-4,-11"
18395,720575940617651156,right,Tm2,56,1,-13,-8,-5,"1,-13"
18396,720575940617843483,right,Tm2,57,6,-11,-12,1,"6,-11"
18397,720575940635195290,right,Tm2,58,3,12,3,9,"3,12"
18398,720575940626801169,right,Tm2,59,-2,2,3,-1,"-2,2"
18399,720575940619430320,right,Tm2,60,-8,8,12,-4,"-8,8"
18400,720575940622095092,right,Tm2,61,-4,-4,2,-6,"-4,-4"
18401,720575940636880782,right,Tm2,62,0,-29,-15,-14,"0,-29"
18402,720575940628349639,right,Tm2,63,4,12,2,10,"4,12"
18403,720575940619325819,right,Tm2,64,4,-23,-16,-7,"4,-23"
18404,720575940615189043,right,Tm2,65,-1,28,15,13,"-1,28"
18405,720575940633124252,right,Tm2,66,2,15,5,10,"2,15"
18406,720575940617470681,right,Tm2,67,-2,-13,-5,-8,"-2,-13"
18407,720575940641435893,right,Tm2,68,3,16,5,11,"3,16"
18408,720575940613635442,right,Tm2,69,1,8,3,5,"1,8"
18409,720575940626903340,right,Tm2,70,-4,21,14,7,"-4,21"
18410,720575940613425361,right,Tm2,71,-2,-3,0,-3,"-2,-3"
18411,720575940618074041,right,Tm2,72,0,-28,-14,-14,"0,-28"
18412,720575940610537678,right,Tm2,73,2,2,-1,3,"2,2"
18413,720575940621914236,right,Tm2,74,-1,-9,-4,-5,"-1,-9"
18414,720575940626489416,right,Tm2,75,-6,14,13,1,"-6,14"
18415,720575940641310939,right,Tm2,76,-3,-4,1,-5,"-3,-4"
18416,720575940624538189,right,Tm2,77,2,-5,-5,0,"2,-5"
18417,720575940626284944,right,Tm2,78,2,20,8,12,"2,20"
18418,720575940628456295,right,Tm2,79,2,1,-2,3,"2,1"
18419,720575940627175927,right,Tm2,80,4,13,2,11,"4,13"
18420,720575940612069745,right,Tm2,81,6,-2,-7,5,"6,-2"
18421,720575940628585948,right,Tm2,82,-7,7,10,-3,"-7,7"
18422,720575940621714345,right,Tm2,83,2,-21,-13,-8,"2,-21"
18423,720575940624950349,right,Tm2,84,-2,12,8,4,"-2,12"
18424,720575940627186813,right,Tm2,85,4,-22,-15,-7,"4,-22"
18425,720575940618796352,right,Tm2,86,-5,-7,1,-8,"-5,-7"
18426,720575940623725261,right,Tm2,87,1,11,4,7,"1,11"
18427,720575940632361999,right,Tm2,88,7,4,-5,9,"7,4"
18428,720575940612499186,right,Tm2,89,1,-19,-11,-8,"1,-19"
18429,720575940637323829,right,Tm2,90,-4,5,6,-1,"-4,5"
18430,720575940620732342,right,Tm2,91,-1,6,4,2,"-1,6"
18431,720575940642185691,right,Tm2,92,0,9,4,5,"0,9"
18432,720575940644945608,right,Tm2,93,-6,3,7,-4,"-6,3"
18433,720575940623093784,right,Tm2,94,5,18,4,14,"5,18"
18434,720575940627145231,right,Tm2,95,4,-21,-15,-6,"4,-21"
18435,720575940612119258,right,Tm2,96,1,-10,-6,-4,"1,-10"
18436,720575940617198822,right,Tm2,97,-5,2,6,-4,"-5,2"
18437,720575940624507829,right,Tm2,98,-1,-12,-5,-7,"-1,-12"
18438,720575940623124323,right,Tm2,99,4,15,3,12,"4,15"
18439,720575940616378811,right,Tm2,100,2,-10,-7,-3,"2,-10"
18440,720575940629149804,right,Tm2,101,-7,6,10,-4,"-7,6"
18441,720575940626623076,right,Tm2,102,3,13,3,10,"3,13"
18442,720575940636729486,right,Tm2,104,-1,-27,-13,-14,"-1,-27"
18443,720575940619986123,right,Tm2,105,3,22,8,14,"3,22"
18444,720575940631048749,right,Tm2,106,-7,11,12,-1,"-7,11"
18445,720575940615006943,right,Tm2,107,8,-2,-9,7,"8,-2"
18446,720575940660305793,right,Tm2,108,-3,-12,-3,-9,"-3,-12"
18447,720575940611863219,right,Tm2,109,4,-5,-7,2,"4,-5"
18448,720575940605913516,right,Tm2,110,-7,0,7,-7,"-7,0"
18449,720575940622667703,right,Tm2,111,2,-24,-14,-10,"2,-24"
18450,720575940628692679,right,Tm2,112,-6,1,6,-5,"-6,1"
18451,720575940627422919,right,Tm2,113,-2,4,4,0,"-2,4"
18452,720575940619288478,right,Tm2,115,-4,2,5,-3,"-4,2"
18453,720575940636211557,right,Tm2,116,-1,-8,-3,-5,"-1,-8"
18454,720575940632254233,right,Tm2,117,-8,-2,7,-9,"-8,-2"
18455,720575940639878259,right,Tm2,118,3,1,-3,4,"3,1"
18456,720575940617750411,right,Tm2,119,-2,6,5,1,"-2,6"
18457,720575940628177743,right,Tm2,120,-1,-1,0,-1,"-1,-1"
18458,720575940627633863,right,Tm2,121,-8,4,10,-6,"-8,4"
18459,720575940627127596,right,Tm2,122,-5,9,9,0,"-5,9"
18460,720575940633135070,right,Tm2,123,-8,10,13,-3,"-8,10"
18461,720575940633160418,right,Tm2,124,1,-7,-5,-2,"1,-7"
18462,720575940659637889,right,Tm2,125,5,9,-1,10,"5,9"
18463,720575940631395128,right,Tm2,127,0,15,7,8,"0,15"
18464,720575940625770644,right,Tm2,128,3,-22,-14,-8,"3,-22"
18465,720575940627768453,right,Tm2,129,0,-13,-7,-6,"0,-13"
18466,720575940637583216,right,Tm2,130,2,12,4,8,"2,12"
18467,720575940619345473,right,Tm2,131,-6,20,16,4,"-6,20"
18468,720575940620021662,right,Tm2,132,2,4,0,4,"2,4"
18469,720575940615751839,right,Tm2,133,-3,20,13,7,"-3,20"
18470,720575940612378610,right,Tm2,134,-5,-18,-4,-14,"-5,-18"
18471,720575940625121428,right,Tm2,135,-3,-22,-8,-14,"-3,-22"
18472,720575940624071975,right,Tm2,136,0,3,1,2,"0,3"
18473,720575940632818259,right,Tm2,137,5,-7,-9,2,"5,-7"
18474,720575940622364961,right,Tm2,138,0,27,13,14,"0,27"
18475,720575940616133493,right,Tm2,139,1,-14,-8,-6,"1,-14"
18476,720575940638153328,right,Tm2,140,3,8,1,7,"3,8"
18477,720575940612080738,right,Tm2,142,-2,-18,-7,-11,"-2,-18"
18478,720575940604183654,right,Tm2,143,-4,16,12,4,"-4,16"
18479,720575940620682991,right,Tm2,144,7,-11,-13,2,"7,-11"
18480,720575940632731752,right,Tm2,145,0,4,2,2,"0,4"
18481,720575940630306871,right,Tm2,146,1,-6,-4,-2,"1,-6"
18482,720575940611829477,right,Tm2,147,1,21,9,12,"1,21"
18483,720575940616310066,right,Tm2,148,-7,-11,1,-12,"-7,-11"
18484,720575940624819948,right,Tm2,149,6,-14,-13,-1,"6,-14"
18485,720575940611115030,right,Tm2,150,-8,5,10,-5,"-8,5"
18486,720575940628687272,right,Tm2,151,-3,-14,-4,-10,"-3,-14"
18487,720575940631656791,right,Tm2,152,3,-15,-11,-4,"3,-15"
18488,720575940621078182,right,Tm2,153,8,0,-8,8,"8,0"
18489,720575940623183544,right,Tm2,154,-8,0,8,-8,"-8,0"
18490,720575940623847056,right,Tm2,155,-8,13,14,-1,"-8,13"
18491,720575940642975524,right,Tm2,156,-9,1,9,-8,"-9,1"
18492,720575940619604359,right,Tm2,157,-1,-7,-3,-4,"-1,-7"
18493,720575940608453077,right,Tm2,158,3,-5,-6,1,"3,-5"
18494,720575940616370700,right,Tm2,159,7,7,-4,11,"7,7"
18495,720575940638324201,right,Tm2,160,-2,20,12,8,"-2,20"
18496,720575940622687002,right,Tm2,161,4,-14,-11,-3,"4,-14"
18497,720575940620467365,right,Tm2,162,-4,-2,3,-5,"-4,-2"
18498,720575940616273947,right,Tm2,163,-9,7,12,-5,"-9,7"
18499,720575940636091760,right,Tm2,164,-1,-2,0,-2,"-1,-2"
18500,720575940616367389,right,Tm2,165,4,16,4,12,"4,16"
18501,720575940623256873,right,Tm2,166,0,18,9,9,"0,18"
18502,720575940631653187,right,Tm2,167,0,-17,-9,-8,"0,-17"
18503,720575940632379790,right,Tm2,168,-1,17,9,8,"-1,17"
18504,720575940605411040,right,Tm2,169,0,-18,-9,-9,"0,-18"
18505,720575940638291007,right,Tm2,170,-5,1,5,-4,"-5,1"
18506,720575940635276127,right,Tm2,171,6,-20,-16,-4,"6,-20"
18507,720575940622743536,right,Tm2,172,1,22,10,12,"1,22"
18508,720575940634904474,right,Tm2,173,2,-25,-15,-10,"2,-25"
18509,720575940627902863,right,Tm2,174,4,-15,-12,-3,"4,-15"
18510,720575940616567227,right,Tm2,175,-6,-7,2,-9,"-6,-7"
18511,720575940615932987,right,Tm2,176,-2,13,8,5,"-2,13"
18512,720575940606632224,right,Tm2,177,-2,-1,1,-2,"-2,-1"
18513,720575940615780725,right,Tm2,178,2,11,3,8,"2,11"
18514,720575940634815639,right,Tm2,179,-5,-16,-3,-13,"-5,-16"
18515,720575940625082953,right,Tm2,180,2,-27,-16,-11,"2,-27"
18516,720575940617035732,right,Tm2,181,1,-4,-3,-1,"1,-4"
18517,720575940628019204,right,Tm2,182,7,-10,-12,2,"7,-10"
18518,720575940629024087,right,Tm2,183,-5,-15,-3,-12,"-5,-15"
18519,720575940637349598,right,Tm2,184,-6,-5,3,-8,"-6,-5"
18520,720575940639421117,right,Tm2,185,2,-11,-8,-3,"2,-11"
18521,720575940615716418,right,Tm2,186,-1,26,14,12,"-1,26"
18522,720575940620417963,right,Tm2,187,3,21,7,14,"3,21"
18523,720575940608305756,right,Tm2,188,-5,17,13,4,"-5,17"
18524,720575940610725874,right,Tm2,189,6,13,0,13,"6,13"
18525,720575940621622652,right,Tm2,190,-3,-5,0,-5,"-3,-5"
18526,720575940636202382,right,Tm2,191,-1,-11,-5,-6,"-1,-11"
18527,720575940624811755,right,Tm2,192,7,10,-2,12,"7,10"
18528,720575940630153068,right,Tm2,193,-5,4,7,-3,"-5,4"
18529,720575940642612621,right,Tm2,194,0,-5,-3,-2,"0,-5"
18530,720575940635204088,right,Tm2,195,-3,-1,2,-3,"-3,-1"
18531,720575940626449964,right,Tm2,196,-1,8,5,3,"-1,8"
18532,720575940630212567,right,Tm2,197,0,-20,-10,-10,"0,-20"
18533,720575940609970642,right,Tm2,198,6,2,-5,7,"6,2"
18534,720575940626794021,right,Tm2,199,0,-12,-6,-6,"0,-12"
18535,720575940627105580,right,Tm2,200,-5,12,11,1,"-5,12"
18536,720575940636707930,right,Tm2,201,-8,9,12,-3,"-8,9"
18537,720575940632003176,right,Tm2,202,-1,27,14,13,"-1,27"
18538,720575940629866563,right,Tm2,203,3,-1,-4,3,"3,-1"
18539,720575940622999832,right,Tm2,204,5,-2,-6,4,"5,-2"
18540,720575940635553375,right,Tm2,205,5,-6,-8,2,"5,-6"
18541,720575940632431391,right,Tm2,206,-3,5,5,0,"-3,5"
18542,720575940622372223,right,Tm2,207,1,29,13,16,"1,29"
18543,720575940642486669,right,Tm2,208,5,-21,-16,-5,"5,-21"
18544,720575940639591758,right,Tm2,209,-3,-8,-1,-7,"-3,-8"
18545,720575940645418548,right,Tm2,210,-6,8,10,-2,"-6,8"
18546,720575940610379443,right,Tm2,211,-7,-1,6,-7,"-7,-1"
18547,720575940624342515,right,Tm2,212,2,-16,-10,-6,"2,-16"
18548,720575940623747819,right,Tm2,213,3,-4,-5,1,"3,-4"
18549,720575940616192373,right,Tm2,214,-5,3,6,-3,"-5,3"
18550,720575940618103835,right,Tm2,216,2,19,7,12,"2,19"
18551,720575940624401671,right,Tm2,217,6,15,1,14,"6,15"
18552,720575940631569572,right,Tm2,218,2,10,3,7,"2,10"
18553,720575940623210008,right,Tm2,219,6,-4,-8,4,"6,-4"
18554,720575940634868366,right,Tm2,220,2,-6,-5,-1,"2,-6"
18555,720575940615127294,right,Tm2,221,-7,3,8,-5,"-7,3"
18556,720575940618068288,right,Tm2,222,-3,26,16,10,"-3,26"
18557,720575940622462580,right,Tm2,223,-2,26,15,11,"-2,26"
18558,720575940631361017,right,Tm2,224,0,5,2,3,"0,5"
18559,720575940637805289,right,Tm2,225,2,-26,-15,-11,"2,-26"
18560,720575940629579769,right,Tm2,226,5,19,4,15,"5,19"
18561,720575940615695289,right,Tm2,227,-7,5,9,-4,"-7,5"
18562,720575940636376750,right,Tm2,228,-7,1,7,-6,"-7,1"
18563,720575940627976776,right,Tm2,229,5,2,-4,6,"5,2"
18564,720575940634707481,right,Tm2,230,2,9,2,7,"2,9"
18565,720575940623902973,right,Tm2,231,4,-12,-10,-2,"4,-12"
18566,720575940613323030,right,Tm2,232,-4,13,10,3,"-4,13"
18567,720575940624589035,right,Tm2,233,4,-13,-11,-2,"4,-13"
18568,720575940638540989,right,Tm2,234,1,3,0,3,"1,3"
18569,720575940614900882,right,Tm2,235,4,11,1,10,"4,11"
18570,720575940620297638,right,Tm2,236,-1,4,3,1,"-1,4"
18571,720575940629672442,right,Tm2,237,-2,27,15,12,"-2,27"
18572,720575940609601486,right,Tm2,238,-8,-3,6,-9,"-8,-3"
18573,720575940618055883,right,Tm2,239,-6,6,9,-3,"-6,6"
18574,720575940623653002,right,Tm2,240,-4,-3,2,-5,"-4,-3"
18575,720575940616836469,right,Tm2,241,2,-17,-11,-6,"2,-17"
18576,720575940632659552,right,Tm2,242,-4,6,7,-1,"-4,6"
18577,720575940640648280,right,Tm2,243,-1,-21,-10,-11,"-1,-21"
18578,720575940619282590,right,Tm2,244,-4,-12,-2,-10,"-4,-12"
18579,720575940616153868,right,Tm2,245,-5,-3,3,-6,"-5,-3"
18580,720575940627106604,right,Tm2,246,-4,15,11,4,"-4,15"
18581,720575940647548036,right,Tm2,247,-4,-15,-4,-11,"-4,-15"
18582,720575940630460665,right,Tm2,248,-6,0,6,-6,"-6,0"
18583,720575940622455977,right,Tm2,249,2,-12,-8,-4,"2,-12"
18584,720575940620918256,right,Tm2,250,-1,1,1,0,"-1,1"
18585,720575940605097132,right,Tm2,251,-1,-14,-6,-8,"-1,-14"
18586,720575940620860245,right,Tm2,252,3,23,8,15,"3,23"
18587,720575940618142877,right,Tm2,253,5,16,3,13,"5,16"
18588,720575940611849395,right,Tm2,254,3,-24,-15,-9,"3,-24"
18589,720575940647380020,right,Tm2,255,-6,-13,-1,-12,"-6,-13"
18590,720575940626650792,right,Tm2,256,5,-20,-15,-5,"5,-20"
18591,720575940621847139,right,Tm2,257,2,21,8,13,"2,21"
18592,720575940622743551,right,Tm2,258,-4,-17,-5,-12,"-4,-17"
18593,720575940617594769,right,Tm2,259,-7,-5,4,-9,"-7,-5"
18594,720575940628930663,right,Tm2,260,-3,19,12,7,"-3,19"
18595,720575940633094431,right,Tm2,261,-1,13,7,6,"-1,13"
18596,720575940620596017,right,Tm2,262,1,-11,-7,-4,"1,-11"
18597,720575940616418233,right,Tm2,263,-3,4,5,-1,"-3,4"
18598,720575940604498022,right,Tm2,264,-1,-6,-2,-4,"-1,-6"
18599,720575940639928117,right,Tm2,265,-6,-1,5,-6,"-6,-1"
18600,720575940624743399,right,Tm2,266,-1,-25,-12,-13,"-1,-25"
18601,720575940612247922,right,Tm2,267,-6,2,7,-5,"-6,2"
18602,720575940633345700,right,Tm2,268,7,-6,-10,4,"7,-6"
18603,720575940627661077,right,Tm2,269,2,-19,-12,-7,"2,-19"
18604,720575940632434221,right,Tm2,270,1,-8,-5,-3,"1,-8"
18605,720575940609851915,right,Tm2,271,4,6,-1,7,"4,6"
18606,720575940642839092,right,Tm2,272,3,-2,-4,2,"3,-2"
18607,720575940618752845,right,Tm2,273,-6,23,17,6,"-6,23"
18608,720575940628369680,right,Tm2,274,6,4,-4,8,"6,4"
18609,720575940619470256,right,Tm2,275,-8,-1,7,-8,"-8,-1"
18610,720575940628779002,right,Tm2,276,2,3,-1,4,"2,3"
18611,720575940641518069,right,Tm2,277,7,-3,-9,6,"7,-3"
18612,720575940615970790,right,Tm2,278,-5,10,10,0,"-5,10"
18613,720575940623287946,right,Tm2,279,-4,8,8,0,"-4,8"
18614,720575940641612507,right,Tm2,280,-6,-14,-1,-13,"-6,-14"
18615,720575940630743511,right,Tm2,281,-9,2,10,-8,"-9,2"
18616,720575940632142904,right,Tm2,282,0,26,13,13,"0,26"
18617,720575940610324885,right,Tm2,283,-4,4,6,-2,"-4,4"
18618,720575940640453437,right,Tm2,284,0,25,12,13,"0,25"
18619,720575940645166627,right,Tm2,285,6,-18,-15,-3,"6,-18"
18620,720575940624413931,right,Tm2,286,0,-24,-12,-12,"0,-24"
18621,720575940622982694,right,Tm2,287,-5,13,11,2,"-5,13"
18622,720575940629659727,right,Tm2,288,-1,30,16,14,"-1,30"
18623,720575940626148733,right,Tm2,289,-1,11,6,5,"-1,11"
18624,720575940645593140,right,Tm2,290,5,-24,-17,-7,"5,-24"
18625,720575940632969517,right,Tm2,291,7,2,-6,8,"7,2"
18626,720575940625896935,right,Tm2,292,-4,18,13,5,"-4,18"
18627,720575940645209623,right,Tm2,293,4,-17,-13,-4,"4,-17"
18628,720575940624930999,right,Tm2,294,1,-20,-11,-9,"1,-20"
18629,720575940613454450,right,Tm2,296,1,-18,-10,-8,"1,-18"
18630,720575940637504397,right,Tm2,297,7,-9,-12,3,"7,-9"
18631,720575940630591532,right,Tm2,298,-5,5,7,-2,"-5,5"
18632,720575940627117100,right,Tm2,299,-4,12,10,2,"-4,12"
18633,720575940638888262,right,Tm2,300,4,-18,-13,-5,"4,-18"
18634,720575940630212601,right,Tm2,301,-5,16,13,3,"-5,16"
18635,720575940644196808,right,Tm2,302,2,17,6,11,"2,17"
18636,720575940627043344,right,Tm2,303,-5,22,16,6,"-5,22"
18637,720575940619158694,right,Tm2,305,-7,4,9,-5,"-7,4"
18638,720575940607182722,right,Tm2,307,5,-25,-18,-7,"5,-25"
18639,720575940639226431,right,Tm2,308,-5,8,9,-1,"-5,8"
18640,720575940639475517,right,Tm2,309,-6,12,12,0,"-6,12"
18641,720575940632441415,right,Tm2,310,2,22,9,13,"2,22"
18642,720575940609799410,right,Tm2,311,-7,15,14,1,"-7,15"
18643,720575940627305544,right,Tm2,312,4,-7,-8,1,"4,-7"
18644,720575940618759734,right,Tm2,313,7,3,-6,9,"7,3"
18645,720575940635189360,right,Tm2,314,-9,5,11,-6,"-9,5"
18646,720575940629121274,right,Tm2,315,-3,-6,0,-6,"-3,-6"
18647,720575940638636510,right,Tm2,316,5,-4,-7,3,"5,-4"
18648,720575940612149617,right,Tm2,317,-5,-4,3,-7,"-5,-4"
18649,720575940629181187,right,Tm2,318,4,-19,-14,-5,"4,-19"
18650,720575940631308648,right,Tm2,319,-2,5,4,1,"-2,5"
18651,720575940620077990,right,Tm2,320,-2,-5,-1,-4,"-2,-5"
18652,720575940633614748,right,Tm2,321,8,4,-6,10,"8,4"
18653,720575940613285886,right,Tm2,322,2,26,11,15,"2,26"
18654,720575940605671852,right,Tm2,323,-7,-13,0,-13,"-7,-13"
18655,720575940622616396,right,Tm2,324,3,24,9,15,"3,24"
18656,720575940623151649,right,Tm2,325,5,1,-5,6,"5,1"
18657,720575940612727722,right,Tm2,326,2,16,6,10,"2,16"
18658,720575940621147233,right,Tm2,327,5,3,-4,7,"5,3"
18659,720575940628235260,right,Tm2,328,5,-9,-10,1,"5,-9"
18660,720575940619708888,right,Tm2,329,0,24,12,12,"0,24"
18661,720575940619970683,right,Tm2,330,3,3,-2,5,"3,3"
18662,720575940619734151,right,Tm2,331,1,-15,-9,-6,"1,-15"
18663,720575940609377372,right,Tm2,332,4,-26,-17,-9,"4,-26"
18664,720575940609717060,right,Tm2,333,0,-21,-11,-10,"0,-21"
18665,720575940622881148,right,Tm2,334,1,-26,-14,-12,"1,-26"
18666,720575940623729421,right,Tm2,335,2,8,2,6,"2,8"
18667,720575940615731359,right,Tm2,336,0,23,11,12,"0,23"
18668,720575940615704662,right,Tm2,337,-5,-6,2,-8,"-5,-6"
18669,720575940632698835,right,Tm2,338,-1,0,1,-1,"-1,0"
18670,720575940617456345,right,Tm2,339,6,11,-1,12,"6,11"
18671,720575940618450085,right,Tm2,340,-4,17,12,5,"-4,17"
18672,720575940628989483,right,Tm2,341,6,-17,-15,-2,"6,-17"
18673,720575940632410159,right,Tm2,342,2,-15,-10,-5,"2,-15"
18674,720575940634585975,right,Tm2,343,-3,27,16,11,"-3,27"
18675,720575940634199777,right,Tm2,344,-2,-15,-6,-9,"-2,-15"
18676,720575940628389379,right,Tm2,345,3,-12,-9,-3,"3,-12"
18677,720575940639945891,right,Tm2,346,-7,-9,2,-11,"-7,-9"
18678,720575940622962531,right,Tm2,347,-5,-13,-2,-11,"-5,-13"
18679,720575940615830228,right,Tm2,348,3,14,4,10,"3,14"
18680,720575940624049147,right,Tm2,349,-5,-14,-2,-12,"-5,-14"
18681,720575940659895937,right,Tm2,350,1,15,6,9,"1,15"
18682,720575940641534349,right,Tm2,351,-1,-17,-8,-9,"-1,-17"
18683,720575940634290031,right,Tm2,352,-2,28,16,12,"-2,28"
18684,720575940639974744,right,Tm2,353,2,24,10,14,"2,24"
18685,720575940621661936,right,Tm2,354,-2,-26,-11,-15,"-2,-26"
18686,720575940644881188,right,Tm2,355,-7,-6,4,-10,"-7,-6"
18687,720575940627321981,right,Tm2,356,0,22,11,11,"0,22"
18688,720575940620633547,right,Tm2,357,4,17,4,13,"4,17"
18689,720575940623420651,right,Tm2,358,-3,17,11,6,"-3,17"
18690,720575940616821824,right,Tm2,359,2,23,9,14,"2,23"
18691,720575940621611502,right,Tm2,360,-5,19,14,5,"-5,19"
18692,720575940617463382,right,Tm2,361,0,-7,-4,-3,"0,-7"
18693,720575940612958614,right,Tm2,362,2,-20,-12,-8,"2,-20"
18694,720575940624173063,right,Tm2,363,7,-4,-9,5,"7,-4"
18695,720575940621082733,right,Tm2,365,4,7,-1,8,"4,7"
18696,720575940636849070,right,Tm2,366,-5,-20,-5,-15,"-5,-20"
18697,720575940620583302,right,Tm2,367,-6,-15,-2,-13,"-6,-15"
18698,720575940624301307,right,Tm2,368,-4,-20,-6,-14,"-4,-20"
18699,720575940617702208,right,Tm2,369,5,-5,-8,3,"5,-5"
18700,720575940628215784,right,Tm2,370,-3,21,13,8,"-3,21"
18701,720575940637114509,right,Tm2,371,6,-5,-9,4,"6,-5"
18702,720575940633155609,right,Tm2,372,1,-2,-2,0,"1,-2"
18703,720575940617433371,right,Tm2,373,1,-21,-12,-9,"1,-21"
18704,720575940636828558,right,Tm2,374,2,13,4,9,"2,13"
18705,720575940630122870,right,Tm2,375,-6,7,9,-2,"-6,7"
18706,720575940618576541,right,Tm2,376,-7,-10,2,-12,"-7,-10"
18707,720575940639657013,right,Tm2,377,0,7,3,4,"0,7"
18708,720575940649534841,right,Tm2,378,-3,18,12,6,"-3,18"
18709,720575940623216141,right,Tm2,379,3,-17,-12,-5,"3,-17"
18710,720575940614527742,right,Tm2,380,-1,29,15,14,"-1,29"
18711,720575940622653879,right,Tm2,381,-8,-9,3,-12,"-8,-9"
18712,720575940625048551,right,Tm2,382,3,-6,-6,0,"3,-6"
18713,720575940621489407,right,Tm2,383,-6,11,11,0,"-6,11"
18714,720575940620174933,right,Tm2,384,-6,-2,5,-7,"-6,-2"
18715,720575940627458130,right,Tm2,385,-3,-18,-6,-12,"-3,-18"
18716,720575940645503876,right,Tm2,386,-6,19,15,4,"-6,19"
18717,720575940633325779,right,Tm2,387,-1,-15,-7,-8,"-1,-15"
18718,720575940627373072,right,Tm2,388,3,19,6,13,"3,19"
18719,720575940646674996,right,Tm2,389,-6,-16,-2,-14,"-6,-16"
18720,720575940647449652,right,Tm2,390,-6,-9,1,-10,"-6,-9"
18721,720575940612781549,right,Tm2,391,4,-3,-6,3,"4,-3"
18722,720575940625196472,right,Tm2,392,-4,7,7,0,"-4,7"
18723,720575940630772342,right,Tm2,393,-1,22,12,10,"-1,22"
18724,720575940620724673,right,Tm2,394,-7,-8,3,-11,"-7,-8"
18725,720575940645367406,right,Tm2,395,0,-22,-11,-11,"0,-22"
18726,720575940629104578,right,Tm2,396,-1,10,6,4,"-1,10"
18727,720575940619067045,right,Tm2,397,-3,-19,-7,-12,"-3,-19"
18728,720575940615134895,right,Tm2,398,-3,22,14,8,"-3,22"
18729,720575940622098202,right,Tm2,399,-4,-24,-8,-16,"-4,-24"
18730,720575940625825892,right,Tm2,401,-2,-19,-8,-11,"-2,-19"
18731,720575940627645205,right,Tm2,402,3,26,10,16,"3,26"
18732,720575940617201553,right,Tm2,403,-2,-12,-4,-8,"-2,-12"
18733,720575940628482247,right,Tm2,404,-1,20,11,9,"-1,20"
18734,720575940659519617,right,Tm2,405,3,10,2,8,"3,10"
18735,720575940605859872,right,Tm2,406,1,-25,-14,-11,"1,-25"
18736,720575940622268186,right,Tm2,407,-5,-10,0,-10,"-5,-10"
18737,720575940629948098,right,Tm2,408,-6,-4,4,-8,"-6,-4"
18738,720575940621375147,right,Tm2,409,0,-3,-2,-1,"0,-3"
18739,720575940605147057,right,Tm2,410,-2,-2,1,-3,"-2,-2"
18740,720575940625029052,right,Tm2,411,-5,-19,-5,-14,"-5,-19"
18741,720575940633138074,right,Tm2,412,-6,21,16,5,"-6,21"
18742,720575940629517818,right,Tm2,413,-2,-7,-2,-5,"-2,-7"
18743,720575940639947608,right,Tm2,414,4,21,6,15,"4,21"
18744,720575940613864298,right,Tm2,415,6,12,0,12,"6,12"
18745,720575940603268780,right,Tm2,416,3,-8,-7,-1,"3,-8"
18746,720575940618059298,right,Tm2,417,-6,-10,1,-11,"-6,-10"
18747,720575940629051343,right,Tm2,418,-2,15,9,6,"-2,15"
18748,720575940620725926,right,Tm2,419,-3,-11,-3,-8,"-3,-11"
18749,720575940605674249,right,Tm2,420,6,-3,-8,5,"6,-3"
18750,720575940626947130,right,Tm2,421,-1,12,7,5,"-1,12"
18751,720575940622441852,right,Tm2,422,-7,-4,5,-9,"-7,-4"
18752,720575940630742359,right,Tm2,423,3,-18,-12,-6,"3,-18"
18753,720575940638057050,right,Tm2,424,-3,-2,2,-4,"-3,-2"
18754,720575940611151480,right,Tm2,425,3,20,7,13,"3,20"
18755,720575940634588607,right,Tm2,426,-3,0,3,-3,"-3,0"
18756,720575940620369543,right,Tm2,427,5,-18,-14,-4,"5,-18"
18757,720575940631532303,right,Tm2,428,-2,23,13,10,"-2,23"
18758,720575940619066095,right,Tm2,429,-2,14,9,5,"-2,14"
18759,720575940640452059,right,Tm2,430,-3,-7,-1,-6,"-3,-7"
18760,720575940624584743,right,Tm2,431,-2,-10,-3,-7,"-2,-10"
18761,720575940622619371,right,Tm2,432,-5,7,8,-1,"-5,7"
18762,720575940644077984,right,Tm2,433,0,-8,-4,-4,"0,-8"
18763,720575940632025939,right,Tm2,434,-3,7,6,1,"-3,7"
18764,720575940624578539,right,Tm2,435,5,-17,-14,-3,"5,-17"
18765,720575940620578548,right,Tm2,436,0,-15,-8,-7,"0,-15"
18766,720575940620520557,right,Tm2,437,-3,12,9,3,"-3,12"
18767,720575940624822334,right,Tm2,438,2,27,11,16,"2,27"
18768,720575940626066618,right,Tm2,439,-3,-9,-2,-7,"-3,-9"
18769,720575940618043732,right,Tm2,440,1,23,10,13,"1,23"
18770,720575940629089067,right,Tm2,441,3,-16,-11,-5,"3,-16"
18771,720575940643425646,right,Tm2,442,-5,25,17,8,"-5,25"
18772,720575940629182716,right,Tm2,443,-6,4,8,-4,"-6,4"
18773,720575940606159793,right,Tm2,444,4,-10,-9,-1,"4,-10"
18774,720575940658844545,right,Tm2,445,-2,8,6,2,"-2,8"
18775,720575940631003254,right,Tm2,446,2,-14,-9,-5,"2,-14"
18776,720575940632164397,right,Tm2,447,-1,2,2,0,"-1,2"
18777,720575940623081942,right,Tm2,448,0,30,15,15,"0,30"
18778,720575940646699555,right,Tm2,449,6,-16,-14,-2,"6,-16"
18779,720575940651039990,right,Tm2,450,2,-9,-7,-2,"2,-9"
18780,720575940647210275,right,Tm2,451,4,20,6,14,"4,20"
18781,720575940630838646,right,Tm2,452,1,-9,-6,-3,"1,-9"
18782,720575940615413410,right,Tm2,453,3,25,9,16,"3,25"
18783,720575940629636395,right,Tm2,454,5,-12,-11,-1,"5,-12"
18784,720575940633316516,right,Tm2,455,7,-7,-11,4,"7,-7"
18785,720575940631966019,right,Tm2,456,0,21,10,11,"0,21"
18786,720575940633355468,right,Tm2,457,-2,17,10,7,"-2,17"
18787,720575940620250862,right,Tm2,458,5,0,-5,5,"5,0"
18788,720575940628106752,right,Tm2,459,5,-3,-7,4,"5,-3"
18789,720575940622484044,right,Tm2,460,-3,-20,-7,-13,"-3,-20"
18790,720575940625549464,right,Tm2,461,7,-5,-10,5,"7,-5"
18791,720575940617685387,right,Tm2,462,-1,18,10,8,"-1,18"
18792,720575940622256141,right,Tm2,463,5,17,3,14,"5,17"
18793,720575940637807156,right,Tm2,464,4,0,-4,4,"4,0"
18794,720575940630316428,right,Tm2,465,3,0,-3,3,"3,0"
18795,720575940612990486,right,Tm2,466,1,14,6,8,"1,14"
18796,720575940618025945,right,Tm2,467,-2,-20,-8,-12,"-2,-20"
18797,720575940619800199,right,Tm2,468,-3,11,8,3,"-3,11"
18798,720575940622314317,right,Tm2,469,-7,13,13,0,"-7,13"
18799,720575940623133636,right,Tm2,470,4,-9,-9,0,"4,-9"
18800,720575940626620004,right,Tm2,471,3,-26,-16,-10,"3,-26"
18801,720575940629343643,right,Tm2,472,1,25,11,14,"1,25"
18802,720575940610278980,right,Tm2,473,-4,23,15,8,"-4,23"
18803,720575940621968809,right,Tm2,474,-3,-17,-6,-11,"-3,-17"
18804,720575940626700474,right,Tm2,475,-4,-1,3,-4,"-4,-1"
18805,720575940616494651,right,Tm2,476,-1,15,8,7,"-1,15"
18806,720575940628818791,right,Tm2,477,-3,2,4,-2,"-3,2"
18807,720575940624906340,right,Tm2,478,-7,16,15,1,"-7,16"
18808,720575940617360059,right,Tm2,479,-2,10,7,3,"-2,10"
18809,720575940623389183,right,Tm2,480,3,-19,-13,-6,"3,-19"
18810,720575940627455079,right,Tm2,481,4,-8,-8,0,"4,-8"
18811,720575940631531279,right,Tm2,482,1,17,7,10,"1,17"
18812,720575940637534349,right,Tm2,483,2,-7,-6,-1,"2,-7"
18813,720575940637534605,right,Tm2,484,3,-9,-8,-1,"3,-9"
18814,720575940614999967,right,Tm2,485,-3,-3,1,-4,"-3,-3"
18815,720575940640527861,right,Tm2,486,0,1,0,1,"0,1"
18816,720575940621792147,right,Tm2,487,1,-1,-2,1,"1,-1"
18817,720575940631977785,right,Tm2,488,7,5,-5,10,"7,5"
18818,720575940617246097,right,Tm2,489,-3,10,8,2,"-3,10"
18819,720575940623475224,right,Tm2,490,-5,6,8,-2,"-5,6"
18820,720575940603314656,right,Tm2,491,7,-1,-8,7,"7,-1"
18821,720575940620080774,right,Tm2,492,-7,-2,6,-8,"-7,-2"
18822,720575940614859426,right,Tm2,493,-3,23,14,9,"-3,23"
18823,720575940630551670,right,Tm2,494,0,29,14,15,"0,29"
18824,720575940624840974,right,Tm2,497,6,1,-6,7,"6,1"
18825,720575940617779942,right,Tm2,498,6,10,-1,11,"6,10"
18826,720575940620813515,right,Tm2,499,5,10,0,10,"5,10"
18827,720575940633877985,right,Tm2,500,7,-8,-11,3,"7,-8"
18828,720575940622595828,right,Tm2,501,1,2,0,2,"1,2"
18829,720575940625318800,right,Tm2,502,5,8,-1,9,"5,8"
18830,720575940626048787,right,Tm2,503,3,17,5,12,"3,17"
18831,720575940637339625,right,Tm2,504,-2,9,6,3,"-2,9"
18832,720575940620324555,right,Tm2,505,6,-22,-17,-5,"6,-22"
18833,720575940615354811,right,Tm2,506,1,-12,-7,-5,"1,-12"
18834,720575940627932693,right,Tm2,507,-5,-12,-1,-11,"-5,-12"
18835,720575940644656419,right,Tm2,508,-5,11,10,1,"-5,11"
18836,720575940618356273,right,Tm2,509,-4,10,9,1,"-4,10"
18837,720575940634215578,right,Tm2,510,-2,11,7,4,"-2,11"
18838,720575940619167798,right,Tm2,511,5,-11,-11,0,"5,-11"
18839,720575940622588969,right,Tm2,512,6,0,-6,6,"6,0"
18840,720575940622674397,right,Tm2,513,-4,-13,-3,-10,"-4,-13"
18841,720575940608963849,right,Tm2,514,-4,-10,-1,-9,"-4,-10"
18842,720575940630457303,right,Tm2,515,-8,-7,4,-11,"-8,-7"
18843,720575940617009350,right,Tm2,516,7,-18,-16,-2,"7,-18"
18844,720575940632271268,right,Tm2,517,6,3,-5,8,"6,3"
18845,720575940606407625,right,Tm2,518,-4,22,15,7,"-4,22"
18846,720575940638770109,right,Tm2,519,-5,-5,2,-7,"-5,-5"
18847,720575940617325780,right,Tm2,520,-2,-22,-9,-13,"-2,-22"
18848,720575940632435783,right,Tm2,521,6,-9,-11,2,"6,-9"
18849,720575940617323035,right,Tm2,522,-4,0,4,-4,"-4,0"
18850,720575940616115654,right,Tm2,523,2,14,5,9,"2,14"
18851,720575940630097256,right,Tm2,524,4,-20,-14,-6,"4,-20"
18852,720575940612832022,right,Tm2,525,-1,-20,-9,-11,"-1,-20"
18853,720575940618369209,right,Tm2,526,0,-10,-5,-5,"0,-10"
18854,720575940625039880,right,Tm2,527,-4,-8,0,-8,"-4,-8"
18855,720575940623816388,right,Tm2,528,2,7,1,6,"2,7"
18856,720575940625477001,right,Tm2,529,2,-2,-3,1,"2,-2"
18857,720575940629831724,right,Tm2,530,-3,-13,-4,-9,"-3,-13"
18858,720575940614711080,right,Tm2,531,1,0,-1,1,"1,0"
18859,720575940620048148,right,Tm2,532,-8,7,11,-4,"-8,7"
18860,720575940638187497,right,Tm2,533,0,-16,-8,-8,"0,-16"
18861,720575940620086789,right,Tm2,534,3,2,-2,4,"3,2"
18862,720575940621324148,right,Tm2,535,8,-4,-10,6,"8,-4"
18863,720575940616331195,right,Tm2,536,3,4,-1,5,"3,4"
18864,720575940643893192,right,Tm2,537,0,-23,-12,-11,"0,-23"
18865,720575940631426375,right,Tm2,538,-4,1,4,-3,"-4,1"
18866,720575940650485238,right,Tm2,539,-6,15,13,2,"-6,15"
18867,720575940636716912,right,Tm2,540,-2,-9,-3,-6,"-2,-9"
18868,720575940622085303,right,Tm2,541,-4,14,11,3,"-4,14"
18869,720575940631458252,right,Tm2,542,6,-13,-13,0,"6,-13"
18870,720575940619845942,right,Tm2,543,-1,-4,-1,-3,"-1,-4"
18871,720575940640525171,right,Tm2,544,3,-13,-10,-3,"3,-13"
18872,720575940611203282,right,Tm2,545,5,11,0,11,"5,11"
18873,720575940628669739,right,Tm2,546,3,6,0,6,"3,6"
18874,720575940627570309,right,Tm2,547,-1,21,11,10,"-1,21"
18875,720575940629784475,right,Tm2,548,1,-16,-9,-7,"1,-16"
18876,720575940626740093,right,Tm2,549,0,-9,-5,-4,"0,-9"
18877,720575940627874216,right,Tm2,550,-2,3,3,0,"-2,3"
18878,720575940629746732,right,Tm2,551,-4,-9,-1,-8,"-4,-9"
18879,720575940644723748,right,Tm2,552,4,-1,-5,4,"4,-1"
18880,720575940627041192,right,Tm2,553,-3,16,11,5,"-3,16"
18881,720575940627005739,right,Tm2,554,-9,-3,7,-10,"-9,-3"
18882,720575940632869004,right,Tm2,555,-4,9,8,1,"-4,9"
18883,720575940612843250,right,Tm2,556,0,10,5,5,"0,10"
18884,720575940614611111,right,Tm2,557,6,-10,-11,1,"6,-10"
18885,720575940630707474,right,Tm2,558,-4,-21,-7,-14,"-4,-21"
18886,720575940626520876,right,Tm2,559,-6,22,17,5,"-6,22"
18887,720575940618517185,right,Tm2,560,-7,14,14,0,"-7,14"
18888,720575940612132977,right,Tm2,561,5,7,-2,9,"5,7"
18889,720575940619971008,right,Tm2,562,-5,-2,4,-6,"-5,-2"
18890,720575940630277888,right,Tm2,563,5,-13,-12,-1,"5,-13"
18891,720575940644945096,right,Tm2,564,3,-23,-15,-8,"3,-23"
18892,720575940626781072,right,Tm2,565,0,-26,-13,-13,"0,-26"
18893,720575940614481873,right,Tm2,566,5,-8,-9,1,"5,-8"
18894,720575940629935226,right,Tm2,567,-2,22,13,9,"-2,22"
18895,720575940626349498,right,Tm2,568,-6,-8,2,-10,"-6,-8"
18896,720575940623701896,right,Tm2,569,6,6,-3,9,"6,6"
18897,720575940633000493,right,Tm2,570,2,25,10,15,"2,25"
18898,720575940618271261,right,Tm2,571,0,-14,-7,-7,"0,-14"
18899,720575940638268835,right,Tm2,572,-8,3,9,-6,"-8,3"
18900,720575940630868524,right,Tm2,573,4,14,3,11,"4,14"
18901,720575940626735141,right,Tm2,574,-6,5,8,-3,"-6,5"
18902,720575940621430900,right,Tm2,575,6,9,-2,11,"6,9"
18903,720575940640230259,right,Tm2,576,0,28,14,14,"0,28"
18904,720575940616182796,right,Tm2,577,5,-14,-12,-2,"5,-14"
18905,720575940627058009,right,Tm2,578,4,-11,-10,-1,"4,-11"
18906,720575940620625172,right,Tm2,579,-3,-10,-2,-8,"-3,-10"
18907,720575940627019539,right,Tm2,580,-2,-23,-10,-13,"-2,-23"
18908,720575940609569493,right,Tm2,581,3,9,1,8,"3,9"
18909,720575940640947152,right,Tm2,582,-1,23,12,11,"-1,23"
18910,720575940615743298,right,Tm2,583,3,-25,-16,-9,"3,-25"
18911,720575940625067703,right,Tm2,584,4,23,7,16,"4,23"
18912,720575940619338053,right,Tm2,585,-1,-23,-11,-12,"-1,-23"
18913,720575940633253805,right,Tm2,586,2,18,7,11,"2,18"
18914,720575940612387557,right,Tm2,587,4,22,7,15,"4,22"
18915,720575940611562226,right,Tm2,588,1,4,1,3,"1,4"
18916,720575940628612986,right,Tm2,589,-1,-5,-2,-3,"-1,-5"
18917,720575940606395266,right,Tm2,590,1,9,3,6,"1,9"
18918,720575940619804912,right,Tm2,591,3,-3,-5,2,"3,-3"
18919,720575940621223789,right,Tm2,592,3,-28,-17,-11,"3,-28"
18920,720575940626886159,right,Tm2,593,3,-14,-10,-4,"3,-14"
18921,720575940619438063,right,Tm2,594,7,-16,-15,-1,"7,-16"
18922,720575940643615086,right,Tm2,595,7,-12,-13,1,"7,-12"
18923,720575940638132964,right,Tm2,596,-4,-16,-4,-12,"-4,-16"
18924,720575940641659956,right,Tm2,597,4,1,-4,5,"4,1"
18925,720575940627056625,right,Tm2,598,2,-18,-11,-7,"2,-18"
18926,720575940631721490,right,Tm2,599,-1,9,5,4,"-1,9"
18927,720575940618526365,right,Tm2,600,3,-10,-8,-2,"3,-10"
18928,720575940623197976,right,Tm2,601,1,16,7,9,"1,16"
18929,720575940617843229,right,Tm2,602,4,-2,-5,3,"4,-2"
18930,720575940621044304,right,Tm2,603,-3,-23,-9,-14,"-3,-23"
18931,720575940614409634,right,Tm2,604,-6,-17,-3,-14,"-6,-17"
18932,720575940635170495,right,Tm2,605,3,15,4,11,"3,15"
18933,720575940608964565,right,Tm2,606,-1,-19,-9,-10,"-1,-19"
18934,720575940640077400,right,Tm2,607,1,18,8,10,"1,18"
18935,720575940619894875,right,Tm2,608,1,10,4,6,"1,10"
18936,720575940627709775,right,Tm2,609,-2,0,2,-2,"-2,0"
18937,720575940625661840,right,Tm2,610,2,-23,-14,-9,"2,-23"
18938,720575940624692372,right,Tm2,611,-1,-18,-8,-10,"-1,-18"
18939,720575940611642830,right,Tm2,612,-3,-26,-10,-16,"-3,-26"
18940,720575940614695029,right,Tm2,613,-8,-4,6,-10,"-8,-4"
18941,720575940620189888,right,Tm2,614,-2,-8,-2,-6,"-2,-8"
18942,720575940630418743,right,Tm2,615,-7,-7,3,-10,"-7,-7"
18943,720575940628972647,right,Tm2,616,-3,15,10,5,"-3,15"
18944,720575940620730350,right,Tm2,617,-2,-17,-7,-10,"-2,-17"
18945,720575940644137416,right,Tm2,618,-1,24,13,11,"-1,24"
18946,720575940611131746,right,Tm2,619,-4,-19,-6,-13,"-4,-19"
18947,720575940631213561,right,Tm2,620,7,1,-7,8,"7,1"
18948,720575940625164327,right,Tm2,621,1,24,11,13,"1,24"
18949,720575940632525534,right,Tm2,622,-5,20,15,5,"-5,20"
18950,720575940625041127,right,Tm2,623,1,13,5,8,"1,13"
18951,720575940618531611,right,Tm2,624,1,-17,-10,-7,"1,-17"
18952,720575940619873752,right,Tm2,625,-2,24,14,10,"-2,24"
18953,720575940629943353,right,Tm2,626,-5,-8,1,-9,"-5,-8"
18954,720575940631563857,right,Tm2,627,0,-1,-1,0,"0,-1"
18955,720575940626468233,right,Tm2,628,0,0,0,0,"0,0"
18956,720575940638132799,right,Tm2,629,4,24,8,16,"4,24"
18957,720575940621118886,right,Tm2,630,4,8,0,8,"4,8"
18958,720575940624518408,right,Tm2,631,1,26,12,14,"1,26"
18959,720575940633894937,right,Tm2,632,3,-20,-13,-7,"3,-20"
18960,720575940613572522,right,Tm2,633,-1,-24,-11,-13,"-1,-24"
18961,720575940631821160,right,Tm2,634,-3,-15,-5,-10,"-3,-15"
18962,720575940646987396,right,Tm2,635,6,-6,-9,3,"6,-6"
18963,720575940632829836,right,Tm2,636,0,6,3,3,"0,6"
18964,720575940612768665,right,Tm2,637,3,-21,-14,-7,"3,-21"
18965,720575940633683610,right,Tm2,638,-1,7,4,3,"-1,7"
18966,720575940608516107,right,Tm2,639,-4,19,13,6,"-4,19"
18967,720575940624693652,right,Tm2,640,-1,-16,-7,-9,"-1,-16"
18968,720575940625619556,right,Tm2,641,-8,-5,5,-10,"-8,-5"
18969,720575940624405482,right,Tm2,642,-5,-11,-1,-10,"-5,-11"
18970,720575940630514769,right,Tm2,643,6,14,1,13,"6,14"
18971,720575940626854735,right,Tm2,644,-6,18,15,3,"-6,18"
18972,720575940629125123,right,Tm2,645,-4,27,17,10,"-4,27"
18973,720575940612543254,right,Tm2,646,6,17,2,15,"6,17"
18974,720575940625188796,right,Tm2,647,-4,-7,0,-7,"-4,-7"
18975,720575940621704268,right,Tm2,649,-1,5,3,2,"-1,5"
18976,720575940623918591,right,Tm2,650,-3,-25,-10,-15,"-3,-25"
18977,720575940633473761,right,Tm2,651,-4,-5,1,-6,"-4,-5"
18978,720575940603495648,right,Tm2,652,-6,-11,0,-11,"-6,-11"
18979,720575940624689812,right,Tm2,653,-6,-12,0,-12,"-6,-12"
18980,720575940631396664,right,Tm2,654,-3,8,7,1,"-3,8"
18981,720575940630108984,right,Tm2,655,6,-1,-7,6,"6,-1"
18982,720575940647731764,right,Tm2,656,0,-11,-6,-5,"0,-11"
18983,720575940626146853,right,Tm2,657,-2,-25,-11,-14,"-2,-25"
18984,720575940617670073,right,Tm2,658,1,20,9,11,"1,20"
18985,720575940637932451,right,Tm2,659,-4,-6,1,-7,"-4,-6"
18986,720575940634026451,right,Tm2,660,2,28,12,16,"2,28"
18987,720575940627112492,right,Tm2,661,-3,14,10,4,"-3,14"
18988,720575940638551860,right,Tm2,662,2,-1,-3,2,"2,-1"
18989,720575940605315262,right,Tm2,663,0,8,4,4,"0,8"
18990,720575940628122620,right,Tm2,664,1,-27,-15,-12,"1,-27"
18991,720575940618611781,right,Tm2,665,7,-2,-8,6,"7,-2"
18992,720575940629912567,right,Tm2,666,7,-13,-14,1,"7,-13"
18993,720575940624966414,right,Tm2,667,1,-28,-15,-13,"1,-28"
18994,720575940625333292,right,Tm2,668,1,19,8,11,"1,19"
18995,720575940632537681,right,Tm2,669,4,-16,-12,-4,"4,-16"
18996,720575940627450962,right,Tm2,671,-4,-23,-8,-15,"-4,-23"
18997,720575940638138019,right,Tm2,672,-8,11,13,-2,"-8,11"
18998,720575940623095748,right,Tm2,674,-4,-14,-3,-11,"-4,-14"
18999,720575940619379553,right,Tm2,675,-7,19,16,3,"-7,19"
19000,720575940608745685,right,Tm2,676,-3,-21,-8,-13,"-3,-21"
19001,720575940636711310,right,Tm2,677,0,11,5,6,"0,11"
19002,720575940638887750,right,Tm2,678,3,-7,-7,0,"3,-7"
19003,720575940618191453,right,Tm2,679,4,18,5,13,"4,18"
19004,720575940630308663,right,Tm2,680,-1,25,13,12,"-1,25"
19005,720575940628716795,right,Tm2,681,-2,-21,-9,-12,"-2,-21"
19006,720575940632888377,right,Tm2,682,6,-8,-10,2,"6,-8"
19007,720575940625381449,right,Tm2,683,2,6,1,5,"2,6"
19008,720575940626354193,right,Tm2,684,-6,17,14,3,"-6,17"
19009,720575940623151128,right,Tm2,685,-5,-9,0,-9,"-5,-9"
19010,720575940625375731,right,Tm2,686,5,-22,-16,-6,"5,-22"
19011,720575940632897491,right,Tm2,687,-6,-3,4,-7,"-6,-3"
19012,720575940624087187,right,Tm2,688,-7,10,12,-2,"-7,10"
19013,720575940626315052,right,Tm2,689,-2,18,11,7,"-2,18"
19014,720575940636818574,right,Tm2,690,-7,-3,5,-8,"-7,-3"
19015,720575940603893280,right,Tm2,691,-9,4,11,-7,"-9,4"
19016,720575940640073816,right,Tm2,692,-4,24,16,8,"-4,24"
19017,720575940616912214,right,Tm2,693,-3,25,15,10,"-3,25"
19018,720575940626997292,right,Tm2,695,-6,10,11,-1,"-6,10"
19019,720575940617667284,right,Tm2,696,-2,16,10,6,"-2,16"
19020,720575940621268672,right,Tm2,697,1,-22,-12,-10,"1,-22"
19021,720575940626746140,right,Tm2,698,6,-7,-10,3,"6,-7"
19022,720575940612291281,right,Tm2,699,-5,0,5,-5,"-5,0"
19023,720575940612738010,right,Tm2,700,5,15,2,13,"5,15"
19024,720575940614459390,right,Tm2,701,0,-4,-2,-2,"0,-4"
19025,720575940633210975,right,Tm2,702,-5,23,16,7,"-5,23"
19026,720575940606011570,right,Tm2,703,-3,1,3,-2,"-3,1"
19027,720575940626671633,right,Tm2,704,-7,8,11,-3,"-7,8"
19028,720575940626653194,right,Tm2,705,1,1,-1,2,"1,1"
19029,720575940645210391,right,Tm2,707,-2,25,14,11,"-2,25"
19030,720575940643775392,right,Tm2,708,-4,-25,-9,-16,"-4,-25"
19031,720575940636268407,right,Tm2,709,-2,-24,-10,-14,"-2,-24"
19032,720575940629525498,right,Tm2,710,4,-25,-17,-8,"4,-25"
19033,720575940620050123,right,Tm2,711,-1,19,10,9,"-1,19"
19034,720575940616320822,right,Tm2,712,-7,12,13,-1,"-7,12"
19035,720575940630469740,right,Tm2,713,-6,16,14,2,"-6,16"
19036,720575940641497589,right,Tm2,714,5,12,1,11,"5,12"
19037,720575940620069848,right,Tm2,715,4,10,1,9,"4,10"
19038,720575940620533720,right,Tm2,716,4,-6,-7,1,"4,-6"
19039,720575940623693962,right,Tm2,717,2,-22,-13,-9,"2,-22"
19040,720575940630306924,right,Tm2,718,-5,24,17,7,"-5,24"
19041,720575940629976395,right,Tm2,719,1,27,12,15,"1,27"
19042,720575940626901036,right,Tm2,720,-5,21,15,6,"-5,21"
19043,720575940627176695,right,Tm2,721,5,13,1,12,"5,13"
19044,720575940621065665,right,Tm2,722,6,-15,-14,-1,"6,-15"
19045,720575940610832602,right,Tm2,723,-2,-11,-4,-7,"-2,-11"
19046,720575940625594189,right,Tm2,724,4,2,-3,5,"4,2"
19047,720575940638217279,right,Tm2,725,-3,-24,-9,-15,"-3,-24"
19048,720575940618159833,right,Tm2,726,2,-28,-16,-12,"2,-28"
19049,720575940628349178,right,Tm2,727,7,6,-4,10,"7,6"
19050,720575940625573936,right,Tm2,728,7,12,-1,13,"7,12"
19051,720575940614717165,right,Tm2,729,-3,29,17,12,"-3,29"
19052,720575940633703393,right,Tm2,730,7,0,-7,7,"7,0"
19053,720575940626349767,right,Tm2,731,-6,9,10,-1,"-6,9"
19054,720575940619636756,right,Tm2,732,-3,6,6,0,"-3,6"
19055,720575940619056037,right,Tm2,733,-5,-17,-4,-13,"-5,-17"
19056,720575940630695243,right,Tm2,734,2,0,-2,2,"2,0"
19057,720575940626131237,right,Tm2,735,1,-23,-13,-10,"1,-23"
19058,720575940633215327,right,Tm2,736,-8,1,8,-7,"-8,1"
19059,720575940611434133,right,Tm2,737,0,19,9,10,"0,19"
19060,720575940623765518,right,Tm2,738,-3,13,9,4,"-3,13"
19061,720575940623532873,right,Tm2,739,-7,2,8,-6,"-7,2"
19062,720575940631372684,right,Tm2,740,2,-8,-6,-2,"2,-8"
19063,720575940645437806,right,Tm2,741,-2,-14,-5,-9,"-2,-14"
19064,720575940627118892,right,Tm2,742,-4,11,9,2,"-4,11"
19065,720575940633946137,right,Tm2,743,6,-19,-16,-3,"6,-19"
19066,720575940621538036,right,Tm2,744,-4,25,16,9,"-4,25"
19067,720575940613646146,right,Tm2,745,0,13,6,7,"0,13"
19068,720575940624327868,right,Tm2,746,-3,3,4,-1,"-3,3"
19069,720575940624537608,right,Tm2,747,0,2,1,1,"0,2"
19070,720575940609328226,right,Tm2,748,-4,20,14,6,"-4,20"
19071,720575940611580074,right,Tm2,749,-2,1,2,-1,"-2,1"
19072,720575940622403819,right,Tm2,750,4,-24,-16,-8,"4,-24"
19073,720575940621344902,right,Tm2,751,1,6,2,4,"1,6"
19074,720575940630775511,right,Tm2,752,-2,7,5,2,"-2,7"
19075,720575940621178221,right,Tm2,753,-3,24,15,9,"-3,24"
19076,720575940631528495,right,Tm2,754,-1,-13,-6,-7,"-1,-13"
19077,720575940630086204,right,Tm2,755,4,19,5,14,"4,19"
19078,720575940635635823,right,Tm2,757,0,-6,-3,-3,"0,-6"
19079,720575940625153267,right,Tm2,758,5,-1,-6,5,"5,-1"
19080,720575940626900376,right,Tm2,759,7,14,0,14,"7,14"
19081,720575940605438398,right,Tm2,760,0,17,8,9,"0,17"
19082,720575940617916450,right,Tm2,761,-4,-18,-5,-13,"-4,-18"
19083,720575940616843293,right,Tm2,762,0,14,7,7,"0,14"
19084,720575940628809723,right,Tm2,763,-5,14,12,2,"-5,14"
19085,720575940623966090,right,Tm2,764,-8,-6,5,-11,"-8,-6"
19086,720575940630949391,right,Tm2,765,-3,9,7,2,"-3,9"
19087,720575940629828864,right,Tm2,766,2,-4,-4,0,"2,-4"
19088,720575940621868276,right,Tm2,767,1,28,13,15,"1,28"
19089,720575940627956605,right,Tm2,772,1,12,5,7,"1,12"
19090,720575940620850567,right,Tm2,773,5,-19,-15,-4,"5,-19"
19091,720575940628963279,right,Tm2,774,-8,6,11,-5,"-8,6"
19092,720575940626284034,right,Tm2,775,5,22,6,16,"5,22"
19093,720575940615045226,right,Tm2,776,5,21,5,16,"5,21"
19094,720575940623757582,right,Tm2,777,6,20,4,16,"6,20"
19095,720575940604734641,right,Tm2,778,4,25,8,17,"4,25"
19096,720575940640867968,right,Tm2,779,5,24,7,17,"5,24"
19097,720575940632569155,right,Tm2,780,-6,25,18,7,"-6,25"
19098,720575940625120812,right,Tm2,781,-5,26,18,8,"-5,26"
19099,720575940641322485,right,Tm2,782,-5,27,18,9,"-5,27"
19100,720575940611161646,right,Tm2,783,-4,28,18,10,"-4,28"
19101,720575940616164767,right,Tm2,786,-2,30,17,13,"-2,30"
19102,720575940629479323,right,Tm2,787,3,28,11,17,"3,28"
19103,720575940632789933,right,Tm2,790,-2,-27,-12,-15,"-2,-27"
19104,720575940627658066,right,Tm2,792,8,2,-7,9,"8,2"
19105,720575940615836428,right,Tm2,793,8,-6,-11,5,"8,-6"
19106,720575940632458282,right,Tm2,794,5,-26,-18,-8,"5,-26"
19107,720575940630327772,right,Tm2,795,6,-21,-17,-4,"6,-21"
19108,720575940622380293,right,Tm2,796,4,26,9,17,"4,26"
19109,720575940636043127,right,Tm20,1,-6,13,12,1,"-6,13"
19110,720575940628230659,right,Tm20,2,-8,2,9,-7,"-8,2"
19111,720575940622996504,right,Tm20,3,6,-12,-12,0,"6,-12"
19112,720575940612553957,right,Tm20,4,-5,-21,-6,-15,"-5,-21"
19113,720575940620156551,right,Tm20,5,-1,16,9,7,"-1,16"
19114,720575940627594236,right,Tm20,6,-2,-4,0,-4,"-2,-4"
19115,720575940621790555,right,Tm20,7,-6,-6,3,-9,"-6,-6"
19116,720575940608403651,right,Tm20,8,-4,26,17,9,"-4,26"
19117,720575940619526198,right,Tm20,9,4,9,0,9,"4,9"
19118,720575940625994515,right,Tm20,10,5,-15,-13,-2,"5,-15"
19119,720575940628038376,right,Tm20,11,7,-14,-14,0,"7,-14"
19120,720575940627542018,right,Tm20,12,-7,9,11,-2,"-7,9"
19121,720575940609719509,right,Tm20,13,-1,-26,-12,-14,"-1,-26"
19122,720575940612825241,right,Tm20,14,0,-27,-14,-13,"0,-27"
19123,720575940638864829,right,Tm20,15,2,-3,-4,1,"2,-3"
19124,720575940630311954,right,Tm20,16,-2,-16,-6,-10,"-2,-16"
19125,720575940645266542,right,Tm20,17,1,-5,-4,-1,"1,-5"
19126,720575940630683961,right,Tm20,18,5,-16,-13,-3,"5,-16"
19127,720575940619729648,right,Tm20,19,-7,17,15,2,"-7,17"
19128,720575940617577019,right,Tm20,20,3,-11,-9,-2,"3,-11"
19129,720575940631558483,right,Tm20,21,-2,19,11,8,"-2,19"
19130,720575940638210613,right,Tm20,22,-1,3,2,1,"-1,3"
19131,720575940615644066,right,Tm20,23,-3,-16,-5,-11,"-3,-16"
19132,720575940620312779,right,Tm20,24,-1,-10,-4,-6,"-1,-10"
19133,720575940620849078,right,Tm20,25,-9,3,10,-7,"-9,3"
19134,720575940621255521,right,Tm20,26,1,-3,-3,0,"1,-3"
19135,720575940625798076,right,Tm20,27,0,-25,-13,-12,"0,-25"
19136,720575940621333231,right,Tm20,28,5,6,-2,8,"5,6"
19137,720575940649191289,right,Tm20,29,-1,-3,-1,-2,"-1,-3"
19138,720575940632358030,right,Tm20,30,6,16,2,14,"6,16"
19139,720575940625838128,right,Tm20,31,0,16,8,8,"0,16"
19140,720575940633598689,right,Tm20,32,0,12,6,6,"0,12"
19141,720575940633247652,right,Tm20,33,3,18,6,12,"3,18"
19142,720575940644356296,right,Tm20,34,6,18,3,15,"6,18"
19143,720575940614854952,right,Tm20,35,1,-24,-13,-11,"1,-24"
19144,720575940646263860,right,Tm20,36,6,8,-2,10,"6,8"
19145,720575940624523411,right,Tm20,37,1,5,1,4,"1,5"
19146,720575940631956051,right,Tm20,38,0,-2,-1,-1,"0,-2"
19147,720575940628492806,right,Tm20,39,0,20,10,10,"0,20"
19148,720575940643576736,right,Tm20,40,-2,-6,-1,-5,"-2,-6"
19149,720575940611481954,right,Tm20,41,-3,28,17,11,"-3,28"
19150,720575940613389795,right,Tm20,42,-1,14,8,6,"-1,14"
19151,720575940621725587,right,Tm20,43,-5,18,14,4,"-5,18"
19152,720575940629600335,right,Tm20,44,5,-10,-10,0,"5,-10"
19153,720575940632704047,right,Tm20,45,-5,-1,4,-5,"-5,-1"
19154,720575940617875869,right,Tm20,46,-5,15,12,3,"-5,15"
19155,720575940629794616,right,Tm20,47,-9,-1,8,-9,"-9,-1"
19156,720575940630281527,right,Tm20,48,-4,-22,-7,-15,"-4,-22"
19157,720575940638199615,right,Tm20,49,4,-4,-6,2,"4,-4"
19158,720575940630741468,right,Tm20,50,-2,21,12,9,"-2,21"
19159,720575940617823355,right,Tm20,51,0,-19,-10,-9,"0,-19"
19160,720575940624291657,right,Tm20,52,-1,-22,-10,-12,"-1,-22"
19161,720575940632915503,right,Tm20,53,5,14,2,12,"5,14"
19162,720575940617525204,right,Tm20,54,-4,3,5,-2,"-4,3"
19163,720575940630881420,right,Tm20,55,-4,-11,-2,-9,"-4,-11"
19164,720575940626806672,right,Tm20,56,1,-13,-8,-5,"1,-13"
19165,720575940635090201,right,Tm20,57,6,-11,-12,1,"6,-11"
19166,720575940608616149,right,Tm20,58,3,12,3,9,"3,12"
19167,720575940621536609,right,Tm20,59,-2,2,3,-1,"-2,2"
19168,720575940625311124,right,Tm20,60,-8,8,12,-4,"-8,8"
19169,720575940627312773,right,Tm20,61,-4,-4,2,-6,"-4,-4"
19170,720575940609069251,right,Tm20,63,4,12,2,10,"4,12"
19171,720575940622181756,right,Tm20,64,4,-23,-16,-7,"4,-23"
19172,720575940637800245,right,Tm20,65,-1,28,15,13,"-1,28"
19173,720575940624837671,right,Tm20,66,2,15,5,10,"2,15"
19174,720575940639237173,right,Tm20,67,-2,-13,-5,-8,"-2,-13"
19175,720575940611999385,right,Tm20,68,3,16,5,11,"3,16"
19176,720575940605952433,right,Tm20,70,-4,21,14,7,"-4,21"
19177,720575940617399809,right,Tm20,71,-2,-3,0,-3,"-2,-3"
19178,720575940646844451,right,Tm20,72,0,-28,-14,-14,"0,-28"
19179,720575940629074170,right,Tm20,73,2,2,-1,3,"2,2"
19180,720575940625456461,right,Tm20,74,-1,-9,-4,-5,"-1,-9"
19181,720575940630250087,right,Tm20,75,-6,14,13,1,"-6,14"
19182,720575940621119414,right,Tm20,76,-3,-4,1,-5,"-3,-4"
19183,720575940626174553,right,Tm20,77,2,-5,-5,0,"2,-5"
19184,720575940617283217,right,Tm20,78,2,20,8,12,"2,20"
19185,720575940645548852,right,Tm20,79,2,1,-2,3,"2,1"
19186,720575940630196480,right,Tm20,80,4,13,2,11,"4,13"
19187,720575940624443912,right,Tm20,81,6,-2,-7,5,"6,-2"
19188,720575940631734840,right,Tm20,82,-7,7,10,-3,"-7,7"
19189,720575940624936974,right,Tm20,83,2,-21,-13,-8,"2,-21"
19190,720575940617604564,right,Tm20,84,-2,12,8,4,"-2,12"
19191,720575940626099493,right,Tm20,85,4,-22,-15,-7,"4,-22"
19192,720575940618588075,right,Tm20,86,-5,-7,1,-8,"-5,-7"
19193,720575940649804153,right,Tm20,87,1,11,4,7,"1,11"
19194,720575940612810905,right,Tm20,89,1,-19,-11,-8,"1,-19"
19195,720575940632059192,right,Tm20,90,-4,5,6,-1,"-4,5"
19196,720575940622429168,right,Tm20,91,-1,6,4,2,"-1,6"
19197,720575940624186153,right,Tm20,92,0,9,4,5,"0,9"
19198,720575940612761598,right,Tm20,93,-6,3,7,-4,"-6,3"
19199,720575940631939395,right,Tm20,94,5,18,4,14,"5,18"
19200,720575940617618388,right,Tm20,95,4,-21,-15,-6,"4,-21"
19201,720575940623485142,right,Tm20,96,1,-10,-6,-4,"1,-10"
19202,720575940629314754,right,Tm20,97,-5,2,6,-4,"-5,2"
19203,720575940628696838,right,Tm20,98,-1,-12,-5,-7,"-1,-12"
19204,720575940614424062,right,Tm20,99,4,15,3,12,"4,15"
19205,720575940650017401,right,Tm20,100,2,-10,-7,-3,"2,-10"
19206,720575940613475537,right,Tm20,101,-7,6,10,-4,"-7,6"
19207,720575940633623853,right,Tm20,102,3,13,3,10,"3,13"
19208,720575940636685198,right,Tm20,103,7,9,-3,12,"7,9"
19209,720575940616565958,right,Tm20,104,-1,-27,-13,-14,"-1,-27"
19210,720575940623017221,right,Tm20,105,3,22,8,14,"3,22"
19211,720575940631645836,right,Tm20,106,-7,11,12,-1,"-7,11"
19212,720575940612420338,right,Tm20,107,8,-2,-9,7,"8,-2"
19213,720575940626640539,right,Tm20,108,-3,-12,-3,-9,"-3,-12"
19214,720575940633727059,right,Tm20,109,4,-5,-7,2,"4,-5"
19215,720575940626783687,right,Tm20,110,-7,0,7,-7,"-7,0"
19216,720575940633878623,right,Tm20,111,2,-24,-14,-10,"2,-24"
19217,720575940621522598,right,Tm20,112,-6,1,6,-5,"-6,1"
19218,720575940625461735,right,Tm20,113,-2,4,4,0,"-2,4"
19219,720575940606839218,right,Tm20,114,2,-13,-9,-4,"2,-13"
19220,720575940626877061,right,Tm20,115,-4,2,5,-3,"-4,2"
19221,720575940632389480,right,Tm20,116,-1,-8,-3,-5,"-1,-8"
19222,720575940641742581,right,Tm20,117,-8,-2,7,-9,"-8,-2"
19223,720575940637730394,right,Tm20,118,3,1,-3,4,"3,1"
19224,720575940619661141,right,Tm20,119,-2,6,5,1,"-2,6"
19225,720575940614208977,right,Tm20,120,-1,-1,0,-1,"-1,-1"
19226,720575940618242102,right,Tm20,121,-8,4,10,-6,"-8,4"
19227,720575940617276372,right,Tm20,122,-5,9,9,0,"-5,9"
19228,720575940634794138,right,Tm20,123,-8,10,13,-3,"-8,10"
19229,720575940644287524,right,Tm20,124,1,-7,-5,-2,"1,-7"
19230,720575940627635837,right,Tm20,125,5,9,-1,10,"5,9"
19231,720575940605026784,right,Tm20,126,3,11,2,9,"3,11"
19232,720575940625621808,right,Tm20,127,0,15,7,8,"0,15"
19233,720575940638449380,right,Tm20,128,3,-22,-14,-8,"3,-22"
19234,720575940621639339,right,Tm20,129,0,-13,-7,-6,"0,-13"
19235,720575940621189473,right,Tm20,130,2,12,4,8,"2,12"
19236,720575940612332494,right,Tm20,131,-6,20,16,4,"-6,20"
19237,720575940613215697,right,Tm20,133,-3,20,13,7,"-3,20"
19238,720575940623207688,right,Tm20,134,-5,-18,-4,-14,"-5,-18"
19239,720575940628690179,right,Tm20,135,-3,-22,-8,-14,"-3,-22"
19240,720575940620414912,right,Tm20,138,0,27,13,14,"0,27"
19241,720575940609623049,right,Tm20,139,1,-14,-8,-6,"1,-14"
19242,720575940611588194,right,Tm20,141,5,-23,-17,-6,"5,-23"
19243,720575940621197132,right,Tm20,142,-2,-18,-7,-11,"-2,-18"
19244,720575940609706820,right,Tm20,143,-4,16,12,4,"-4,16"
19245,720575940633719716,right,Tm20,144,7,-11,-13,2,"7,-11"
19246,720575940647759748,right,Tm20,145,0,4,2,2,"0,4"
19247,720575940620037205,right,Tm20,146,1,-6,-4,-2,"1,-6"
19248,720575940623332232,right,Tm20,147,1,21,9,12,"1,21"
19249,720575940618685268,right,Tm20,148,-7,-11,1,-12,"-7,-11"
19250,720575940639472984,right,Tm20,149,6,-14,-13,-1,"6,-14"
19251,720575940621086452,right,Tm20,150,-8,5,10,-5,"-8,5"
19252,720575940627721295,right,Tm20,151,-3,-14,-4,-10,"-3,-14"
19253,720575940619921232,right,Tm20,152,3,-15,-11,-4,"3,-15"
19254,720575940637016206,right,Tm20,153,8,0,-8,8,"8,0"
19255,720575940627526140,right,Tm20,154,-8,0,8,-8,"-8,0"
19256,720575940628225847,right,Tm20,155,-8,13,14,-1,"-8,13"
19257,720575940603809452,right,Tm20,156,-9,1,9,-8,"-9,1"
19258,720575940628781111,right,Tm20,157,-1,-7,-3,-4,"-1,-7"
19259,720575940627777297,right,Tm20,158,3,-5,-6,1,"3,-5"
19260,720575940628596739,right,Tm20,160,-2,20,12,8,"-2,20"
19261,720575940612957747,right,Tm20,161,4,-14,-11,-3,"4,-14"
19262,720575940620250759,right,Tm20,162,-4,-2,3,-5,"-4,-2"
19263,720575940632389432,right,Tm20,164,-1,-2,0,-2,"-1,-2"
19264,720575940626250384,right,Tm20,165,4,16,4,12,"4,16"
19265,720575940614973115,right,Tm20,166,0,18,9,9,"0,18"
19266,720575940620191508,right,Tm20,167,0,-17,-9,-8,"0,-17"
19267,720575940621908506,right,Tm20,168,-1,17,9,8,"-1,17"
19268,720575940617207645,right,Tm20,169,0,-18,-9,-9,"0,-18"
19269,720575940628392859,right,Tm20,170,-5,1,5,-4,"-5,1"
19270,720575940608683100,right,Tm20,171,6,-20,-16,-4,"6,-20"
19271,720575940609239305,right,Tm20,172,1,22,10,12,"1,22"
19272,720575940617259893,right,Tm20,173,2,-25,-15,-10,"2,-25"
19273,720575940613884847,right,Tm20,174,4,-15,-12,-3,"4,-15"
19274,720575940615820703,right,Tm20,175,-6,-7,2,-9,"-6,-7"
19275,720575940615161297,right,Tm20,176,-2,13,8,5,"-2,13"
19276,720575940625388365,right,Tm20,177,-2,-1,1,-2,"-2,-1"
19277,720575940628725009,right,Tm20,178,2,11,3,8,"2,11"
19278,720575940611370286,right,Tm20,179,-5,-16,-3,-13,"-5,-16"
19279,720575940624400823,right,Tm20,180,2,-27,-16,-11,"2,-27"
19280,720575940631426297,right,Tm20,181,1,-4,-3,-1,"1,-4"
19281,720575940622430284,right,Tm20,182,7,-10,-12,2,"7,-10"
19282,720575940613740072,right,Tm20,183,-5,-15,-3,-12,"-5,-15"
19283,720575940631741507,right,Tm20,184,-6,-5,3,-8,"-6,-5"
19284,720575940616559519,right,Tm20,185,2,-11,-8,-3,"2,-11"
19285,720575940633490830,right,Tm20,186,-1,26,14,12,"-1,26"
19286,720575940628145064,right,Tm20,187,3,21,7,14,"3,21"
19287,720575940626138314,right,Tm20,188,-5,17,13,4,"-5,17"
19288,720575940627762965,right,Tm20,189,6,13,0,13,"6,13"
19289,720575940617790491,right,Tm20,190,-3,-5,0,-5,"-3,-5"
19290,720575940637371493,right,Tm20,191,-1,-11,-5,-6,"-1,-11"
19291,720575940624498869,right,Tm20,192,7,10,-2,12,"7,10"
19292,720575940623972791,right,Tm20,193,-5,4,7,-3,"-5,4"
19293,720575940624362424,right,Tm20,194,0,-5,-3,-2,"0,-5"
19294,720575940622900265,right,Tm20,195,-3,-1,2,-3,"-3,-1"
19295,720575940609096971,right,Tm20,196,-1,8,5,3,"-1,8"
19296,720575940639385397,right,Tm20,197,0,-20,-10,-10,"0,-20"
19297,720575940624101158,right,Tm20,198,6,2,-5,7,"6,2"
19298,720575940636741231,right,Tm20,199,0,-12,-6,-6,"0,-12"
19299,720575940612986902,right,Tm20,200,-5,12,11,1,"-5,12"
19300,720575940619717942,right,Tm20,201,-8,9,12,-3,"-8,9"
19301,720575940636783790,right,Tm20,202,-1,27,14,13,"-1,27"
19302,720575940636554462,right,Tm20,203,3,-1,-4,3,"3,-1"
19303,720575940626891522,right,Tm20,204,5,-2,-6,4,"5,-2"
19304,720575940635666356,right,Tm20,205,5,-6,-8,2,"5,-6"
19305,720575940625577060,right,Tm20,206,-3,5,5,0,"-3,5"
19306,720575940635582399,right,Tm20,207,1,29,13,16,"1,29"
19307,720575940624947207,right,Tm20,208,5,-21,-16,-5,"5,-21"
19308,720575940637937385,right,Tm20,209,-3,-8,-1,-7,"-3,-8"
19309,720575940605293698,right,Tm20,210,-6,8,10,-2,"-6,8"
19310,720575940624762004,right,Tm20,211,-7,-1,6,-7,"-7,-1"
19311,720575940613985576,right,Tm20,212,2,-16,-10,-6,"2,-16"
19312,720575940653550753,right,Tm20,213,3,-4,-5,1,"3,-4"
19313,720575940630379562,right,Tm20,214,-5,3,6,-3,"-5,3"
19314,720575940619432920,right,Tm20,216,2,19,7,12,"2,19"
19315,720575940619060638,right,Tm20,217,6,15,1,14,"6,15"
19316,720575940619640280,right,Tm20,218,2,10,3,7,"2,10"
19317,720575940620814575,right,Tm20,219,6,-4,-8,4,"6,-4"
19318,720575940624446647,right,Tm20,220,2,-6,-5,-1,"2,-6"
19319,720575940627793482,right,Tm20,221,-7,3,8,-5,"-7,3"
19320,720575940631573037,right,Tm20,222,-3,26,16,10,"-3,26"
19321,720575940609570168,right,Tm20,223,-2,26,15,11,"-2,26"
19322,720575940608686684,right,Tm20,224,0,5,2,3,"0,5"
19323,720575940625916965,right,Tm20,225,2,-26,-15,-11,"2,-26"
19324,720575940614876583,right,Tm20,226,5,19,4,15,"5,19"
19325,720575940606855177,right,Tm20,227,-7,5,9,-4,"-7,5"
19326,720575940614987059,right,Tm20,228,-7,1,7,-6,"-7,1"
19327,720575940621382638,right,Tm20,229,5,2,-4,6,"5,2"
19328,720575940621683078,right,Tm20,230,2,9,2,7,"2,9"
19329,720575940634997695,right,Tm20,231,4,-12,-10,-2,"4,-12"
19330,720575940633916814,right,Tm20,232,-4,13,10,3,"-4,13"
19331,720575940614653950,right,Tm20,233,4,-13,-11,-2,"4,-13"
19332,720575940627671177,right,Tm20,235,4,11,1,10,"4,11"
19333,720575940606915714,right,Tm20,236,-1,4,3,1,"-1,4"
19334,720575940625947173,right,Tm20,237,-2,27,15,12,"-2,27"
19335,720575940621135621,right,Tm20,238,-8,-3,6,-9,"-8,-3"
19336,720575940617857025,right,Tm20,239,-6,6,9,-3,"-6,6"
19337,720575940637084271,right,Tm20,240,-4,-3,2,-5,"-4,-3"
19338,720575940605454025,right,Tm20,241,2,-17,-11,-6,"2,-17"
19339,720575940636723118,right,Tm20,242,-4,6,7,-1,"-4,6"
19340,720575940627321118,right,Tm20,243,-1,-21,-10,-11,"-1,-21"
19341,720575940614048749,right,Tm20,244,-4,-12,-2,-10,"-4,-12"
19342,720575940624301287,right,Tm20,245,-5,-3,3,-6,"-5,-3"
19343,720575940624354121,right,Tm20,246,-4,15,11,4,"-4,15"
19344,720575940623505348,right,Tm20,247,-4,-15,-4,-11,"-4,-15"
19345,720575940616903451,right,Tm20,248,-6,0,6,-6,"-6,0"
19346,720575940637608846,right,Tm20,249,2,-12,-8,-4,"2,-12"
19347,720575940629766403,right,Tm20,250,-1,1,1,0,"-1,1"
19348,720575940624715244,right,Tm20,251,-1,-14,-6,-8,"-1,-14"
19349,720575940629966380,right,Tm20,252,3,23,8,15,"3,23"
19350,720575940614826130,right,Tm20,253,5,16,3,13,"5,16"
19351,720575940629976594,right,Tm20,254,3,-24,-15,-9,"3,-24"
19352,720575940612566954,right,Tm20,255,-6,-13,-1,-12,"-6,-13"
19353,720575940631236347,right,Tm20,256,5,-20,-15,-5,"5,-20"
19354,720575940607258891,right,Tm20,257,2,21,8,13,"2,21"
19355,720575940624702727,right,Tm20,258,-4,-17,-5,-12,"-4,-17"
19356,720575940635528184,right,Tm20,259,-7,-5,4,-9,"-7,-5"
19357,720575940612832749,right,Tm20,260,-3,19,12,7,"-3,19"
19358,720575940630499831,right,Tm20,261,-1,13,7,6,"-1,13"
19359,720575940620910928,right,Tm20,262,1,-11,-7,-4,"1,-11"
19360,720575940631475287,right,Tm20,263,-3,4,5,-1,"-3,4"
19361,720575940636024687,right,Tm20,264,-1,-6,-2,-4,"-1,-6"
19362,720575940606790834,right,Tm20,265,-6,-1,5,-6,"-6,-1"
19363,720575940644104352,right,Tm20,266,-1,-25,-12,-13,"-1,-25"
19364,720575940628320811,right,Tm20,267,-6,2,7,-5,"-6,2"
19365,720575940641254452,right,Tm20,268,7,-6,-10,4,"7,-6"
19366,720575940610914258,right,Tm20,269,2,-19,-12,-7,"2,-19"
19367,720575940611658482,right,Tm20,270,1,-8,-5,-3,"1,-8"
19368,720575940611545902,right,Tm20,271,4,6,-1,7,"4,6"
19369,720575940619690968,right,Tm20,272,3,-2,-4,2,"3,-2"
19370,720575940637830709,right,Tm20,273,-6,23,17,6,"-6,23"
19371,720575940632258786,right,Tm20,275,-8,-1,7,-8,"-8,-1"
19372,720575940624019637,right,Tm20,276,2,3,-1,4,"2,3"
19373,720575940618645589,right,Tm20,277,7,-3,-9,6,"7,-3"
19374,720575940624066539,right,Tm20,278,-5,10,10,0,"-5,10"
19375,720575940623401962,right,Tm20,279,-4,8,8,0,"-4,8"
19376,720575940627397223,right,Tm20,281,-9,2,10,-8,"-9,2"
19377,720575940616984518,right,Tm20,282,0,26,13,13,"0,26"
19378,720575940627146042,right,Tm20,283,-4,4,6,-2,"-4,4"
19379,720575940619105053,right,Tm20,284,0,25,12,13,"0,25"
19380,720575940622139076,right,Tm20,285,6,-18,-15,-3,"6,-18"
19381,720575940638687814,right,Tm20,286,0,-24,-12,-12,"0,-24"
19382,720575940619234496,right,Tm20,287,-5,13,11,2,"-5,13"
19383,720575940638774086,right,Tm20,288,-1,30,16,14,"-1,30"
19384,720575940613131890,right,Tm20,290,5,-24,-17,-7,"5,-24"
19385,720575940626898072,right,Tm20,291,7,2,-6,8,"7,2"
19386,720575940630687483,right,Tm20,292,-4,18,13,5,"-4,18"
19387,720575940623510221,right,Tm20,293,4,-17,-13,-4,"4,-17"
19388,720575940632611399,right,Tm20,294,1,-20,-11,-9,"1,-20"
19389,720575940614556822,right,Tm20,295,-2,29,16,13,"-2,29"
19390,720575940626237584,right,Tm20,296,1,-18,-10,-8,"1,-18"
19391,720575940628206023,right,Tm20,297,7,-9,-12,3,"7,-9"
19392,720575940611258670,right,Tm20,298,-5,5,7,-2,"-5,5"
19393,720575940633888910,right,Tm20,299,-4,12,10,2,"-4,12"
19394,720575940607332226,right,Tm20,300,4,-18,-13,-5,"4,-18"
19395,720575940627539755,right,Tm20,301,-5,16,13,3,"-5,16"
19396,720575940632786124,right,Tm20,302,2,17,6,11,"2,17"
19397,720575940616167837,right,Tm20,303,-5,22,16,6,"-5,22"
19398,720575940621213936,right,Tm20,305,-7,4,9,-5,"-7,4"
19399,720575940624362749,right,Tm20,306,3,7,0,7,"3,7"
19400,720575940635598443,right,Tm20,307,5,-25,-18,-7,"5,-25"
19401,720575940624084203,right,Tm20,308,-5,8,9,-1,"-5,8"
19402,720575940626981962,right,Tm20,309,-6,12,12,0,"-6,12"
19403,720575940623309960,right,Tm20,310,2,22,9,13,"2,22"
19404,720575940623354348,right,Tm20,311,-7,15,14,1,"-7,15"
19405,720575940625934896,right,Tm20,312,4,-7,-8,1,"4,-7"
19406,720575940631169551,right,Tm20,313,7,3,-6,9,"7,3"
19407,720575940626280344,right,Tm20,314,-9,5,11,-6,"-9,5"
19408,720575940625963085,right,Tm20,315,-3,-6,0,-6,"-3,-6"
19409,720575940623491476,right,Tm20,316,5,-4,-7,3,"5,-4"
19410,720575940621383558,right,Tm20,317,-5,-4,3,-7,"-5,-4"
19411,720575940630807503,right,Tm20,318,4,-19,-14,-5,"4,-19"
19412,720575940624422141,right,Tm20,319,-2,5,4,1,"-2,5"
19413,720575940618025629,right,Tm20,320,-2,-5,-1,-4,"-2,-5"
19414,720575940638491224,right,Tm20,321,8,4,-6,10,"8,4"
19415,720575940624722615,right,Tm20,322,2,26,11,15,"2,26"
19416,720575940626223934,right,Tm20,323,-7,-13,0,-13,"-7,-13"
19417,720575940635308479,right,Tm20,324,3,24,9,15,"3,24"
19418,720575940647935540,right,Tm20,326,2,16,6,10,"2,16"
19419,720575940614166690,right,Tm20,328,5,-9,-10,1,"5,-9"
19420,720575940644576804,right,Tm20,329,0,24,12,12,"0,24"
19421,720575940627522898,right,Tm20,330,3,3,-2,5,"3,3"
19422,720575940605225900,right,Tm20,331,1,-15,-9,-6,"1,-15"
19423,720575940629662311,right,Tm20,332,4,-26,-17,-9,"4,-26"
19424,720575940623588829,right,Tm20,333,0,-21,-11,-10,"0,-21"
19425,720575940628540904,right,Tm20,334,1,-26,-14,-12,"1,-26"
19426,720575940630764283,right,Tm20,336,0,23,11,12,"0,23"
19427,720575940626271674,right,Tm20,337,-5,-6,2,-8,"-5,-6"
19428,720575940617051682,right,Tm20,338,-1,0,1,-1,"-1,0"
19429,720575940627591503,right,Tm20,339,6,11,-1,12,"6,11"
19430,720575940631849576,right,Tm20,340,-4,17,12,5,"-4,17"
19431,720575940613919784,right,Tm20,341,6,-17,-15,-2,"6,-17"
19432,720575940622073093,right,Tm20,342,2,-15,-10,-5,"2,-15"
19433,720575940605678270,right,Tm20,343,-3,27,16,11,"-3,27"
19434,720575940619505243,right,Tm20,344,-2,-15,-6,-9,"-2,-15"
19435,720575940629077447,right,Tm20,345,3,-12,-9,-3,"3,-12"
19436,720575940630584313,right,Tm20,346,-7,-9,2,-11,"-7,-9"
19437,720575940626195006,right,Tm20,347,-5,-13,-2,-11,"-5,-13"
19438,720575940604892640,right,Tm20,348,3,14,4,10,"3,14"
19439,720575940622485887,right,Tm20,349,-5,-14,-2,-12,"-5,-14"
19440,720575940624623804,right,Tm20,350,1,15,6,9,"1,15"
19441,720575940620875373,right,Tm20,351,-1,-17,-8,-9,"-1,-17"
19442,720575940631298245,right,Tm20,352,-2,28,16,12,"-2,28"
19443,720575940629611002,right,Tm20,353,2,24,10,14,"2,24"
19444,720575940627986821,right,Tm20,354,-2,-26,-11,-15,"-2,-26"
19445,720575940628813571,right,Tm20,355,-7,-6,4,-10,"-7,-6"
19446,720575940619859915,right,Tm20,356,0,22,11,11,"0,22"
19447,720575940618016925,right,Tm20,357,4,17,4,13,"4,17"
19448,720575940621437249,right,Tm20,358,-3,17,11,6,"-3,17"
19449,720575940622936346,right,Tm20,359,2,23,9,14,"2,23"
19450,720575940626208714,right,Tm20,360,-5,19,14,5,"-5,19"
19451,720575940622596777,right,Tm20,361,0,-7,-4,-3,"0,-7"
19452,720575940612846643,right,Tm20,362,2,-20,-12,-8,"2,-20"
19453,720575940616334011,right,Tm20,363,7,-4,-9,5,"7,-4"
19454,720575940634678112,right,Tm20,365,4,7,-1,8,"4,7"
19455,720575940646811444,right,Tm20,368,-4,-20,-6,-14,"-4,-20"
19456,720575940628965873,right,Tm20,369,5,-5,-8,3,"5,-5"
19457,720575940628729360,right,Tm20,370,-3,21,13,8,"-3,21"
19458,720575940617594146,right,Tm20,371,6,-5,-9,4,"6,-5"
19459,720575940619006366,right,Tm20,372,1,-2,-2,0,"1,-2"
19460,720575940647457412,right,Tm20,373,1,-21,-12,-9,"1,-21"
19461,720575940631505739,right,Tm20,374,2,13,4,9,"2,13"
19462,720575940614318754,right,Tm20,375,-6,7,9,-2,"-6,7"
19463,720575940622631351,right,Tm20,376,-7,-10,2,-12,"-7,-10"
19464,720575940619160405,right,Tm20,377,0,7,3,4,"0,7"
19465,720575940620866657,right,Tm20,378,-3,18,12,6,"-3,18"
19466,720575940624353065,right,Tm20,379,3,-17,-12,-5,"3,-17"
19467,720575940621217670,right,Tm20,380,-1,29,15,14,"-1,29"
19468,720575940627764105,right,Tm20,382,3,-6,-6,0,"3,-6"
19469,720575940630184234,right,Tm20,383,-6,11,11,0,"-6,11"
19470,720575940608816067,right,Tm20,384,-6,-2,5,-7,"-6,-2"
19471,720575940628598633,right,Tm20,385,-3,-18,-6,-12,"-3,-18"
19472,720575940627287890,right,Tm20,386,-6,19,15,4,"-6,19"
19473,720575940633612205,right,Tm20,387,-1,-15,-7,-8,"-1,-15"
19474,720575940616161241,right,Tm20,388,3,19,6,13,"3,19"
19475,720575940624697748,right,Tm20,389,-6,-16,-2,-14,"-6,-16"
19476,720575940617411933,right,Tm20,390,-6,-9,1,-10,"-6,-9"
19477,720575940612743410,right,Tm20,391,4,-3,-6,3,"4,-3"
19478,720575940627754492,right,Tm20,392,-4,7,7,0,"-4,7"
19479,720575940637352293,right,Tm20,393,-1,22,12,10,"-1,22"
19480,720575940644586400,right,Tm20,394,-7,-8,3,-11,"-7,-8"
19481,720575940617575541,right,Tm20,395,0,-22,-11,-11,"0,-22"
19482,720575940614844603,right,Tm20,397,-3,-19,-7,-12,"-3,-19"
19483,720575940610718869,right,Tm20,398,-3,22,14,8,"-3,22"
19484,720575940617269846,right,Tm20,400,1,-29,-16,-13,"1,-29"
19485,720575940619880395,right,Tm20,401,-2,-19,-8,-11,"-2,-19"
19486,720575940616143922,right,Tm20,402,3,26,10,16,"3,26"
19487,720575940620153536,right,Tm20,403,-2,-12,-4,-8,"-2,-12"
19488,720575940638637894,right,Tm20,404,-1,20,11,9,"-1,20"
19489,720575940624243639,right,Tm20,405,3,10,2,8,"3,10"
19490,720575940629897015,right,Tm20,406,1,-25,-14,-11,"1,-25"
19491,720575940638029284,right,Tm20,407,-5,-10,0,-10,"-5,-10"
19492,720575940617745620,right,Tm20,408,-6,-4,4,-8,"-6,-4"
19493,720575940623271562,right,Tm20,409,0,-3,-2,-1,"0,-3"
19494,720575940621401438,right,Tm20,410,-2,-2,1,-3,"-2,-2"
19495,720575940626901593,right,Tm20,411,-5,-19,-5,-14,"-5,-19"
19496,720575940619737453,right,Tm20,412,-6,21,16,5,"-6,21"
19497,720575940629780224,right,Tm20,413,-2,-7,-2,-5,"-2,-7"
19498,720575940643561582,right,Tm20,414,4,21,6,15,"4,21"
19499,720575940620226580,right,Tm20,415,6,12,0,12,"6,12"
19500,720575940615320785,right,Tm20,416,3,-8,-7,-1,"3,-8"
19501,720575940639779005,right,Tm20,417,-6,-10,1,-11,"-6,-10"
19502,720575940628096232,right,Tm20,418,-2,15,9,6,"-2,15"
19503,720575940636748462,right,Tm20,419,-3,-11,-3,-8,"-3,-11"
19504,720575940614844562,right,Tm20,420,6,-3,-8,5,"6,-3"
19505,720575940636616334,right,Tm20,421,-1,12,7,5,"-1,12"
19506,720575940629837671,right,Tm20,422,-7,-4,5,-9,"-7,-4"
19507,720575940622058480,right,Tm20,423,3,-18,-12,-6,"3,-18"
19508,720575940621724276,right,Tm20,424,-3,-2,2,-4,"-3,-2"
19509,720575940629093737,right,Tm20,425,3,20,7,13,"3,20"
19510,720575940626487677,right,Tm20,426,-3,0,3,-3,"-3,0"
19511,720575940631254156,right,Tm20,427,5,-18,-14,-4,"5,-18"
19512,720575940621711365,right,Tm20,428,-2,23,13,10,"-2,23"
19513,720575940623276938,right,Tm20,429,-2,14,9,5,"-2,14"
19514,720575940642663584,right,Tm20,430,-3,-7,-1,-6,"-3,-7"
19515,720575940627974406,right,Tm20,431,-2,-10,-3,-7,"-2,-10"
19516,720575940630310999,right,Tm20,432,-5,7,8,-1,"-5,7"
19517,720575940630869315,right,Tm20,433,0,-8,-4,-4,"0,-8"
19518,720575940633905038,right,Tm20,434,-3,7,6,1,"-3,7"
19519,720575940632344936,right,Tm20,435,5,-17,-14,-3,"5,-17"
19520,720575940625961509,right,Tm20,436,0,-15,-8,-7,"0,-15"
19521,720575940622883220,right,Tm20,437,-3,12,9,3,"-3,12"
19522,720575940636306424,right,Tm20,438,2,27,11,16,"2,27"
19523,720575940622968158,right,Tm20,439,-3,-9,-2,-7,"-3,-9"
19524,720575940618557248,right,Tm20,440,1,23,10,13,"1,23"
19525,720575940627901864,right,Tm20,441,3,-16,-11,-5,"3,-16"
19526,720575940638137151,right,Tm20,442,-5,25,17,8,"-5,25"
19527,720575940638811982,right,Tm20,443,-6,4,8,-4,"-6,4"
19528,720575940617842459,right,Tm20,444,4,-10,-9,-1,"4,-10"
19529,720575940612654632,right,Tm20,445,-2,8,6,2,"-2,8"
19530,720575940621137318,right,Tm20,446,2,-14,-9,-5,"2,-14"
19531,720575940619505902,right,Tm20,447,-1,2,2,0,"-1,2"
19532,720575940612673498,right,Tm20,448,0,30,15,15,"0,30"
19533,720575940616472507,right,Tm20,449,6,-16,-14,-2,"6,-16"
19534,720575940607670229,right,Tm20,450,2,-9,-7,-2,"2,-9"
19535,720575940630255324,right,Tm20,451,4,20,6,14,"4,20"
19536,720575940613072754,right,Tm20,452,1,-9,-6,-3,"1,-9"
19537,720575940622191393,right,Tm20,453,3,25,9,16,"3,25"
19538,720575940625241580,right,Tm20,454,5,-12,-11,-1,"5,-12"
19539,720575940631783747,right,Tm20,455,7,-7,-11,4,"7,-7"
19540,720575940634848151,right,Tm20,456,0,21,10,11,"0,21"
19541,720575940618517662,right,Tm20,457,-2,17,10,7,"-2,17"
19542,720575940620386031,right,Tm20,458,5,0,-5,5,"5,0"
19543,720575940604837344,right,Tm20,459,5,-3,-7,4,"5,-3"
19544,720575940618077725,right,Tm20,460,-3,-20,-7,-13,"-3,-20"
19545,720575940619432773,right,Tm20,461,7,-5,-10,5,"7,-5"
19546,720575940626487829,right,Tm20,462,-1,18,10,8,"-1,18"
19547,720575940632146828,right,Tm20,463,5,17,3,14,"5,17"
19548,720575940637124464,right,Tm20,464,4,0,-4,4,"4,0"
19549,720575940619873377,right,Tm20,465,3,0,-3,3,"3,0"
19550,720575940618528203,right,Tm20,466,1,14,6,8,"1,14"
19551,720575940630936151,right,Tm20,467,-2,-20,-8,-12,"-2,-20"
19552,720575940635715252,right,Tm20,468,-3,11,8,3,"-3,11"
19553,720575940616270619,right,Tm20,469,-7,13,13,0,"-7,13"
19554,720575940638175977,right,Tm20,470,4,-9,-9,0,"4,-9"
19555,720575940639571875,right,Tm20,471,3,-26,-16,-10,"3,-26"
19556,720575940617283899,right,Tm20,472,1,25,11,14,"1,25"
19557,720575940612635122,right,Tm20,473,-4,23,15,8,"-4,23"
19558,720575940629743738,right,Tm20,474,-3,-17,-6,-11,"-3,-17"
19559,720575940616063093,right,Tm20,475,-4,-1,3,-4,"-4,-1"
19560,720575940621319077,right,Tm20,476,-1,15,8,7,"-1,15"
19561,720575940622335114,right,Tm20,477,-3,2,4,-2,"-3,2"
19562,720575940612630642,right,Tm20,478,-7,16,15,1,"-7,16"
19563,720575940627567620,right,Tm20,479,-2,10,7,3,"-2,10"
19564,720575940633288032,right,Tm20,480,3,-19,-13,-6,"3,-19"
19565,720575940606502066,right,Tm20,481,4,-8,-8,0,"4,-8"
19566,720575940625696660,right,Tm20,482,1,17,7,10,"1,17"
19567,720575940624418045,right,Tm20,483,2,-7,-6,-1,"2,-7"
19568,720575940627158545,right,Tm20,484,3,-9,-8,-1,"3,-9"
19569,720575940612621590,right,Tm20,485,-3,-3,1,-4,"-3,-3"
19570,720575940632411556,right,Tm20,486,0,1,0,1,"0,1"
19571,720575940629828943,right,Tm20,487,1,-1,-2,1,"1,-1"
19572,720575940625379854,right,Tm20,488,7,5,-5,10,"7,5"
19573,720575940614274302,right,Tm20,489,-3,10,8,2,"-3,10"
19574,720575940616382258,right,Tm20,490,-5,6,8,-2,"-5,6"
19575,720575940628487440,right,Tm20,491,7,-1,-8,7,"7,-1"
19576,720575940614345110,right,Tm20,492,-7,-2,6,-8,"-7,-2"
19577,720575940617055062,right,Tm20,493,-3,23,14,9,"-3,23"
19578,720575940640395891,right,Tm20,494,0,29,14,15,"0,29"
19579,720575940621330414,right,Tm20,496,7,8,-3,11,"7,8"
19580,720575940625931045,right,Tm20,497,6,1,-6,7,"6,1"
19581,720575940623692326,right,Tm20,498,6,10,-1,11,"6,10"
19582,720575940630826106,right,Tm20,499,5,10,0,10,"5,10"
19583,720575940635554296,right,Tm20,500,7,-8,-11,3,"7,-8"
19584,720575940622021552,right,Tm20,501,1,2,0,2,"1,2"
19585,720575940610997060,right,Tm20,503,3,17,5,12,"3,17"
19586,720575940642182619,right,Tm20,504,-2,9,6,3,"-2,9"
19587,720575940623801343,right,Tm20,505,6,-22,-17,-5,"6,-22"
19588,720575940613436182,right,Tm20,506,1,-12,-7,-5,"1,-12"
19589,720575940630250711,right,Tm20,507,-5,-12,-1,-11,"-5,-12"
19590,720575940631332060,right,Tm20,508,-5,11,10,1,"-5,11"
19591,720575940634990746,right,Tm20,509,-4,10,9,1,"-4,10"
19592,720575940616918785,right,Tm20,510,-2,11,7,4,"-2,11"
19593,720575940616067378,right,Tm20,511,5,-11,-11,0,"5,-11"
19594,720575940628020303,right,Tm20,512,6,0,-6,6,"6,0"
19595,720575940617448029,right,Tm20,513,-4,-13,-3,-10,"-4,-13"
19596,720575940624309256,right,Tm20,514,-4,-10,-1,-9,"-4,-10"
19597,720575940633225676,right,Tm20,515,-8,-7,4,-11,"-8,-7"
19598,720575940626976664,right,Tm20,516,7,-18,-16,-2,"7,-18"
19599,720575940621953797,right,Tm20,518,-4,22,15,7,"-4,22"
19600,720575940622066721,right,Tm20,519,-5,-5,2,-7,"-5,-5"
19601,720575940630084986,right,Tm20,520,-2,-22,-9,-13,"-2,-22"
19602,720575940614615362,right,Tm20,521,6,-9,-11,2,"6,-9"
19603,720575940629190343,right,Tm20,522,-4,0,4,-4,"-4,0"
19604,720575940634015630,right,Tm20,523,2,14,5,9,"2,14"
19605,720575940625267640,right,Tm20,524,4,-20,-14,-6,"4,-20"
19606,720575940623495364,right,Tm20,525,-1,-20,-9,-11,"-1,-20"
19607,720575940627401353,right,Tm20,526,0,-10,-5,-5,"0,-10"
19608,720575940645581166,right,Tm20,527,-4,-8,0,-8,"-4,-8"
19609,720575940631595660,right,Tm20,529,2,-2,-3,1,"2,-2"
19610,720575940656115105,right,Tm20,530,-3,-13,-4,-9,"-3,-13"
19611,720575940622382964,right,Tm20,531,1,0,-1,1,"1,0"
19612,720575940636556004,right,Tm20,532,-8,7,11,-4,"-8,7"
19613,720575940618936645,right,Tm20,533,0,-16,-8,-8,"0,-16"
19614,720575940627024536,right,Tm20,534,3,2,-2,4,"3,2"
19615,720575940615403231,right,Tm20,535,8,-4,-10,6,"8,-4"
19616,720575940628275528,right,Tm20,536,3,4,-1,5,"3,4"
19617,720575940609355054,right,Tm20,537,0,-23,-12,-11,"0,-23"
19618,720575940631305676,right,Tm20,538,-4,1,4,-3,"-4,1"
19619,720575940619717717,right,Tm20,539,-6,15,13,2,"-6,15"
19620,720575940614416815,right,Tm20,540,-2,-9,-3,-6,"-2,-9"
19621,720575940642290421,right,Tm20,541,-4,14,11,3,"-4,14"
19622,720575940624883388,right,Tm20,542,6,-13,-13,0,"6,-13"
19623,720575940610524099,right,Tm20,543,-1,-4,-1,-3,"-1,-4"
19624,720575940632080170,right,Tm20,544,3,-13,-10,-3,"3,-13"
19625,720575940630821676,right,Tm20,545,5,11,0,11,"5,11"
19626,720575940624682167,right,Tm20,547,-1,21,11,10,"-1,21"
19627,720575940631624515,right,Tm20,548,1,-16,-9,-7,"1,-16"
19628,720575940603915436,right,Tm20,549,0,-9,-5,-4,"0,-9"
19629,720575940648459652,right,Tm20,550,-2,3,3,0,"-2,3"
19630,720575940618201371,right,Tm20,551,-4,-9,-1,-8,"-4,-9"
19631,720575940616970838,right,Tm20,552,4,-1,-5,4,"4,-1"
19632,720575940626553231,right,Tm20,553,-3,16,11,5,"-3,16"
19633,720575940618381515,right,Tm20,554,-9,-3,7,-10,"-9,-3"
19634,720575940643505312,right,Tm20,555,-4,9,8,1,"-4,9"
19635,720575940631575338,right,Tm20,556,0,10,5,5,"0,10"
19636,720575940616338619,right,Tm20,557,6,-10,-11,1,"6,-10"
19637,720575940615084719,right,Tm20,558,-4,-21,-7,-14,"-4,-21"
19638,720575940631801642,right,Tm20,559,-6,22,17,5,"-6,22"
19639,720575940626735209,right,Tm20,560,-7,14,14,0,"-7,14"
19640,720575940619748517,right,Tm20,562,-5,-2,4,-6,"-5,-2"
19641,720575940627565650,right,Tm20,563,5,-13,-12,-1,"5,-13"
19642,720575940630159916,right,Tm20,564,3,-23,-15,-8,"3,-23"
19643,720575940620597208,right,Tm20,565,0,-26,-13,-13,"0,-26"
19644,720575940622050726,right,Tm20,566,5,-8,-9,1,"5,-8"
19645,720575940618417477,right,Tm20,567,-2,22,13,9,"-2,22"
19646,720575940617332258,right,Tm20,568,-6,-8,2,-10,"-6,-8"
19647,720575940660273537,right,Tm20,570,2,25,10,15,"2,25"
19648,720575940632501034,right,Tm20,571,0,-14,-7,-7,"0,-14"
19649,720575940639205464,right,Tm20,572,-8,3,9,-6,"-8,3"
19650,720575940628586737,right,Tm20,573,4,14,3,11,"4,14"
19651,720575940621253708,right,Tm20,574,-6,5,8,-3,"-6,5"
19652,720575940646273902,right,Tm20,576,0,28,14,14,"0,28"
19653,720575940635181978,right,Tm20,577,5,-14,-12,-2,"5,-14"
19654,720575940628809259,right,Tm20,578,4,-11,-10,-1,"4,-11"
19655,720575940627262553,right,Tm20,579,-3,-10,-2,-8,"-3,-10"
19656,720575940652519926,right,Tm20,580,-2,-23,-10,-13,"-2,-23"
19657,720575940616031903,right,Tm20,582,-1,23,12,11,"-1,23"
19658,720575940619782054,right,Tm20,583,3,-25,-16,-9,"3,-25"
19659,720575940629465047,right,Tm20,584,4,23,7,16,"4,23"
19660,720575940621819980,right,Tm20,585,-1,-23,-11,-12,"-1,-23"
19661,720575940622360188,right,Tm20,586,2,18,7,11,"2,18"
19662,720575940622928739,right,Tm20,587,4,22,7,15,"4,22"
19663,720575940632326370,right,Tm20,588,1,4,1,3,"1,4"
19664,720575940606553289,right,Tm20,589,-1,-5,-2,-3,"-1,-5"
19665,720575940630371287,right,Tm20,590,1,9,3,6,"1,9"
19666,720575940635204759,right,Tm20,591,3,-3,-5,2,"3,-3"
19667,720575940614301905,right,Tm20,593,3,-14,-10,-4,"3,-14"
19668,720575940611892885,right,Tm20,594,7,-16,-15,-1,"7,-16"
19669,720575940634178771,right,Tm20,595,7,-12,-13,1,"7,-12"
19670,720575940604721376,right,Tm20,596,-4,-16,-4,-12,"-4,-16"
19671,720575940628398441,right,Tm20,597,4,1,-4,5,"4,1"
19672,720575940616970713,right,Tm20,598,2,-18,-11,-7,"2,-18"
19673,720575940646888500,right,Tm20,599,-1,9,5,4,"-1,9"
19674,720575940619037972,right,Tm20,600,3,-10,-8,-2,"3,-10"
19675,720575940635758746,right,Tm20,601,1,16,7,9,"1,16"
19676,720575940624058119,right,Tm20,602,4,-2,-5,3,"4,-2"
19677,720575940615096231,right,Tm20,603,-3,-23,-9,-14,"-3,-23"
19678,720575940624840179,right,Tm20,604,-6,-17,-3,-14,"-6,-17"
19679,720575940618985630,right,Tm20,605,3,15,4,11,"3,15"
19680,720575940625945843,right,Tm20,606,-1,-19,-9,-10,"-1,-19"
19681,720575940636804442,right,Tm20,607,1,18,8,10,"1,18"
19682,720575940617320379,right,Tm20,608,1,10,4,6,"1,10"
19683,720575940624932282,right,Tm20,609,-2,0,2,-2,"-2,0"
19684,720575940620011736,right,Tm20,610,2,-23,-14,-9,"2,-23"
19685,720575940632266538,right,Tm20,611,-1,-18,-8,-10,"-1,-18"
19686,720575940606290121,right,Tm20,614,-2,-8,-2,-6,"-2,-8"
19687,720575940611363426,right,Tm20,615,-7,-7,3,-10,"-7,-7"
19688,720575940630391162,right,Tm20,616,-3,15,10,5,"-3,15"
19689,720575940640275773,right,Tm20,617,-2,-17,-7,-10,"-2,-17"
19690,720575940624924600,right,Tm20,618,-1,24,13,11,"-1,24"
19691,720575940625144624,right,Tm20,619,-4,-19,-6,-13,"-4,-19"
19692,720575940621849699,right,Tm20,620,7,1,-7,8,"7,1"
19693,720575940640755408,right,Tm20,621,1,24,11,13,"1,24"
19694,720575940643245335,right,Tm20,622,-5,20,15,5,"-5,20"
19695,720575940637035918,right,Tm20,623,1,13,5,8,"1,13"
19696,720575940629820571,right,Tm20,624,1,-17,-10,-7,"1,-17"
19697,720575940633491342,right,Tm20,625,-2,24,14,10,"-2,24"
19698,720575940639183549,right,Tm20,626,-5,-8,1,-9,"-5,-8"
19699,720575940626395394,right,Tm20,627,0,-1,-1,0,"0,-1"
19700,720575940629062555,right,Tm20,628,0,0,0,0,"0,0"
19701,720575940617859677,right,Tm20,630,4,8,0,8,"4,8"
19702,720575940620496331,right,Tm20,631,1,26,12,14,"1,26"
19703,720575940624643336,right,Tm20,632,3,-20,-13,-7,"3,-20"
19704,720575940623832781,right,Tm20,633,-1,-24,-11,-13,"-1,-24"
19705,720575940639434566,right,Tm20,634,-3,-15,-5,-10,"-3,-15"
19706,720575940620011467,right,Tm20,635,6,-6,-9,3,"6,-6"
19707,720575940628402760,right,Tm20,636,0,6,3,3,"0,6"
19708,720575940620913232,right,Tm20,637,3,-21,-14,-7,"3,-21"
19709,720575940633593057,right,Tm20,638,-1,7,4,3,"-1,7"
19710,720575940625838885,right,Tm20,639,-4,19,13,6,"-4,19"
19711,720575940619043156,right,Tm20,640,-1,-16,-7,-9,"-1,-16"
19712,720575940615857631,right,Tm20,641,-8,-5,5,-10,"-8,-5"
19713,720575940636564622,right,Tm20,642,-5,-11,-1,-10,"-5,-11"
19714,720575940612116337,right,Tm20,643,6,14,1,13,"6,14"
19715,720575940625879433,right,Tm20,644,-6,18,15,3,"-6,18"
19716,720575940622740999,right,Tm20,645,-4,27,17,10,"-4,27"
19717,720575940642264461,right,Tm20,646,6,17,2,15,"6,17"
19718,720575940630236375,right,Tm20,647,-4,-7,0,-7,"-4,-7"
19719,720575940635070911,right,Tm20,648,1,7,2,5,"1,7"
19720,720575940621601926,right,Tm20,650,-3,-25,-10,-15,"-3,-25"
19721,720575940630833093,right,Tm20,651,-4,-5,1,-6,"-4,-5"
19722,720575940629339756,right,Tm20,652,-6,-11,0,-11,"-6,-11"
19723,720575940617727389,right,Tm20,654,-3,8,7,1,"-3,8"
19724,720575940645114647,right,Tm20,655,6,-1,-7,6,"6,-1"
19725,720575940627464734,right,Tm20,656,0,-11,-6,-5,"0,-11"
19726,720575940635237271,right,Tm20,657,-2,-25,-11,-14,"-2,-25"
19727,720575940620404389,right,Tm20,658,1,20,9,11,"1,20"
19728,720575940609098965,right,Tm20,659,-4,-6,1,-7,"-4,-6"
19729,720575940637859246,right,Tm20,661,-3,14,10,4,"-3,14"
19730,720575940620908368,right,Tm20,662,2,-1,-3,2,"2,-1"
19731,720575940620306452,right,Tm20,664,1,-27,-15,-12,"1,-27"
19732,720575940618681920,right,Tm20,665,7,-2,-8,6,"7,-2"
19733,720575940630948695,right,Tm20,666,7,-13,-14,1,"7,-13"
19734,720575940610937646,right,Tm20,667,1,-28,-15,-13,"1,-28"
19735,720575940622947401,right,Tm20,668,1,19,8,11,"1,19"
19736,720575940622743646,right,Tm20,669,4,-16,-12,-4,"4,-16"
19737,720575940618446912,right,Tm20,671,-4,-23,-8,-15,"-4,-23"
19738,720575940612366061,right,Tm20,672,-8,11,13,-2,"-8,11"
19739,720575940605924320,right,Tm20,674,-4,-14,-3,-11,"-4,-14"
19740,720575940620139467,right,Tm20,675,-7,19,16,3,"-7,19"
19741,720575940620650155,right,Tm20,678,3,-7,-7,0,"3,-7"
19742,720575940618881694,right,Tm20,679,4,18,5,13,"4,18"
19743,720575940634809696,right,Tm20,680,-1,25,13,12,"-1,25"
19744,720575940610911864,right,Tm20,681,-2,-21,-9,-12,"-2,-21"
19745,720575940643897760,right,Tm20,682,6,-8,-10,2,"6,-8"
19746,720575940615005590,right,Tm20,684,-6,17,14,3,"-6,17"
19747,720575940615567682,right,Tm20,685,-5,-9,0,-9,"-5,-9"
19748,720575940616579487,right,Tm20,686,5,-22,-16,-6,"5,-22"
19749,720575940618718288,right,Tm20,687,-6,-3,4,-7,"-6,-3"
19750,720575940613141466,right,Tm20,688,-7,10,12,-2,"-7,10"
19751,720575940614563734,right,Tm20,689,-2,18,11,7,"-2,18"
19752,720575940610029870,right,Tm20,690,-7,-3,5,-8,"-7,-3"
19753,720575940629431314,right,Tm20,691,-9,4,11,-7,"-9,4"
19754,720575940626043180,right,Tm20,692,-4,24,16,8,"-4,24"
19755,720575940623508627,right,Tm20,693,-3,25,15,10,"-3,25"
19756,720575940628824835,right,Tm20,695,-6,10,11,-1,"-6,10"
19757,720575940625629844,right,Tm20,696,-2,16,10,6,"-2,16"
19758,720575940638007898,right,Tm20,697,1,-22,-12,-10,"1,-22"
19759,720575940646696227,right,Tm20,698,6,-7,-10,3,"6,-7"
19760,720575940620104059,right,Tm20,699,-5,0,5,-5,"-5,0"
19761,720575940625882768,right,Tm20,700,5,15,2,13,"5,15"
19762,720575940631375435,right,Tm20,701,0,-4,-2,-2,"0,-4"
19763,720575940627315845,right,Tm20,702,-5,23,16,7,"-5,23"
19764,720575940624338215,right,Tm20,703,-3,1,3,-2,"-3,1"
19765,720575940625044716,right,Tm20,704,-7,8,11,-3,"-7,8"
19766,720575940622478836,right,Tm20,705,1,1,-1,2,"1,1"
19767,720575940649752441,right,Tm20,707,-2,25,14,11,"-2,25"
19768,720575940624453268,right,Tm20,709,-2,-24,-10,-14,"-2,-24"
19769,720575940625606328,right,Tm20,710,4,-25,-17,-8,"4,-25"
19770,720575940623368547,right,Tm20,711,-1,19,10,9,"-1,19"
19771,720575940620812880,right,Tm20,712,-7,12,13,-1,"-7,12"
19772,720575940631404239,right,Tm20,713,-6,16,14,2,"-6,16"
19773,720575940610675064,right,Tm20,714,5,12,1,11,"5,12"
19774,720575940619828603,right,Tm20,715,4,10,1,9,"4,10"
19775,720575940639409998,right,Tm20,716,4,-6,-7,1,"4,-6"
19776,720575940620854766,right,Tm20,717,2,-22,-13,-9,"2,-22"
19777,720575940614082867,right,Tm20,718,-5,24,17,7,"-5,24"
19778,720575940621064052,right,Tm20,719,1,27,12,15,"1,27"
19779,720575940624412651,right,Tm20,720,-5,21,15,6,"-5,21"
19780,720575940617951316,right,Tm20,721,5,13,1,12,"5,13"
19781,720575940612663722,right,Tm20,722,6,-15,-14,-1,"6,-15"
19782,720575940627404053,right,Tm20,723,-2,-11,-4,-7,"-2,-11"
19783,720575940623788031,right,Tm20,724,4,2,-3,5,"4,2"
19784,720575940626185104,right,Tm20,725,-3,-24,-9,-15,"-3,-24"
19785,720575940646790532,right,Tm20,728,7,12,-1,13,"7,12"
19786,720575940616937589,right,Tm20,729,-3,29,17,12,"-3,29"
19787,720575940623115363,right,Tm20,730,7,0,-7,7,"7,0"
19788,720575940635380079,right,Tm20,731,-6,9,10,-1,"-6,9"
19789,720575940619659093,right,Tm20,732,-3,6,6,0,"-3,6"
19790,720575940620581766,right,Tm20,733,-5,-17,-4,-13,"-5,-17"
19791,720575940635520608,right,Tm20,734,2,0,-2,2,"2,0"
19792,720575940625177628,right,Tm20,735,1,-23,-13,-10,"1,-23"
19793,720575940624208520,right,Tm20,736,-8,1,8,-7,"-8,1"
19794,720575940622508876,right,Tm20,737,0,19,9,10,"0,19"
19795,720575940626973053,right,Tm20,738,-3,13,9,4,"-3,13"
19796,720575940620305334,right,Tm20,739,-7,2,8,-6,"-7,2"
19797,720575940644697124,right,Tm20,740,2,-8,-6,-2,"2,-8"
19798,720575940630761979,right,Tm20,741,-2,-14,-5,-9,"-2,-14"
19799,720575940620047124,right,Tm20,742,-4,11,9,2,"-4,11"
19800,720575940604711392,right,Tm20,744,-4,25,16,9,"-4,25"
19801,720575940630669568,right,Tm20,745,0,13,6,7,"0,13"
19802,720575940619604534,right,Tm20,746,-3,3,4,-1,"-3,3"
19803,720575940624008373,right,Tm20,747,0,2,1,1,"0,2"
19804,720575940635371662,right,Tm20,748,-4,20,14,6,"-4,20"
19805,720575940606851761,right,Tm20,749,-2,1,2,-1,"-2,1"
19806,720575940627894088,right,Tm20,750,4,-24,-16,-8,"4,-24"
19807,720575940616011882,right,Tm20,751,1,6,2,4,"1,6"
19808,720575940653269238,right,Tm20,752,-2,7,5,2,"-2,7"
19809,720575940610480248,right,Tm20,753,-3,24,15,9,"-3,24"
19810,720575940626329893,right,Tm20,754,-1,-13,-6,-7,"-1,-13"
19811,720575940631751215,right,Tm20,755,4,19,5,14,"4,19"
19812,720575940628475048,right,Tm20,756,5,20,5,15,"5,20"
19813,720575940607223218,right,Tm20,757,0,-6,-3,-3,"0,-6"
19814,720575940620705886,right,Tm20,758,5,-1,-6,5,"5,-1"
19815,720575940625198315,right,Tm20,759,7,14,0,14,"7,14"
19816,720575940619781729,right,Tm20,760,0,17,8,9,"0,17"
19817,720575940628677137,right,Tm20,762,0,14,7,7,"0,14"
19818,720575940618547649,right,Tm20,763,-5,14,12,2,"-5,14"
19819,720575940634177250,right,Tm20,764,-8,-6,5,-11,"-8,-6"
19820,720575940613277165,right,Tm20,765,-3,9,7,2,"-3,9"
19821,720575940622092253,right,Tm20,766,2,-4,-4,0,"2,-4"
19822,720575940618512197,right,Tm20,767,1,28,13,15,"1,28"
19823,720575940622217904,right,Tm20,769,4,-27,-18,-9,"4,-27"
19824,720575940645973015,right,Tm20,771,3,-27,-17,-10,"3,-27"
19825,720575940632269639,right,Tm20,772,1,12,5,7,"1,12"
19826,720575940638073919,right,Tm20,773,5,-19,-15,-4,"5,-19"
19827,720575940604529580,right,Tm20,774,-8,6,11,-5,"-8,6"
19828,720575940629059287,right,Tm20,775,5,22,6,16,"5,22"
19829,720575940609233163,right,Tm20,776,5,21,5,16,"5,21"
19830,720575940628973130,right,Tm20,777,6,20,4,16,"6,20"
19831,720575940627781019,right,Tm20,778,4,25,8,17,"4,25"
19832,720575940624151492,right,Tm20,779,5,24,7,17,"5,24"
19833,720575940618051001,right,Tm20,780,-6,25,18,7,"-6,25"
19834,720575940614361263,right,Tm20,781,-5,26,18,8,"-5,26"
19835,720575940618345217,right,Tm20,783,-4,28,18,10,"-4,28"
19836,720575940626878210,right,Tm20,784,-4,29,18,11,"-4,29"
19837,720575940631567045,right,Tm20,785,-3,30,18,12,"-3,30"
19838,720575940628335432,right,Tm20,786,-2,30,17,13,"-2,30"
19839,720575940641502928,right,Tm20,787,3,28,11,17,"3,28"
19840,720575940640469107,right,Tm20,788,3,27,10,17,"3,27"
19841,720575940631237420,right,Tm20,789,-3,-27,-11,-16,"-3,-27"
19842,720575940638654271,right,Tm20,791,-1,-28,-13,-15,"-1,-28"
19843,720575940616399666,right,Tm20,792,8,2,-7,9,"8,2"
19844,720575940633332947,right,Tm20,793,8,-6,-11,5,"8,-6"
19845,720575940623125372,right,Tm20,794,5,-26,-18,-8,"5,-26"
19846,720575940629819845,right,Tm20,795,6,-21,-17,-4,"6,-21"
19847,720575940632791087,right,Tm20,796,4,26,9,17,"4,26"
19848,720575940618758278,right,Tm21,1,-6,13,12,1,"-6,13"
19849,720575940638837582,right,Tm21,2,-8,2,9,-7,"-8,2"
19850,720575940623713003,right,Tm21,3,6,-12,-12,0,"6,-12"
19851,720575940629578746,right,Tm21,6,-2,-4,0,-4,"-2,-4"
19852,720575940631367439,right,Tm21,7,-6,-6,3,-9,"-6,-6"
19853,720575940614781330,right,Tm21,8,-4,26,17,9,"-4,26"
19854,720575940643866784,right,Tm21,9,4,9,0,9,"4,9"
19855,720575940631691624,right,Tm21,10,5,-15,-13,-2,"5,-15"
19856,720575940627311887,right,Tm21,11,7,-14,-14,0,"7,-14"
19857,720575940646213667,right,Tm21,12,-7,9,11,-2,"-7,9"
19858,720575940623130381,right,Tm21,13,-1,-26,-12,-14,"-1,-26"
19859,720575940621616054,right,Tm21,14,0,-27,-14,-13,"0,-27"
19860,720575940623897744,right,Tm21,15,2,-3,-4,1,"2,-3"
19861,720575940617225019,right,Tm21,16,-2,-16,-6,-10,"-2,-16"
19862,720575940621398182,right,Tm21,17,1,-5,-4,-1,"1,-5"
19863,720575940605680998,right,Tm21,18,5,-16,-13,-3,"5,-16"
19864,720575940616545437,right,Tm21,19,-7,17,15,2,"-7,17"
19865,720575940620460679,right,Tm21,21,-2,19,11,8,"-2,19"
19866,720575940615057420,right,Tm21,22,-1,3,2,1,"-1,3"
19867,720575940625672935,right,Tm21,23,-3,-16,-5,-11,"-3,-16"
19868,720575940635682808,right,Tm21,24,-1,-10,-4,-6,"-1,-10"
19869,720575940624164133,right,Tm21,25,-9,3,10,-7,"-9,3"
19870,720575940628458001,right,Tm21,26,1,-3,-3,0,"1,-3"
19871,720575940624875751,right,Tm21,27,0,-25,-13,-12,"0,-25"
19872,720575940625812880,right,Tm21,29,-1,-3,-1,-2,"-1,-3"
19873,720575940647925124,right,Tm21,30,6,16,2,14,"6,16"
19874,720575940634158361,right,Tm21,31,0,16,8,8,"0,16"
19875,720575940615408039,right,Tm21,32,0,12,6,6,"0,12"
19876,720575940659444865,right,Tm21,33,3,18,6,12,"3,18"
19877,720575940627780229,right,Tm21,35,1,-24,-13,-11,"1,-24"
19878,720575940647336739,right,Tm21,38,0,-2,-1,-1,"0,-2"
19879,720575940638310197,right,Tm21,39,0,20,10,10,"0,20"
19880,720575940619832661,right,Tm21,40,-2,-6,-1,-5,"-2,-6"
19881,720575940620712784,right,Tm21,41,-3,28,17,11,"-3,28"
19882,720575940617953537,right,Tm21,42,-1,14,8,6,"-1,14"
19883,720575940632308025,right,Tm21,44,5,-10,-10,0,"5,-10"
19884,720575940627217393,right,Tm21,46,-5,15,12,3,"-5,15"
19885,720575940612129522,right,Tm21,47,-9,-1,8,-9,"-9,-1"
19886,720575940612142834,right,Tm21,48,-4,-22,-7,-15,"-4,-22"
19887,720575940632688804,right,Tm21,49,4,-4,-6,2,"4,-4"
19888,720575940613175666,right,Tm21,50,-2,21,12,9,"-2,21"
19889,720575940613222809,right,Tm21,51,0,-19,-10,-9,"0,-19"
19890,720575940612548325,right,Tm21,52,-1,-22,-10,-12,"-1,-22"
19891,720575940630275900,right,Tm21,53,5,14,2,12,"5,14"
19892,720575940629814138,right,Tm21,54,-4,3,5,-2,"-4,3"
19893,720575940621281729,right,Tm21,55,-4,-11,-2,-9,"-4,-11"
19894,720575940639204029,right,Tm21,56,1,-13,-8,-5,"1,-13"
19895,720575940611493490,right,Tm21,57,6,-11,-12,1,"6,-11"
19896,720575940653226998,right,Tm21,58,3,12,3,9,"3,12"
19897,720575940622264810,right,Tm21,59,-2,2,3,-1,"-2,2"
19898,720575940626825744,right,Tm21,60,-8,8,12,-4,"-8,8"
19899,720575940620314864,right,Tm21,61,-4,-4,2,-6,"-4,-4"
19900,720575940625653235,right,Tm21,62,0,-29,-15,-14,"0,-29"
19901,720575940613797357,right,Tm21,63,4,12,2,10,"4,12"
19902,720575940626626588,right,Tm21,64,4,-23,-16,-7,"4,-23"
19903,720575940629724519,right,Tm21,65,-1,28,15,13,"-1,28"
19904,720575940631403282,right,Tm21,66,2,15,5,10,"2,15"
19905,720575940606908849,right,Tm21,67,-2,-13,-5,-8,"-2,-13"
19906,720575940629394075,right,Tm21,68,3,16,5,11,"3,16"
19907,720575940638200895,right,Tm21,69,1,8,3,5,"1,8"
19908,720575940624809876,right,Tm21,70,-4,21,14,7,"-4,21"
19909,720575940625160200,right,Tm21,71,-2,-3,0,-3,"-2,-3"
19910,720575940624323219,right,Tm21,73,2,2,-1,3,"2,2"
19911,720575940620935360,right,Tm21,74,-1,-9,-4,-5,"-1,-9"
19912,720575940642126989,right,Tm21,75,-6,14,13,1,"-6,14"
19913,720575940624762260,right,Tm21,76,-3,-4,1,-5,"-3,-4"
19914,720575940608112139,right,Tm21,77,2,-5,-5,0,"2,-5"
19915,720575940625848464,right,Tm21,78,2,20,8,12,"2,20"
19916,720575940631328727,right,Tm21,79,2,1,-2,3,"2,1"
19917,720575940632636975,right,Tm21,80,4,13,2,11,"4,13"
19918,720575940633199943,right,Tm21,81,6,-2,-7,5,"6,-2"
19919,720575940613326829,right,Tm21,82,-7,7,10,-3,"-7,7"
19920,720575940622085033,right,Tm21,83,2,-21,-13,-8,"2,-21"
19921,720575940631698447,right,Tm21,84,-2,12,8,4,"-2,12"
19922,720575940627732818,right,Tm21,85,4,-22,-15,-7,"4,-22"
19923,720575940623037208,right,Tm21,86,-5,-7,1,-8,"-5,-7"
19924,720575940607060354,right,Tm21,87,1,11,4,7,"1,11"
19925,720575940621628038,right,Tm21,89,1,-19,-11,-8,"1,-19"
19926,720575940625508843,right,Tm21,90,-4,5,6,-1,"-4,5"
19927,720575940624025187,right,Tm21,91,-1,6,4,2,"-1,6"
19928,720575940628035861,right,Tm21,93,-6,3,7,-4,"-6,3"
19929,720575940624955406,right,Tm21,94,5,18,4,14,"5,18"
19930,720575940630675706,right,Tm21,95,4,-21,-15,-6,"4,-21"
19931,720575940635853675,right,Tm21,97,-5,2,6,-4,"-5,2"
19932,720575940624725140,right,Tm21,98,-1,-12,-5,-7,"-1,-12"
19933,720575940615838826,right,Tm21,99,4,15,3,12,"4,15"
19934,720575940616496385,right,Tm21,100,2,-10,-7,-3,"2,-10"
19935,720575940628787564,right,Tm21,101,-7,6,10,-4,"-7,6"
19936,720575940627924220,right,Tm21,105,3,22,8,14,"3,22"
19937,720575940630387169,right,Tm21,106,-7,11,12,-1,"-7,11"
19938,720575940630057035,right,Tm21,108,-3,-12,-3,-9,"-3,-12"
19939,720575940627274767,right,Tm21,109,4,-5,-7,2,"4,-5"
19940,720575940620705556,right,Tm21,110,-7,0,7,-7,"-7,0"
19941,720575940615702239,right,Tm21,111,2,-24,-14,-10,"2,-24"
19942,720575940638788686,right,Tm21,112,-6,1,6,-5,"-6,1"
19943,720575940646482308,right,Tm21,113,-2,4,4,0,"-2,4"
19944,720575940645585204,right,Tm21,114,2,-13,-9,-4,"2,-13"
19945,720575940622473174,right,Tm21,115,-4,2,5,-3,"-4,2"
19946,720575940632931615,right,Tm21,116,-1,-8,-3,-5,"-1,-8"
19947,720575940616548923,right,Tm21,117,-8,-2,7,-9,"-8,-2"
19948,720575940620597163,right,Tm21,118,3,1,-3,4,"3,1"
19949,720575940619306325,right,Tm21,119,-2,6,5,1,"-2,6"
19950,720575940611411698,right,Tm21,120,-1,-1,0,-1,"-1,-1"
19951,720575940627430087,right,Tm21,121,-8,4,10,-6,"-8,4"
19952,720575940629910844,right,Tm21,122,-5,9,9,0,"-5,9"
19953,720575940626171880,right,Tm21,123,-8,10,13,-3,"-8,10"
19954,720575940613121706,right,Tm21,124,1,-7,-5,-2,"1,-7"
19955,720575940631273676,right,Tm21,127,0,15,7,8,"0,15"
19956,720575940627431301,right,Tm21,128,3,-22,-14,-8,"3,-22"
19957,720575940626886552,right,Tm21,129,0,-13,-7,-6,"0,-13"
19958,720575940621117360,right,Tm21,130,2,12,4,8,"2,12"
19959,720575940618282576,right,Tm21,131,-6,20,16,4,"-6,20"
19960,720575940631276047,right,Tm21,132,2,4,0,4,"2,4"
19961,720575940629638594,right,Tm21,133,-3,20,13,7,"-3,20"
19962,720575940620861121,right,Tm21,134,-5,-18,-4,-14,"-5,-18"
19963,720575940632432866,right,Tm21,135,-3,-22,-8,-14,"-3,-22"
19964,720575940621656602,right,Tm21,137,5,-7,-9,2,"5,-7"
19965,720575940643797664,right,Tm21,138,0,27,13,14,"0,27"
19966,720575940631524111,right,Tm21,139,1,-14,-8,-6,"1,-14"
19967,720575940640746867,right,Tm21,140,3,8,1,7,"3,8"
19968,720575940622156031,right,Tm21,142,-2,-18,-7,-11,"-2,-18"
19969,720575940638901456,right,Tm21,143,-4,16,12,4,"-4,16"
19970,720575940625458958,right,Tm21,146,1,-6,-4,-2,"1,-6"
19971,720575940628445000,right,Tm21,147,1,21,9,12,"1,21"
19972,720575940615497026,right,Tm21,149,6,-14,-13,-1,"6,-14"
19973,720575940628071162,right,Tm21,150,-8,5,10,-5,"-8,5"
19974,720575940615016598,right,Tm21,151,-3,-14,-4,-10,"-3,-14"
19975,720575940631689723,right,Tm21,154,-8,0,8,-8,"-8,0"
19976,720575940622616712,right,Tm21,156,-9,1,9,-8,"-9,1"
19977,720575940629892668,right,Tm21,157,-1,-7,-3,-4,"-1,-7"
19978,720575940622918911,right,Tm21,158,3,-5,-6,1,"3,-5"
19979,720575940628815207,right,Tm21,160,-2,20,12,8,"-2,20"
19980,720575940622457037,right,Tm21,162,-4,-2,3,-5,"-4,-2"
19981,720575940617414237,right,Tm21,164,-1,-2,0,-2,"-1,-2"
19982,720575940649870713,right,Tm21,165,4,16,4,12,"4,16"
19983,720575940631779651,right,Tm21,166,0,18,9,9,"0,18"
19984,720575940624741524,right,Tm21,167,0,-17,-9,-8,"0,-17"
19985,720575940605278636,right,Tm21,168,-1,17,9,8,"-1,17"
19986,720575940624948467,right,Tm21,170,-5,1,5,-4,"-5,1"
19987,720575940619748372,right,Tm21,171,6,-20,-16,-4,"6,-20"
19988,720575940622409571,right,Tm21,172,1,22,10,12,"1,22"
19989,720575940641638107,right,Tm21,173,2,-25,-15,-10,"2,-25"
19990,720575940612335090,right,Tm21,174,4,-15,-12,-3,"4,-15"
19991,720575940612734358,right,Tm21,175,-6,-7,2,-9,"-6,-7"
19992,720575940638482254,right,Tm21,177,-2,-1,1,-2,"-2,-1"
19993,720575940613390250,right,Tm21,178,2,11,3,8,"2,11"
19994,720575940629545744,right,Tm21,179,-5,-16,-3,-13,"-5,-16"
19995,720575940626693776,right,Tm21,181,1,-4,-3,-1,"1,-4"
19996,720575940614222334,right,Tm21,182,7,-10,-12,2,"7,-10"
19997,720575940637176944,right,Tm21,183,-5,-15,-3,-12,"-5,-15"
19998,720575940606208713,right,Tm21,184,-6,-5,3,-8,"-6,-5"
19999,720575940618141780,right,Tm21,185,2,-11,-8,-3,"2,-11"
20000,720575940627681864,right,Tm21,186,-1,26,14,12,"-1,26"
20001,720575940623628076,right,Tm21,187,3,21,7,14,"3,21"
20002,720575940628660329,right,Tm21,188,-5,17,13,4,"-5,17"
20003,720575940630356193,right,Tm21,189,6,13,0,13,"6,13"
20004,720575940625603002,right,Tm21,190,-3,-5,0,-5,"-3,-5"
20005,720575940612524202,right,Tm21,191,-1,-11,-5,-6,"-1,-11"
20006,720575940622133286,right,Tm21,193,-5,4,7,-3,"-5,4"
20007,720575940615195202,right,Tm21,194,0,-5,-3,-2,"0,-5"
20008,720575940621232237,right,Tm21,195,-3,-1,2,-3,"-3,-1"
20009,720575940650476409,right,Tm21,196,-1,8,5,3,"-1,8"
20010,720575940626606026,right,Tm21,197,0,-20,-10,-10,"0,-20"
20011,720575940630815051,right,Tm21,199,0,-12,-6,-6,"0,-12"
20012,720575940613598354,right,Tm21,200,-5,12,11,1,"-5,12"
20013,720575940631579500,right,Tm21,202,-1,27,14,13,"-1,27"
20014,720575940632804397,right,Tm21,203,3,-1,-4,3,"3,-1"
20015,720575940622873768,right,Tm21,205,5,-6,-8,2,"5,-6"
20016,720575940621546432,right,Tm21,206,-3,5,5,0,"-3,5"
20017,720575940626709797,right,Tm21,208,5,-21,-16,-5,"5,-21"
20018,720575940627820175,right,Tm21,209,-3,-8,-1,-7,"-3,-8"
20019,720575940632065839,right,Tm21,210,-6,8,10,-2,"-6,8"
20020,720575940622122334,right,Tm21,211,-7,-1,6,-7,"-7,-1"
20021,720575940617125947,right,Tm21,212,2,-16,-10,-6,"2,-16"
20022,720575940624423655,right,Tm21,213,3,-4,-5,1,"3,-4"
20023,720575940621851626,right,Tm21,214,-5,3,6,-3,"-5,3"
20024,720575940609791171,right,Tm21,215,6,7,-3,10,"6,7"
20025,720575940620515009,right,Tm21,216,2,19,7,12,"2,19"
20026,720575940624900851,right,Tm21,218,2,10,3,7,"2,10"
20027,720575940622648541,right,Tm21,219,6,-4,-8,4,"6,-4"
20028,720575940620282550,right,Tm21,220,2,-6,-5,-1,"2,-6"
20029,720575940615415157,right,Tm21,221,-7,3,8,-5,"-7,3"
20030,720575940617942356,right,Tm21,222,-3,26,16,10,"-3,26"
20031,720575940627123081,right,Tm21,226,5,19,4,15,"5,19"
20032,720575940627763016,right,Tm21,227,-7,5,9,-4,"-7,5"
20033,720575940626171261,right,Tm21,228,-7,1,7,-6,"-7,1"
20034,720575940618497093,right,Tm21,231,4,-12,-10,-2,"4,-12"
20035,720575940633810062,right,Tm21,232,-4,13,10,3,"-4,13"
20036,720575940620091989,right,Tm21,233,4,-13,-11,-2,"4,-13"
20037,720575940618503325,right,Tm21,235,4,11,1,10,"4,11"
20038,720575940637994941,right,Tm21,236,-1,4,3,1,"-1,4"
20039,720575940623970045,right,Tm21,237,-2,27,15,12,"-2,27"
20040,720575940635655672,right,Tm21,238,-8,-3,6,-9,"-8,-3"
20041,720575940619229912,right,Tm21,239,-6,6,9,-3,"-6,6"
20042,720575940623959549,right,Tm21,240,-4,-3,2,-5,"-4,-3"
20043,720575940626769241,right,Tm21,241,2,-17,-11,-6,"2,-17"
20044,720575940627428106,right,Tm21,242,-4,6,7,-1,"-4,6"
20045,720575940630726139,right,Tm21,243,-1,-21,-10,-11,"-1,-21"
20046,720575940620624879,right,Tm21,244,-4,-12,-2,-10,"-4,-12"
20047,720575940654966177,right,Tm21,245,-5,-3,3,-6,"-5,-3"
20048,720575940636586096,right,Tm21,246,-4,15,11,4,"-4,15"
20049,720575940627135113,right,Tm21,247,-4,-15,-4,-11,"-4,-15"
20050,720575940627636423,right,Tm21,248,-6,0,6,-6,"-6,0"
20051,720575940632214242,right,Tm21,249,2,-12,-8,-4,"2,-12"
20052,720575940621675329,right,Tm21,250,-1,1,1,0,"-1,1"
20053,720575940622060585,right,Tm21,251,-1,-14,-6,-8,"-1,-14"
20054,720575940614716639,right,Tm21,252,3,23,8,15,"3,23"
20055,720575940609300419,right,Tm21,253,5,16,3,13,"5,16"
20056,720575940616251835,right,Tm21,255,-6,-13,-1,-12,"-6,-13"
20057,720575940630491191,right,Tm21,257,2,21,8,13,"2,21"
20058,720575940626782010,right,Tm21,258,-4,-17,-5,-12,"-4,-17"
20059,720575940605771040,right,Tm21,259,-7,-5,4,-9,"-7,-5"
20060,720575940634171673,right,Tm21,260,-3,19,12,7,"-3,19"
20061,720575940623295949,right,Tm21,262,1,-11,-7,-4,"1,-11"
20062,720575940615137447,right,Tm21,264,-1,-6,-2,-4,"-1,-6"
20063,720575940635051188,right,Tm21,265,-6,-1,5,-6,"-6,-1"
20064,720575940633138093,right,Tm21,268,7,-6,-10,4,"7,-6"
20065,720575940609921803,right,Tm21,269,2,-19,-12,-7,"2,-19"
20066,720575940626931843,right,Tm21,270,1,-8,-5,-3,"1,-8"
20067,720575940638585149,right,Tm21,272,3,-2,-4,2,"3,-2"
20068,720575940632264263,right,Tm21,273,-6,23,17,6,"-6,23"
20069,720575940650943865,right,Tm21,276,2,3,-1,4,"2,3"
20070,720575940605128876,right,Tm21,277,7,-3,-9,6,"7,-3"
20071,720575940635051199,right,Tm21,278,-5,10,10,0,"-5,10"
20072,720575940625552103,right,Tm21,279,-4,8,8,0,"-4,8"
20073,720575940629713743,right,Tm21,283,-4,4,6,-2,"-4,4"
20074,720575940649840505,right,Tm21,284,0,25,12,13,"0,25"
20075,720575940610401860,right,Tm21,285,6,-18,-15,-3,"6,-18"
20076,720575940621657965,right,Tm21,286,0,-24,-12,-12,"0,-24"
20077,720575940627761674,right,Tm21,287,-5,13,11,2,"-5,13"
20078,720575940635466091,right,Tm21,290,5,-24,-17,-7,"5,-24"
20079,720575940617359138,right,Tm21,291,7,2,-6,8,"7,2"
20080,720575940635848696,right,Tm21,292,-4,18,13,5,"-4,18"
20081,720575940637455278,right,Tm21,293,4,-17,-13,-4,"4,-17"
20082,720575940629512208,right,Tm21,294,1,-20,-11,-9,"1,-20"
20083,720575940627176793,right,Tm21,296,1,-18,-10,-8,"1,-18"
20084,720575940620148340,right,Tm21,298,-5,5,7,-2,"-5,5"
20085,720575940612932403,right,Tm21,299,-4,12,10,2,"-4,12"
20086,720575940630221178,right,Tm21,300,4,-18,-13,-5,"4,-18"
20087,720575940617871643,right,Tm21,301,-5,16,13,3,"-5,16"
20088,720575940639379253,right,Tm21,302,2,17,6,11,"2,17"
20089,720575940632001849,right,Tm21,303,-5,22,16,6,"-5,22"
20090,720575940615081578,right,Tm21,305,-7,4,9,-5,"-7,4"
20091,720575940625523088,right,Tm21,308,-5,8,9,-1,"-5,8"
20092,720575940619714800,right,Tm21,309,-6,12,12,0,"-6,12"
20093,720575940637090927,right,Tm21,310,2,22,9,13,"2,22"
20094,720575940627972090,right,Tm21,311,-7,15,14,1,"-7,15"
20095,720575940621573824,right,Tm21,312,4,-7,-8,1,"4,-7"
20096,720575940626020885,right,Tm21,313,7,3,-6,9,"7,3"
20097,720575940645102883,right,Tm21,314,-9,5,11,-6,"-9,5"
20098,720575940612346074,right,Tm21,315,-3,-6,0,-6,"-3,-6"
20099,720575940617640309,right,Tm21,316,5,-4,-7,3,"5,-4"
20100,720575940621619382,right,Tm21,317,-5,-4,3,-7,"-5,-4"
20101,720575940639862435,right,Tm21,318,4,-19,-14,-5,"4,-19"
20102,720575940625103374,right,Tm21,319,-2,5,4,1,"-2,5"
20103,720575940617818973,right,Tm21,320,-2,-5,-1,-4,"-2,-5"
20104,720575940640844632,right,Tm21,322,2,26,11,15,"2,26"
20105,720575940624072885,right,Tm21,323,-7,-13,0,-13,"-7,-13"
20106,720575940623167768,right,Tm21,324,3,24,9,15,"3,24"
20107,720575940632585892,right,Tm21,325,5,1,-5,6,"5,1"
20108,720575940622971169,right,Tm21,326,2,16,6,10,"2,16"
20109,720575940619656664,right,Tm21,328,5,-9,-10,1,"5,-9"
20110,720575940627709839,right,Tm21,329,0,24,12,12,"0,24"
20111,720575940622879331,right,Tm21,331,1,-15,-9,-6,"1,-15"
20112,720575940621754484,right,Tm21,332,4,-26,-17,-9,"4,-26"
20113,720575940622114992,right,Tm21,334,1,-26,-14,-12,"1,-26"
20114,720575940653562358,right,Tm21,335,2,8,2,6,"2,8"
20115,720575940639344181,right,Tm21,336,0,23,11,12,"0,23"
20116,720575940631219768,right,Tm21,337,-5,-6,2,-8,"-5,-6"
20117,720575940630188396,right,Tm21,340,-4,17,12,5,"-4,17"
20118,720575940623022104,right,Tm21,342,2,-15,-10,-5,"2,-15"
20119,720575940609900299,right,Tm21,343,-3,27,16,11,"-3,27"
20120,720575940624988564,right,Tm21,344,-2,-15,-6,-9,"-2,-15"
20121,720575940634455266,right,Tm21,345,3,-12,-9,-3,"3,-12"
20122,720575940621489517,right,Tm21,346,-7,-9,2,-11,"-7,-9"
20123,720575940617607124,right,Tm21,348,3,14,4,10,"3,14"
20124,720575940623507238,right,Tm21,350,1,15,6,9,"1,15"
20125,720575940629417259,right,Tm21,352,-2,28,16,12,"-2,28"
20126,720575940621828848,right,Tm21,353,2,24,10,14,"2,24"
20127,720575940625707278,right,Tm21,354,-2,-26,-11,-15,"-2,-26"
20128,720575940605618720,right,Tm21,355,-7,-6,4,-10,"-7,-6"
20129,720575940622231280,right,Tm21,356,0,22,11,11,"0,22"
20130,720575940617894145,right,Tm21,357,4,17,4,13,"4,17"
20131,720575940631400746,right,Tm21,358,-3,17,11,6,"-3,17"
20132,720575940627733593,right,Tm21,359,2,23,9,14,"2,23"
20133,720575940627970106,right,Tm21,360,-5,19,14,5,"-5,19"
20134,720575940622264745,right,Tm21,363,7,-4,-9,5,"7,-4"
20135,720575940638128350,right,Tm21,368,-4,-20,-6,-14,"-4,-20"
20136,720575940624299005,right,Tm21,369,5,-5,-8,3,"5,-5"
20137,720575940646762275,right,Tm21,370,-3,21,13,8,"-3,21"
20138,720575940628653564,right,Tm21,371,6,-5,-9,4,"6,-5"
20139,720575940621405318,right,Tm21,372,1,-2,-2,0,"1,-2"
20140,720575940627406162,right,Tm21,373,1,-21,-12,-9,"1,-21"
20141,720575940618881620,right,Tm21,374,2,13,4,9,"2,13"
20142,720575940612045235,right,Tm21,375,-6,7,9,-2,"-6,7"
20143,720575940627683898,right,Tm21,378,-3,18,12,6,"-3,18"
20144,720575940616485515,right,Tm21,379,3,-17,-12,-5,"3,-17"
20145,720575940639327184,right,Tm21,380,-1,29,15,14,"-1,29"
20146,720575940619971975,right,Tm21,381,-8,-9,3,-12,"-8,-9"
20147,720575940636496247,right,Tm21,382,3,-6,-6,0,"3,-6"
20148,720575940618120517,right,Tm21,383,-6,11,11,0,"-6,11"
20149,720575940620041455,right,Tm21,384,-6,-2,5,-7,"-6,-2"
20150,720575940626468185,right,Tm21,386,-6,19,15,4,"-6,19"
20151,720575940627724616,right,Tm21,387,-1,-15,-7,-8,"-1,-15"
20152,720575940625078460,right,Tm21,388,3,19,6,13,"3,19"
20153,720575940624299784,right,Tm21,389,-6,-16,-2,-14,"-6,-16"
20154,720575940628539591,right,Tm21,390,-6,-9,1,-10,"-6,-9"
20155,720575940617462457,right,Tm21,391,4,-3,-6,3,"4,-3"
20156,720575940635079263,right,Tm21,392,-4,7,7,0,"-4,7"
20157,720575940613978262,right,Tm21,393,-1,22,12,10,"-1,22"
20158,720575940620857709,right,Tm21,394,-7,-8,3,-11,"-7,-8"
20159,720575940609301038,right,Tm21,395,0,-22,-11,-11,"0,-22"
20160,720575940612687144,right,Tm21,396,-1,10,6,4,"-1,10"
20161,720575940621021099,right,Tm21,398,-3,22,14,8,"-3,22"
20162,720575940630947535,right,Tm21,399,-4,-24,-8,-16,"-4,-24"
20163,720575940646961460,right,Tm21,401,-2,-19,-8,-11,"-2,-19"
20164,720575940617592793,right,Tm21,402,3,26,10,16,"3,26"
20165,720575940627771737,right,Tm21,403,-2,-12,-4,-8,"-2,-12"
20166,720575940627835413,right,Tm21,404,-1,20,11,9,"-1,20"
20167,720575940616065130,right,Tm21,406,1,-25,-14,-11,"1,-25"
20168,720575940628806444,right,Tm21,407,-5,-10,0,-10,"-5,-10"
20169,720575940645723940,right,Tm21,408,-6,-4,4,-8,"-6,-4"
20170,720575940640557520,right,Tm21,409,0,-3,-2,-1,"0,-3"
20171,720575940625961561,right,Tm21,410,-2,-2,1,-3,"-2,-2"
20172,720575940607179394,right,Tm21,412,-6,21,16,5,"-6,21"
20173,720575940623525645,right,Tm21,413,-2,-7,-2,-5,"-2,-7"
20174,720575940627539528,right,Tm21,414,4,21,6,15,"4,21"
20175,720575940629995820,right,Tm21,415,6,12,0,12,"6,12"
20176,720575940635211365,right,Tm21,417,-6,-10,1,-11,"-6,-10"
20177,720575940644658455,right,Tm21,418,-2,15,9,6,"-2,15"
20178,720575940623309080,right,Tm21,419,-3,-11,-3,-8,"-3,-11"
20179,720575940622576141,right,Tm21,420,6,-3,-8,5,"6,-3"
20180,720575940607344770,right,Tm21,421,-1,12,7,5,"-1,12"
20181,720575940639636806,right,Tm21,422,-7,-4,5,-9,"-7,-4"
20182,720575940622950424,right,Tm21,423,3,-18,-12,-6,"3,-18"
20183,720575940613525930,right,Tm21,424,-3,-2,2,-4,"-3,-2"
20184,720575940627169929,right,Tm21,425,3,20,7,13,"3,20"
20185,720575940645828974,right,Tm21,426,-3,0,3,-3,"-3,0"
20186,720575940660136577,right,Tm21,427,5,-18,-14,-4,"5,-18"
20187,720575940627007640,right,Tm21,429,-2,14,9,5,"-2,14"
20188,720575940625613287,right,Tm21,430,-3,-7,-1,-6,"-3,-7"
20189,720575940616761686,right,Tm21,431,-2,-10,-3,-7,"-2,-10"
20190,720575940617570333,right,Tm21,432,-5,7,8,-1,"-5,7"
20191,720575940632505484,right,Tm21,433,0,-8,-4,-4,"0,-8"
20192,720575940612942511,right,Tm21,434,-3,7,6,1,"-3,7"
20193,720575940628323861,right,Tm21,435,5,-17,-14,-3,"5,-17"
20194,720575940621802662,right,Tm21,436,0,-15,-8,-7,"0,-15"
20195,720575940624043363,right,Tm21,437,-3,12,9,3,"-3,12"
20196,720575940627084060,right,Tm21,439,-3,-9,-2,-7,"-3,-9"
20197,720575940646570787,right,Tm21,440,1,23,10,13,"1,23"
20198,720575940633310675,right,Tm21,441,3,-16,-11,-5,"3,-16"
20199,720575940613803798,right,Tm21,442,-5,25,17,8,"-5,25"
20200,720575940622929737,right,Tm21,443,-6,4,8,-4,"-6,4"
20201,720575940621781375,right,Tm21,444,4,-10,-9,-1,"4,-10"
20202,720575940626408188,right,Tm21,445,-2,8,6,2,"-2,8"
20203,720575940644727076,right,Tm21,446,2,-14,-9,-5,"2,-14"
20204,720575940651898358,right,Tm21,447,-1,2,2,0,"-1,2"
20205,720575940612592537,right,Tm21,449,6,-16,-14,-2,"6,-16"
20206,720575940613772269,right,Tm21,450,2,-9,-7,-2,"2,-9"
20207,720575940635139423,right,Tm21,451,4,20,6,14,"4,20"
20208,720575940639810931,right,Tm21,452,1,-9,-6,-3,"1,-9"
20209,720575940640790691,right,Tm21,454,5,-12,-11,-1,"5,-12"
20210,720575940614635059,right,Tm21,455,7,-7,-11,4,"7,-7"
20211,720575940637822527,right,Tm21,456,0,21,10,11,"0,21"
20212,720575940628667828,right,Tm21,458,5,0,-5,5,"5,0"
20213,720575940638079578,right,Tm21,460,-3,-20,-7,-13,"-3,-20"
20214,720575940640374131,right,Tm21,462,-1,18,10,8,"-1,18"
20215,720575940630343649,right,Tm21,463,5,17,3,14,"5,17"
20216,720575940632360722,right,Tm21,464,4,0,-4,4,"4,0"
20217,720575940625893157,right,Tm21,465,3,0,-3,3,"3,0"
20218,720575940619143963,right,Tm21,466,1,14,6,8,"1,14"
20219,720575940619039773,right,Tm21,467,-2,-20,-8,-12,"-2,-20"
20220,720575940611817957,right,Tm21,468,-3,11,8,3,"-3,11"
20221,720575940630459863,right,Tm21,469,-7,13,13,0,"-7,13"
20222,720575940626860290,right,Tm21,470,4,-9,-9,0,"4,-9"
20223,720575940627862538,right,Tm21,471,3,-26,-16,-10,"3,-26"
20224,720575940618065989,right,Tm21,472,1,25,11,14,"1,25"
20225,720575940604825824,right,Tm21,473,-4,23,15,8,"-4,23"
20226,720575940625465836,right,Tm21,474,-3,-17,-6,-11,"-3,-17"
20227,720575940613309157,right,Tm21,475,-4,-1,3,-4,"-4,-1"
20228,720575940619182646,right,Tm21,476,-1,15,8,7,"-1,15"
20229,720575940647459460,right,Tm21,477,-3,2,4,-2,"-3,2"
20230,720575940624447588,right,Tm21,478,-7,16,15,1,"-7,16"
20231,720575940621097142,right,Tm21,479,-2,10,7,3,"-2,10"
20232,720575940632811821,right,Tm21,480,3,-19,-13,-6,"3,-19"
20233,720575940637793589,right,Tm21,481,4,-8,-8,0,"4,-8"
20234,720575940610074210,right,Tm21,482,1,17,7,10,"1,17"
20235,720575940612235214,right,Tm21,483,2,-7,-6,-1,"2,-7"
20236,720575940655108513,right,Tm21,484,3,-9,-8,-1,"3,-9"
20237,720575940632478893,right,Tm21,485,-3,-3,1,-4,"-3,-3"
20238,720575940610493123,right,Tm21,486,0,1,0,1,"0,1"
20239,720575940605575090,right,Tm21,487,1,-1,-2,1,"1,-1"
20240,720575940621294435,right,Tm21,489,-3,10,8,2,"-3,10"
20241,720575940625020088,right,Tm21,490,-5,6,8,-2,"-5,6"
20242,720575940611620306,right,Tm21,491,7,-1,-8,7,"7,-1"
20243,720575940619831316,right,Tm21,492,-7,-2,6,-8,"-7,-2"
20244,720575940628117510,right,Tm21,493,-3,23,14,9,"-3,23"
20245,720575940623918216,right,Tm21,497,6,1,-6,7,"6,1"
20246,720575940615219367,right,Tm21,498,6,10,-1,11,"6,10"
20247,720575940624750921,right,Tm21,499,5,10,0,10,"5,10"
20248,720575940615730594,right,Tm21,500,7,-8,-11,3,"7,-8"
20249,720575940613580438,right,Tm21,501,1,2,0,2,"1,2"
20250,720575940632912941,right,Tm21,503,3,17,5,12,"3,17"
20251,720575940630605007,right,Tm21,504,-2,9,6,3,"-2,9"
20252,720575940630655737,right,Tm21,505,6,-22,-17,-5,"6,-22"
20253,720575940609219595,right,Tm21,506,1,-12,-7,-5,"1,-12"
20254,720575940636272526,right,Tm21,507,-5,-12,-1,-11,"-5,-12"
20255,720575940620215744,right,Tm21,508,-5,11,10,1,"-5,11"
20256,720575940611602274,right,Tm21,509,-4,10,9,1,"-4,10"
20257,720575940624940019,right,Tm21,510,-2,11,7,4,"-2,11"
20258,720575940630110172,right,Tm21,512,6,0,-6,6,"6,0"
20259,720575940635638008,right,Tm21,513,-4,-13,-3,-10,"-4,-13"
20260,720575940639955059,right,Tm21,514,-4,-10,-1,-9,"-4,-10"
20261,720575940624737277,right,Tm21,518,-4,22,15,7,"-4,22"
20262,720575940617982209,right,Tm21,519,-5,-5,2,-7,"-5,-5"
20263,720575940634661601,right,Tm21,520,-2,-22,-9,-13,"-2,-22"
20264,720575940608356617,right,Tm21,521,6,-9,-11,2,"6,-9"
20265,720575940618470779,right,Tm21,522,-4,0,4,-4,"-4,0"
20266,720575940612840562,right,Tm21,523,2,14,5,9,"2,14"
20267,720575940620808286,right,Tm21,524,4,-20,-14,-6,"4,-20"
20268,720575940618683456,right,Tm21,525,-1,-20,-9,-11,"-1,-20"
20269,720575940640173264,right,Tm21,526,0,-10,-5,-5,"0,-10"
20270,720575940625009848,right,Tm21,527,-4,-8,0,-8,"-4,-8"
20271,720575940633401683,right,Tm21,529,2,-2,-3,1,"2,-2"
20272,720575940629222147,right,Tm21,530,-3,-13,-4,-9,"-3,-13"
20273,720575940608731972,right,Tm21,531,1,0,-1,1,"1,0"
20274,720575940631069381,right,Tm21,532,-8,7,11,-4,"-8,7"
20275,720575940616950341,right,Tm21,533,0,-16,-8,-8,"0,-16"
20276,720575940623443725,right,Tm21,534,3,2,-2,4,"3,2"
20277,720575940623766468,right,Tm21,537,0,-23,-12,-11,"0,-23"
20278,720575940617808418,right,Tm21,538,-4,1,4,-3,"-4,1"
20279,720575940632115256,right,Tm21,539,-6,15,13,2,"-6,15"
20280,720575940623047437,right,Tm21,540,-2,-9,-3,-6,"-2,-9"
20281,720575940612208090,right,Tm21,541,-4,14,11,3,"-4,14"
20282,720575940639655229,right,Tm21,542,6,-13,-13,0,"6,-13"
20283,720575940604553150,right,Tm21,543,-1,-4,-1,-3,"-1,-4"
20284,720575940622269693,right,Tm21,545,5,11,0,11,"5,11"
20285,720575940638813766,right,Tm21,547,-1,21,11,10,"-1,21"
20286,720575940632252130,right,Tm21,548,1,-16,-9,-7,"1,-16"
20287,720575940627954182,right,Tm21,549,0,-9,-5,-4,"0,-9"
20288,720575940635758222,right,Tm21,550,-2,3,3,0,"-2,3"
20289,720575940626515556,right,Tm21,551,-4,-9,-1,-8,"-4,-9"
20290,720575940618095163,right,Tm21,552,4,-1,-5,4,"4,-1"
20291,720575940618864542,right,Tm21,553,-3,16,11,5,"-3,16"
20292,720575940606939010,right,Tm21,554,-9,-3,7,-10,"-9,-3"
20293,720575940618731899,right,Tm21,555,-4,9,8,1,"-4,9"
20294,720575940633638625,right,Tm21,556,0,10,5,5,"0,10"
20295,720575940605773758,right,Tm21,557,6,-10,-11,1,"6,-10"
20296,720575940629576463,right,Tm21,560,-7,14,14,0,"-7,14"
20297,720575940641629429,right,Tm21,561,5,7,-2,9,"5,7"
20298,720575940614945990,right,Tm21,562,-5,-2,4,-6,"-5,-2"
20299,720575940627905354,right,Tm21,564,3,-23,-15,-8,"3,-23"
20300,720575940615454206,right,Tm21,565,0,-26,-13,-13,"0,-26"
20301,720575940619462814,right,Tm21,566,5,-8,-9,1,"5,-8"
20302,720575940625425703,right,Tm21,567,-2,22,13,9,"-2,22"
20303,720575940650722681,right,Tm21,568,-6,-8,2,-10,"-6,-8"
20304,720575940624694932,right,Tm21,571,0,-14,-7,-7,"0,-14"
20305,720575940624138933,right,Tm21,572,-8,3,9,-6,"-8,3"
20306,720575940616210994,right,Tm21,573,4,14,3,11,"4,14"
20307,720575940625912248,right,Tm21,575,6,9,-2,11,"6,9"
20308,720575940620495343,right,Tm21,576,0,28,14,14,"0,28"
20309,720575940632789924,right,Tm21,578,4,-11,-10,-1,"4,-11"
20310,720575940633573089,right,Tm21,579,-3,-10,-2,-8,"-3,-10"
20311,720575940628302357,right,Tm21,580,-2,-23,-10,-13,"-2,-23"
20312,720575940645529710,right,Tm21,582,-1,23,12,11,"-1,23"
20313,720575940617460317,right,Tm21,585,-1,-23,-11,-12,"-1,-23"
20314,720575940622687657,right,Tm21,586,2,18,7,11,"2,18"
20315,720575940635496366,right,Tm21,588,1,4,1,3,"1,4"
20316,720575940627637586,right,Tm21,589,-1,-5,-2,-3,"-1,-5"
20317,720575940616928651,right,Tm21,590,1,9,3,6,"1,9"
20318,720575940636916398,right,Tm21,591,3,-3,-5,2,"3,-3"
20319,720575940618657088,right,Tm21,593,3,-14,-10,-4,"3,-14"
20320,720575940623222410,right,Tm21,594,7,-16,-15,-1,"7,-16"
20321,720575940628761084,right,Tm21,595,7,-12,-13,1,"7,-12"
20322,720575940622935956,right,Tm21,597,4,1,-4,5,"4,1"
20323,720575940627503635,right,Tm21,598,2,-18,-11,-7,"2,-18"
20324,720575940612368754,right,Tm21,600,3,-10,-8,-2,"3,-10"
20325,720575940627906308,right,Tm21,602,4,-2,-5,3,"4,-2"
20326,720575940628236487,right,Tm21,604,-6,-17,-3,-14,"-6,-17"
20327,720575940635463007,right,Tm21,605,3,15,4,11,"3,15"
20328,720575940626486300,right,Tm21,606,-1,-19,-9,-10,"-1,-19"
20329,720575940617729254,right,Tm21,607,1,18,8,10,"1,18"
20330,720575940615906165,right,Tm21,608,1,10,4,6,"1,10"
20331,720575940618093529,right,Tm21,609,-2,0,2,-2,"-2,0"
20332,720575940625830525,right,Tm21,611,-1,-18,-8,-10,"-1,-18"
20333,720575940611984789,right,Tm21,614,-2,-8,-2,-6,"-2,-8"
20334,720575940645162775,right,Tm21,615,-7,-7,3,-10,"-7,-7"
20335,720575940618266907,right,Tm21,616,-3,15,10,5,"-3,15"
20336,720575940623346473,right,Tm21,617,-2,-17,-7,-10,"-2,-17"
20337,720575940619957077,right,Tm21,618,-1,24,13,11,"-1,24"
20338,720575940628358226,right,Tm21,619,-4,-19,-6,-13,"-4,-19"
20339,720575940626835500,right,Tm21,621,1,24,11,13,"1,24"
20340,720575940636309940,right,Tm21,622,-5,20,15,5,"-5,20"
20341,720575940620884133,right,Tm21,624,1,-17,-10,-7,"1,-17"
20342,720575940626822700,right,Tm21,625,-2,24,14,10,"-2,24"
20343,720575940619753419,right,Tm21,626,-5,-8,1,-9,"-5,-8"
20344,720575940616817081,right,Tm21,627,0,-1,-1,0,"0,-1"
20345,720575940632563681,right,Tm21,628,0,0,0,0,"0,0"
20346,720575940621326982,right,Tm21,629,4,24,8,16,"4,24"
20347,720575940634510817,right,Tm21,630,4,8,0,8,"4,8"
20348,720575940645506414,right,Tm21,631,1,26,12,14,"1,26"
20349,720575940624112935,right,Tm21,632,3,-20,-13,-7,"3,-20"
20350,720575940635351964,right,Tm21,633,-1,-24,-11,-13,"-1,-24"
20351,720575940644991511,right,Tm21,634,-3,-15,-5,-10,"-3,-15"
20352,720575940612610789,right,Tm21,635,6,-6,-9,3,"6,-6"
20353,720575940645258532,right,Tm21,637,3,-21,-14,-7,"3,-21"
20354,720575940627471759,right,Tm21,638,-1,7,4,3,"-1,7"
20355,720575940605185964,right,Tm21,639,-4,19,13,6,"-4,19"
20356,720575940637104496,right,Tm21,640,-1,-16,-7,-9,"-1,-16"
20357,720575940622199390,right,Tm21,641,-8,-5,5,-10,"-8,-5"
20358,720575940618068454,right,Tm21,642,-5,-11,-1,-10,"-5,-11"
20359,720575940623089944,right,Tm21,643,6,14,1,13,"6,14"
20360,720575940615944514,right,Tm21,644,-6,18,15,3,"-6,18"
20361,720575940607032194,right,Tm21,645,-4,27,17,10,"-4,27"
20362,720575940609647829,right,Tm21,647,-4,-7,0,-7,"-4,-7"
20363,720575940613710102,right,Tm21,650,-3,-25,-10,-15,"-3,-25"
20364,720575940628751209,right,Tm21,651,-4,-5,1,-6,"-4,-5"
20365,720575940614098739,right,Tm21,652,-6,-11,0,-11,"-6,-11"
20366,720575940623022886,right,Tm21,653,-6,-12,0,-12,"-6,-12"
20367,720575940632599182,right,Tm21,654,-3,8,7,1,"-3,8"
20368,720575940648641412,right,Tm21,656,0,-11,-6,-5,"0,-11"
20369,720575940626298156,right,Tm21,658,1,20,9,11,"1,20"
20370,720575940627253912,right,Tm21,659,-4,-6,1,-7,"-4,-6"
20371,720575940616715381,right,Tm21,660,2,28,12,16,"2,28"
20372,720575940616219577,right,Tm21,661,-3,14,10,4,"-3,14"
20373,720575940641274164,right,Tm21,662,2,-1,-3,2,"2,-1"
20374,720575940609990595,right,Tm21,663,0,8,4,4,"0,8"
20375,720575940635957183,right,Tm21,665,7,-2,-8,6,"7,-2"
20376,720575940637154661,right,Tm21,668,1,19,8,11,"1,19"
20377,720575940626518334,right,Tm21,669,4,-16,-12,-4,"4,-16"
20378,720575940638242432,right,Tm21,672,-8,11,13,-2,"-8,11"
20379,720575940639242805,right,Tm21,673,2,5,0,5,"2,5"
20380,720575940625769108,right,Tm21,674,-4,-14,-3,-11,"-4,-14"
20381,720575940624052989,right,Tm21,675,-7,19,16,3,"-7,19"
20382,720575940636087919,right,Tm21,676,-3,-21,-8,-13,"-3,-21"
20383,720575940606595430,right,Tm21,677,0,11,5,6,"0,11"
20384,720575940639193203,right,Tm21,678,3,-7,-7,0,"3,-7"
20385,720575940630365562,right,Tm21,679,4,18,5,13,"4,18"
20386,720575940631961740,right,Tm21,680,-1,25,13,12,"-1,25"
20387,720575940609343683,right,Tm21,681,-2,-21,-9,-12,"-2,-21"
20388,720575940629146923,right,Tm21,682,6,-8,-10,2,"6,-8"
20389,720575940616961565,right,Tm21,684,-6,17,14,3,"-6,17"
20390,720575940617255773,right,Tm21,685,-5,-9,0,-9,"-5,-9"
20391,720575940626430014,right,Tm21,686,5,-22,-16,-6,"5,-22"
20392,720575940621616065,right,Tm21,687,-6,-3,4,-7,"-6,-3"
20393,720575940629760890,right,Tm21,688,-7,10,12,-2,"-7,10"
20394,720575940633832403,right,Tm21,689,-2,18,11,7,"-2,18"
20395,720575940611813299,right,Tm21,690,-7,-3,5,-8,"-7,-3"
20396,720575940626123353,right,Tm21,691,-9,4,11,-7,"-9,4"
20397,720575940630369335,right,Tm21,692,-4,24,16,8,"-4,24"
20398,720575940613367789,right,Tm21,693,-3,25,15,10,"-3,25"
20399,720575940620020278,right,Tm21,695,-6,10,11,-1,"-6,10"
20400,720575940633305058,right,Tm21,696,-2,16,10,6,"-2,16"
20401,720575940618096212,right,Tm21,697,1,-22,-12,-10,"1,-22"
20402,720575940644710180,right,Tm21,698,6,-7,-10,3,"6,-7"
20403,720575940647380276,right,Tm21,699,-5,0,5,-5,"-5,0"
20404,720575940612933594,right,Tm21,700,5,15,2,13,"5,15"
20405,720575940630156887,right,Tm21,701,0,-4,-2,-2,"0,-4"
20406,720575940614621694,right,Tm21,702,-5,23,16,7,"-5,23"
20407,720575940629974735,right,Tm21,703,-3,1,3,-2,"-3,1"
20408,720575940653015713,right,Tm21,704,-7,8,11,-3,"-7,8"
20409,720575940627981553,right,Tm21,705,1,1,-1,2,"1,1"
20410,720575940630988818,right,Tm21,707,-2,25,14,11,"-2,25"
20411,720575940629831783,right,Tm21,708,-4,-25,-9,-16,"-4,-25"
20412,720575940624523773,right,Tm21,709,-2,-24,-10,-14,"-2,-24"
20413,720575940623474902,right,Tm21,710,4,-25,-17,-8,"4,-25"
20414,720575940622466636,right,Tm21,711,-1,19,10,9,"-1,19"
20415,720575940616589853,right,Tm21,712,-7,12,13,-1,"-7,12"
20416,720575940644121032,right,Tm21,713,-6,16,14,2,"-6,16"
20417,720575940635609012,right,Tm21,716,4,-6,-7,1,"4,-6"
20418,720575940630339066,right,Tm21,717,2,-22,-13,-9,"2,-22"
20419,720575940646868532,right,Tm21,719,1,27,12,15,"1,27"
20420,720575940621594206,right,Tm21,720,-5,21,15,6,"-5,21"
20421,720575940617649041,right,Tm21,721,5,13,1,12,"5,13"
20422,720575940626887320,right,Tm21,722,6,-15,-14,-1,"6,-15"
20423,720575940622703621,right,Tm21,723,-2,-11,-4,-7,"-2,-11"
20424,720575940630405632,right,Tm21,725,-3,-24,-9,-15,"-3,-24"
20425,720575940618424645,right,Tm21,729,-3,29,17,12,"-3,29"
20426,720575940629224647,right,Tm21,730,7,0,-7,7,"7,0"
20427,720575940620045588,right,Tm21,731,-6,9,10,-1,"-6,9"
20428,720575940632011050,right,Tm21,732,-3,6,6,0,"-3,6"
20429,720575940632703180,right,Tm21,733,-5,-17,-4,-13,"-5,-17"
20430,720575940638564661,right,Tm21,734,2,0,-2,2,"2,0"
20431,720575940619264891,right,Tm21,735,1,-23,-13,-10,"1,-23"
20432,720575940625412554,right,Tm21,736,-8,1,8,-7,"-8,1"
20433,720575940638927332,right,Tm21,737,0,19,9,10,"0,19"
20434,720575940626855268,right,Tm21,738,-3,13,9,4,"-3,13"
20435,720575940629012418,right,Tm21,739,-7,2,8,-6,"-7,2"
20436,720575940624240520,right,Tm21,740,2,-8,-6,-2,"2,-8"
20437,720575940608130499,right,Tm21,741,-2,-14,-5,-9,"-2,-14"
20438,720575940614272510,right,Tm21,742,-4,11,9,2,"-4,11"
20439,720575940642141147,right,Tm21,745,0,13,6,7,"0,13"
20440,720575940629382730,right,Tm21,746,-3,3,4,-1,"-3,3"
20441,720575940636370665,right,Tm21,748,-4,20,14,6,"-4,20"
20442,720575940625003824,right,Tm21,749,-2,1,2,-1,"-2,1"
20443,720575940610016324,right,Tm21,750,4,-24,-16,-8,"4,-24"
20444,720575940629793691,right,Tm21,752,-2,7,5,2,"-2,7"
20445,720575940611699406,right,Tm21,753,-3,24,15,9,"-3,24"
20446,720575940607030658,right,Tm21,754,-1,-13,-6,-7,"-1,-13"
20447,720575940615980044,right,Tm21,755,4,19,5,14,"4,19"
20448,720575940625898014,right,Tm21,756,5,20,5,15,"5,20"
20449,720575940609290435,right,Tm21,757,0,-6,-3,-3,"0,-6"
20450,720575940622491980,right,Tm21,758,5,-1,-6,5,"5,-1"
20451,720575940649943161,right,Tm21,760,0,17,8,9,"0,17"
20452,720575940605705318,right,Tm21,761,-4,-18,-5,-13,"-4,-18"
20453,720575940627715093,right,Tm21,762,0,14,7,7,"0,14"
20454,720575940633917582,right,Tm21,763,-5,14,12,2,"-5,14"
20455,720575940614273534,right,Tm21,765,-3,9,7,2,"-3,9"
20456,720575940624424939,right,Tm21,766,2,-4,-4,0,"2,-4"
20457,720575940629870458,right,Tm21,768,3,5,-1,6,"3,5"
20458,720575940615074572,right,Tm21,771,3,-27,-17,-10,"3,-27"
20459,720575940636111758,right,Tm21,772,1,12,5,7,"1,12"
20460,720575940643799456,right,Tm21,773,5,-19,-15,-4,"5,-19"
20461,720575940625816860,right,Tm21,774,-8,6,11,-5,"-8,6"
20462,720575940640874624,right,Tm21,775,5,22,6,16,"5,22"
20463,720575940633369252,right,Tm21,778,4,25,8,17,"4,25"
20464,720575940625274957,right,Tm21,781,-5,26,18,8,"-5,26"
20465,720575940605697726,right,Tm21,783,-4,28,18,10,"-4,28"
20466,720575940611395682,right,Tm21,786,-2,30,17,13,"-2,30"
20467,720575940615067990,right,Tm3,1,-6,13,12,1,"-6,13"
20468,720575940630863159,right,Tm3,2,-8,2,9,-7,"-8,2"
20469,720575940615483103,right,Tm3,3,6,-12,-12,0,"6,-12"
20470,720575940615955643,right,Tm3,4,-5,-21,-6,-15,"-5,-21"
20471,720575940620439717,right,Tm3,5,-1,16,9,7,"-1,16"
20472,720575940621639713,right,Tm3,6,-2,-4,0,-4,"-2,-4"
20473,720575940621161862,right,Tm3,7,-6,-6,3,-9,"-6,-6"
20474,720575940629070083,right,Tm3,8,-4,26,17,9,"-4,26"
20475,720575940613008051,right,Tm3,9,4,9,0,9,"4,9"
20476,720575940636723557,right,Tm3,10,5,-15,-13,-2,"5,-15"
20477,720575940625877808,right,Tm3,11,7,-14,-14,0,"7,-14"
20478,720575940625114201,right,Tm3,12,-7,9,11,-2,"-7,9"
20479,720575940616549377,right,Tm3,13,-1,-26,-12,-14,"-1,-26"
20480,720575940625067239,right,Tm3,14,0,-27,-14,-13,"0,-27"
20481,720575940642952500,right,Tm3,15,2,-3,-4,1,"2,-3"
20482,720575940622350156,right,Tm3,16,-2,-16,-6,-10,"-2,-16"
20483,720575940626572218,right,Tm3,17,1,-5,-4,-1,"1,-5"
20484,720575940617490230,right,Tm3,18,5,-16,-13,-3,"5,-16"
20485,720575940625889929,right,Tm3,19,-7,17,15,2,"-7,17"
20486,720575940652679158,right,Tm3,20,3,-11,-9,-2,"3,-11"
20487,720575940616691573,right,Tm3,21,-2,19,11,8,"-2,19"
20488,720575940611007812,right,Tm3,22,-1,3,2,1,"-1,3"
20489,720575940639501965,right,Tm3,23,-3,-16,-5,-11,"-3,-16"
20490,720575940617200187,right,Tm3,24,-1,-10,-4,-6,"-1,-10"
20491,720575940639658880,right,Tm3,25,-9,3,10,-7,"-9,3"
20492,720575940617836774,right,Tm3,26,1,-3,-3,0,"1,-3"
20493,720575940627264030,right,Tm3,27,0,-25,-13,-12,"0,-25"
20494,720575940627711492,right,Tm3,29,-1,-3,-1,-2,"-1,-3"
20495,720575940615486866,right,Tm3,30,6,16,2,14,"6,16"
20496,720575940626943260,right,Tm3,31,0,16,8,8,"0,16"
20497,720575940632379410,right,Tm3,32,0,12,6,6,"0,12"
20498,720575940620139124,right,Tm3,33,3,18,6,12,"3,18"
20499,720575940624860972,right,Tm3,34,6,18,3,15,"6,18"
20500,720575940607469746,right,Tm3,35,1,-24,-13,-11,"1,-24"
20501,720575940620620820,right,Tm3,37,1,5,1,4,"1,5"
20502,720575940622270088,right,Tm3,38,0,-2,-1,-1,"0,-2"
20503,720575940620906734,right,Tm3,39,0,20,10,10,"0,20"
20504,720575940620272263,right,Tm3,40,-2,-6,-1,-5,"-2,-6"
20505,720575940622879453,right,Tm3,41,-3,28,17,11,"-3,28"
20506,720575940638661446,right,Tm3,42,-1,14,8,6,"-1,14"
20507,720575940617769105,right,Tm3,43,-5,18,14,4,"-5,18"
20508,720575940617160862,right,Tm3,44,5,-10,-10,0,"5,-10"
20509,720575940629671468,right,Tm3,45,-5,-1,4,-5,"-5,-1"
20510,720575940618249812,right,Tm3,46,-5,15,12,3,"-5,15"
20511,720575940616215709,right,Tm3,47,-9,-1,8,-9,"-9,-1"
20512,720575940633966192,right,Tm3,48,-4,-22,-7,-15,"-4,-22"
20513,720575940617468121,right,Tm3,49,4,-4,-6,2,"4,-4"
20514,720575940622073840,right,Tm3,50,-2,21,12,9,"-2,21"
20515,720575940616058811,right,Tm3,51,0,-19,-10,-9,"0,-19"
20516,720575940626674378,right,Tm3,52,-1,-22,-10,-12,"-1,-22"
20517,720575940643503924,right,Tm3,53,5,14,2,12,"5,14"
20518,720575940618490269,right,Tm3,54,-4,3,5,-2,"-4,3"
20519,720575940615330001,right,Tm3,55,-4,-11,-2,-9,"-4,-11"
20520,720575940625096743,right,Tm3,56,1,-13,-8,-5,"1,-13"
20521,720575940644850468,right,Tm3,57,6,-11,-12,1,"6,-11"
20522,720575940619691569,right,Tm3,58,3,12,3,9,"3,12"
20523,720575940642873229,right,Tm3,59,-2,2,3,-1,"-2,2"
20524,720575940613058162,right,Tm3,61,-4,-4,2,-6,"-4,-4"
20525,720575940622763288,right,Tm3,62,0,-29,-15,-14,"0,-29"
20526,720575940625417293,right,Tm3,63,4,12,2,10,"4,12"
20527,720575940616561494,right,Tm3,64,4,-23,-16,-7,"4,-23"
20528,720575940614981672,right,Tm3,65,-1,28,15,13,"-1,28"
20529,720575940626926920,right,Tm3,66,2,15,5,10,"2,15"
20530,720575940644306980,right,Tm3,67,-2,-13,-5,-8,"-2,-13"
20531,720575940633415054,right,Tm3,68,3,16,5,11,"3,16"
20532,720575940620344084,right,Tm3,69,1,8,3,5,"1,8"
20533,720575940612206771,right,Tm3,70,-4,21,14,7,"-4,21"
20534,720575940637243364,right,Tm3,71,-2,-3,0,-3,"-2,-3"
20535,720575940632680588,right,Tm3,72,0,-28,-14,-14,"0,-28"
20536,720575940632299916,right,Tm3,73,2,2,-1,3,"2,2"
20537,720575940614118097,right,Tm3,74,-1,-9,-4,-5,"-1,-9"
20538,720575940629903951,right,Tm3,75,-6,14,13,1,"-6,14"
20539,720575940647793972,right,Tm3,76,-3,-4,1,-5,"-3,-4"
20540,720575940623700371,right,Tm3,77,2,-5,-5,0,"2,-5"
20541,720575940626844474,right,Tm3,78,2,20,8,12,"2,20"
20542,720575940628589824,right,Tm3,79,2,1,-2,3,"2,1"
20543,720575940638136666,right,Tm3,80,4,13,2,11,"4,13"
20544,720575940618228763,right,Tm3,81,6,-2,-7,5,"6,-2"
20545,720575940619598452,right,Tm3,82,-7,7,10,-3,"-7,7"
20546,720575940614182055,right,Tm3,83,2,-21,-13,-8,"2,-21"
20547,720575940630616863,right,Tm3,84,-2,12,8,4,"-2,12"
20548,720575940611435474,right,Tm3,85,4,-22,-15,-7,"4,-22"
20549,720575940635798008,right,Tm3,86,-5,-7,1,-8,"-5,-7"
20550,720575940618693716,right,Tm3,87,1,11,4,7,"1,11"
20551,720575940622167329,right,Tm3,88,7,4,-5,9,"7,4"
20552,720575940614543569,right,Tm3,89,1,-19,-11,-8,"1,-19"
20553,720575940613420658,right,Tm3,90,-4,5,6,-1,"-4,5"
20554,720575940636278384,right,Tm3,91,-1,6,4,2,"-1,6"
20555,720575940621799960,right,Tm3,92,0,9,4,5,"0,9"
20556,720575940627271823,right,Tm3,93,-6,3,7,-4,"-6,3"
20557,720575940634311580,right,Tm3,94,5,18,4,14,"5,18"
20558,720575940627404298,right,Tm3,95,4,-21,-15,-6,"4,-21"
20559,720575940632262760,right,Tm3,96,1,-10,-6,-4,"1,-10"
20560,720575940635204250,right,Tm3,97,-5,2,6,-4,"-5,2"
20561,720575940610655186,right,Tm3,98,-1,-12,-5,-7,"-1,-12"
20562,720575940624020648,right,Tm3,99,4,15,3,12,"4,15"
20563,720575940626005287,right,Tm3,100,2,-10,-7,-3,"2,-10"
20564,720575940619990804,right,Tm3,101,-7,6,10,-4,"-7,6"
20565,720575940623493161,right,Tm3,102,3,13,3,10,"3,13"
20566,720575940626830692,right,Tm3,104,-1,-27,-13,-14,"-1,-27"
20567,720575940626328126,right,Tm3,105,3,22,8,14,"3,22"
20568,720575940627517592,right,Tm3,106,-7,11,12,-1,"-7,11"
20569,720575940617719163,right,Tm3,107,8,-2,-9,7,"8,-2"
20570,720575940622120900,right,Tm3,108,-3,-12,-3,-9,"-3,-12"
20571,720575940625225511,right,Tm3,109,4,-5,-7,2,"4,-5"
20572,720575940616498498,right,Tm3,110,-7,0,7,-7,"-7,0"
20573,720575940607284098,right,Tm3,111,2,-24,-14,-10,"2,-24"
20574,720575940646897796,right,Tm3,112,-6,1,6,-5,"-6,1"
20575,720575940648696452,right,Tm3,113,-2,4,4,0,"-2,4"
20576,720575940607472050,right,Tm3,114,2,-13,-9,-4,"2,-13"
20577,720575940618311734,right,Tm3,115,-4,2,5,-3,"-4,2"
20578,720575940633914263,right,Tm3,116,-1,-8,-3,-5,"-1,-8"
20579,720575940621111431,right,Tm3,117,-8,-2,7,-9,"-8,-2"
20580,720575940620596651,right,Tm3,118,3,1,-3,4,"3,1"
20581,720575940627535272,right,Tm3,119,-2,6,5,1,"-2,6"
20582,720575940628943226,right,Tm3,120,-1,-1,0,-1,"-1,-1"
20583,720575940618065984,right,Tm3,121,-8,4,10,-6,"-8,4"
20584,720575940612190248,right,Tm3,122,-5,9,9,0,"-5,9"
20585,720575940618161099,right,Tm3,123,-8,10,13,-3,"-8,10"
20586,720575940607123586,right,Tm3,124,1,-7,-5,-2,"1,-7"
20587,720575940618293720,right,Tm3,125,5,9,-1,10,"5,9"
20588,720575940625537176,right,Tm3,126,3,11,2,9,"3,11"
20589,720575940621449654,right,Tm3,127,0,15,7,8,"0,15"
20590,720575940621936666,right,Tm3,128,3,-22,-14,-8,"3,-22"
20591,720575940610511314,right,Tm3,129,0,-13,-7,-6,"0,-13"
20592,720575940620478629,right,Tm3,130,2,12,4,8,"2,12"
20593,720575940629455415,right,Tm3,131,-6,20,16,4,"-6,20"
20594,720575940623440678,right,Tm3,132,2,4,0,4,"2,4"
20595,720575940625601613,right,Tm3,133,-3,20,13,7,"-3,20"
20596,720575940638140132,right,Tm3,134,-5,-18,-4,-14,"-5,-18"
20597,720575940632438546,right,Tm3,135,-3,-22,-8,-14,"-3,-22"
20598,720575940633546015,right,Tm3,136,0,3,1,2,"0,3"
20599,720575940623666116,right,Tm3,137,5,-7,-9,2,"5,-7"
20600,720575940614534142,right,Tm3,138,0,27,13,14,"0,27"
20601,720575940626616322,right,Tm3,139,1,-14,-8,-6,"1,-14"
20602,720575940623392148,right,Tm3,141,5,-23,-17,-6,"5,-23"
20603,720575940621659374,right,Tm3,142,-2,-18,-7,-11,"-2,-18"
20604,720575940623144141,right,Tm3,143,-4,16,12,4,"-4,16"
20605,720575940660081537,right,Tm3,144,7,-11,-13,2,"7,-11"
20606,720575940632783160,right,Tm3,145,0,4,2,2,"0,4"
20607,720575940631136825,right,Tm3,146,1,-6,-4,-2,"1,-6"
20608,720575940626890284,right,Tm3,147,1,21,9,12,"1,21"
20609,720575940624698004,right,Tm3,148,-7,-11,1,-12,"-7,-11"
20610,720575940604561510,right,Tm3,149,6,-14,-13,-1,"6,-14"
20611,720575940619430064,right,Tm3,150,-8,5,10,-5,"-8,5"
20612,720575940605597886,right,Tm3,151,-3,-14,-4,-10,"-3,-14"
20613,720575940620901759,right,Tm3,152,3,-15,-11,-4,"3,-15"
20614,720575940638937789,right,Tm3,154,-8,0,8,-8,"-8,0"
20615,720575940628887772,right,Tm3,155,-8,13,14,-1,"-8,13"
20616,720575940631306600,right,Tm3,156,-9,1,9,-8,"-9,1"
20617,720575940635144372,right,Tm3,157,-1,-7,-3,-4,"-1,-7"
20618,720575940632461881,right,Tm3,158,3,-5,-6,1,"3,-5"
20619,720575940620443007,right,Tm3,160,-2,20,12,8,"-2,20"
20620,720575940627837713,right,Tm3,161,4,-14,-11,-3,"4,-14"
20621,720575940624262379,right,Tm3,162,-4,-2,3,-5,"-4,-2"
20622,720575940626639485,right,Tm3,164,-1,-2,0,-2,"-1,-2"
20623,720575940636102030,right,Tm3,165,4,16,4,12,"4,16"
20624,720575940611967125,right,Tm3,166,0,18,9,9,"0,18"
20625,720575940618734144,right,Tm3,167,0,-17,-9,-8,"0,-17"
20626,720575940639886707,right,Tm3,168,-1,17,9,8,"-1,17"
20627,720575940627963934,right,Tm3,169,0,-18,-9,-9,"0,-18"
20628,720575940624888812,right,Tm3,170,-5,1,5,-4,"-5,1"
20629,720575940615260522,right,Tm3,171,6,-20,-16,-4,"6,-20"
20630,720575940636794766,right,Tm3,172,1,22,10,12,"1,22"
20631,720575940636579191,right,Tm3,173,2,-25,-15,-10,"2,-25"
20632,720575940617876293,right,Tm3,174,4,-15,-12,-3,"4,-15"
20633,720575940624363261,right,Tm3,175,-6,-7,2,-9,"-6,-7"
20634,720575940631288647,right,Tm3,176,-2,13,8,5,"-2,13"
20635,720575940616412219,right,Tm3,177,-2,-1,1,-2,"-2,-1"
20636,720575940642878772,right,Tm3,178,2,11,3,8,"2,11"
20637,720575940630288695,right,Tm3,179,-5,-16,-3,-13,"-5,-16"
20638,720575940644772388,right,Tm3,180,2,-27,-16,-11,"2,-27"
20639,720575940616190258,right,Tm3,181,1,-4,-3,-1,"1,-4"
20640,720575940629196111,right,Tm3,182,7,-10,-12,2,"7,-10"
20641,720575940622804830,right,Tm3,183,-5,-15,-3,-12,"-5,-15"
20642,720575940632752588,right,Tm3,184,-6,-5,3,-8,"-6,-5"
20643,720575940620159573,right,Tm3,185,2,-11,-8,-3,"2,-11"
20644,720575940610686766,right,Tm3,186,-1,26,14,12,"-1,26"
20645,720575940645608046,right,Tm3,187,3,21,7,14,"3,21"
20646,720575940614973546,right,Tm3,188,-5,17,13,4,"-5,17"
20647,720575940627851592,right,Tm3,189,6,13,0,13,"6,13"
20648,720575940616386705,right,Tm3,190,-3,-5,0,-5,"-3,-5"
20649,720575940628673027,right,Tm3,191,-1,-11,-5,-6,"-1,-11"
20650,720575940611126392,right,Tm3,193,-5,4,7,-3,"-5,4"
20651,720575940629025027,right,Tm3,194,0,-5,-3,-2,"0,-5"
20652,720575940651954166,right,Tm3,195,-3,-1,2,-3,"-3,-1"
20653,720575940638551273,right,Tm3,196,-1,8,5,3,"-1,8"
20654,720575940619929479,right,Tm3,197,0,-20,-10,-10,"0,-20"
20655,720575940639208164,right,Tm3,198,6,2,-5,7,"6,2"
20656,720575940621484982,right,Tm3,199,0,-12,-6,-6,"0,-12"
20657,720575940620401505,right,Tm3,200,-5,12,11,1,"-5,12"
20658,720575940634817178,right,Tm3,202,-1,27,14,13,"-1,27"
20659,720575940618902619,right,Tm3,203,3,-1,-4,3,"3,-1"
20660,720575940624569276,right,Tm3,204,5,-2,-6,4,"5,-2"
20661,720575940647657604,right,Tm3,205,5,-6,-8,2,"5,-6"
20662,720575940617790548,right,Tm3,206,-3,5,5,0,"-3,5"
20663,720575940622981500,right,Tm3,207,1,29,13,16,"1,29"
20664,720575940619287198,right,Tm3,208,5,-21,-16,-5,"5,-21"
20665,720575940634356193,right,Tm3,209,-3,-8,-1,-7,"-3,-8"
20666,720575940618242384,right,Tm3,210,-6,8,10,-2,"-6,8"
20667,720575940630721295,right,Tm3,211,-7,-1,6,-7,"-7,-1"
20668,720575940626490024,right,Tm3,212,2,-16,-10,-6,"2,-16"
20669,720575940620446228,right,Tm3,213,3,-4,-5,1,"3,-4"
20670,720575940622351137,right,Tm3,214,-5,3,6,-3,"-5,3"
20671,720575940626874133,right,Tm3,215,6,7,-3,10,"6,7"
20672,720575940639533646,right,Tm3,216,2,19,7,12,"2,19"
20673,720575940614872738,right,Tm3,218,2,10,3,7,"2,10"
20674,720575940636686734,right,Tm3,219,6,-4,-8,4,"6,-4"
20675,720575940618579797,right,Tm3,220,2,-6,-5,-1,"2,-6"
20676,720575940619971755,right,Tm3,221,-7,3,8,-5,"-7,3"
20677,720575940633560462,right,Tm3,222,-3,26,16,10,"-3,26"
20678,720575940638300388,right,Tm3,223,-2,26,15,11,"-2,26"
20679,720575940637348464,right,Tm3,224,0,5,2,3,"0,5"
20680,720575940626573886,right,Tm3,225,2,-26,-15,-11,"2,-26"
20681,720575940611981283,right,Tm3,226,5,19,4,15,"5,19"
20682,720575940636383600,right,Tm3,227,-7,5,9,-4,"-7,5"
20683,720575940617829445,right,Tm3,228,-7,1,7,-6,"-7,1"
20684,720575940626476184,right,Tm3,229,5,2,-4,6,"5,2"
20685,720575940626661050,right,Tm3,230,2,9,2,7,"2,9"
20686,720575940625431652,right,Tm3,231,4,-12,-10,-2,"4,-12"
20687,720575940633808270,right,Tm3,232,-4,13,10,3,"-4,13"
20688,720575940627226895,right,Tm3,233,4,-13,-11,-2,"4,-13"
20689,720575940611550254,right,Tm3,234,1,3,0,3,"1,3"
20690,720575940629040487,right,Tm3,235,4,11,1,10,"4,11"
20691,720575940629867515,right,Tm3,236,-1,4,3,1,"-1,4"
20692,720575940625091149,right,Tm3,237,-2,27,15,12,"-2,27"
20693,720575940621546501,right,Tm3,238,-8,-3,6,-9,"-8,-3"
20694,720575940620293824,right,Tm3,240,-4,-3,2,-5,"-4,-3"
20695,720575940635799476,right,Tm3,241,2,-17,-11,-6,"2,-17"
20696,720575940618880566,right,Tm3,242,-4,6,7,-1,"-4,6"
20697,720575940621859354,right,Tm3,243,-1,-21,-10,-11,"-1,-21"
20698,720575940629383754,right,Tm3,244,-4,-12,-2,-10,"-4,-12"
20699,720575940618283293,right,Tm3,245,-5,-3,3,-6,"-5,-3"
20700,720575940617529049,right,Tm3,246,-4,15,11,4,"-4,15"
20701,720575940617328982,right,Tm3,247,-4,-15,-4,-11,"-4,-15"
20702,720575940629626368,right,Tm3,248,-6,0,6,-6,"-6,0"
20703,720575940625569101,right,Tm3,249,2,-12,-8,-4,"2,-12"
20704,720575940634123418,right,Tm3,250,-1,1,1,0,"-1,1"
20705,720575940660027009,right,Tm3,251,-1,-14,-6,-8,"-1,-14"
20706,720575940605787494,right,Tm3,252,3,23,8,15,"3,23"
20707,720575940639542606,right,Tm3,253,5,16,3,13,"5,16"
20708,720575940635151641,right,Tm3,254,3,-24,-15,-9,"3,-24"
20709,720575940626156365,right,Tm3,255,-6,-13,-1,-12,"-6,-13"
20710,720575940620827841,right,Tm3,256,5,-20,-15,-5,"5,-20"
20711,720575940620677056,right,Tm3,257,2,21,8,13,"2,21"
20712,720575940625140238,right,Tm3,258,-4,-17,-5,-12,"-4,-17"
20713,720575940652021750,right,Tm3,259,-7,-5,4,-9,"-7,-5"
20714,720575940630093628,right,Tm3,260,-3,19,12,7,"-3,19"
20715,720575940626138298,right,Tm3,261,-1,13,7,6,"-1,13"
20716,720575940606806961,right,Tm3,262,1,-11,-7,-4,"1,-11"
20717,720575940621496959,right,Tm3,263,-3,4,5,-1,"-3,4"
20718,720575940639687283,right,Tm3,264,-1,-6,-2,-4,"-1,-6"
20719,720575940630127932,right,Tm3,265,-6,-1,5,-6,"-6,-1"
20720,720575940606809009,right,Tm3,266,-1,-25,-12,-13,"-1,-25"
20721,720575940632314705,right,Tm3,268,7,-6,-10,4,"7,-6"
20722,720575940615935756,right,Tm3,269,2,-19,-12,-7,"2,-19"
20723,720575940617654365,right,Tm3,270,1,-8,-5,-3,"1,-8"
20724,720575940624557565,right,Tm3,271,4,6,-1,7,"4,6"
20725,720575940625337637,right,Tm3,272,3,-2,-4,2,"3,-2"
20726,720575940622602334,right,Tm3,273,-6,23,17,6,"-6,23"
20727,720575940632211596,right,Tm3,275,-8,-1,7,-8,"-8,-1"
20728,720575940602398473,right,Tm3,276,2,3,-1,4,"2,3"
20729,720575940630196279,right,Tm3,277,7,-3,-9,6,"7,-3"
20730,720575940625442570,right,Tm3,278,-5,10,10,0,"-5,10"
20731,720575940621665988,right,Tm3,279,-4,8,8,0,"-4,8"
20732,720575940644016072,right,Tm3,280,-6,-14,-1,-13,"-6,-14"
20733,720575940616548411,right,Tm3,281,-9,2,10,-8,"-9,2"
20734,720575940623550983,right,Tm3,282,0,26,13,13,"0,26"
20735,720575940616114374,right,Tm3,283,-4,4,6,-2,"-4,4"
20736,720575940624832404,right,Tm3,284,0,25,12,13,"0,25"
20737,720575940616751989,right,Tm3,285,6,-18,-15,-3,"6,-18"
20738,720575940619259806,right,Tm3,286,0,-24,-12,-12,"0,-24"
20739,720575940633913230,right,Tm3,287,-5,13,11,2,"-5,13"
20740,720575940613101541,right,Tm3,288,-1,30,16,14,"-1,30"
20741,720575940619119921,right,Tm3,289,-1,11,6,5,"-1,11"
20742,720575940620501780,right,Tm3,290,5,-24,-17,-7,"5,-24"
20743,720575940634225363,right,Tm3,291,7,2,-6,8,"7,2"
20744,720575940623921847,right,Tm3,292,-4,18,13,5,"-4,18"
20745,720575940643950752,right,Tm3,293,4,-17,-13,-4,"4,-17"
20746,720575940621193825,right,Tm3,294,1,-20,-11,-9,"1,-20"
20747,720575940637139312,right,Tm3,295,-2,29,16,13,"-2,29"
20748,720575940620497172,right,Tm3,296,1,-18,-10,-8,"1,-18"
20749,720575940616398917,right,Tm3,298,-5,5,7,-2,"-5,5"
20750,720575940618101917,right,Tm3,299,-4,12,10,2,"-4,12"
20751,720575940608911113,right,Tm3,300,4,-18,-13,-5,"4,-18"
20752,720575940628956631,right,Tm3,301,-5,16,13,3,"-5,16"
20753,720575940633283373,right,Tm3,302,2,17,6,11,"2,17"
20754,720575940618358299,right,Tm3,303,-5,22,16,6,"-5,22"
20755,720575940622914026,right,Tm3,305,-7,4,9,-5,"-7,4"
20756,720575940626381564,right,Tm3,308,-5,8,9,-1,"-5,8"
20757,720575940617134494,right,Tm3,309,-6,12,12,0,"-6,12"
20758,720575940614389969,right,Tm3,310,2,22,9,13,"2,22"
20759,720575940620378239,right,Tm3,311,-7,15,14,1,"-7,15"
20760,720575940619319454,right,Tm3,312,4,-7,-8,1,"4,-7"
20761,720575940617355707,right,Tm3,313,7,3,-6,9,"7,3"
20762,720575940624776380,right,Tm3,314,-9,5,11,-6,"-9,5"
20763,720575940628393988,right,Tm3,315,-3,-6,0,-6,"-3,-6"
20764,720575940620745563,right,Tm3,316,5,-4,-7,3,"5,-4"
20765,720575940603383008,right,Tm3,317,-5,-4,3,-7,"-5,-4"
20766,720575940617773851,right,Tm3,318,4,-19,-14,-5,"4,-19"
20767,720575940639558197,right,Tm3,319,-2,5,4,1,"-2,5"
20768,720575940627093766,right,Tm3,320,-2,-5,-1,-4,"-2,-5"
20769,720575940616148383,right,Tm3,321,8,4,-6,10,"8,4"
20770,720575940619987147,right,Tm3,322,2,26,11,15,"2,26"
20771,720575940614838971,right,Tm3,323,-7,-13,0,-13,"-7,-13"
20772,720575940623864554,right,Tm3,324,3,24,9,15,"3,24"
20773,720575940612398834,right,Tm3,325,5,1,-5,6,"5,1"
20774,720575940621380116,right,Tm3,326,2,16,6,10,"2,16"
20775,720575940627997821,right,Tm3,327,5,3,-4,7,"5,3"
20776,720575940627301391,right,Tm3,328,5,-9,-10,1,"5,-9"
20777,720575940625342908,right,Tm3,329,0,24,12,12,"0,24"
20778,720575940610995832,right,Tm3,330,3,3,-2,5,"3,3"
20779,720575940623189773,right,Tm3,331,1,-15,-9,-6,"1,-15"
20780,720575940617683857,right,Tm3,332,4,-26,-17,-9,"4,-26"
20781,720575940627677071,right,Tm3,333,0,-21,-11,-10,"0,-21"
20782,720575940627667794,right,Tm3,334,1,-26,-14,-12,"1,-26"
20783,720575940623948012,right,Tm3,335,2,8,2,6,"2,8"
20784,720575940619170358,right,Tm3,336,0,23,11,12,"0,23"
20785,720575940624627691,right,Tm3,337,-5,-6,2,-8,"-5,-6"
20786,720575940621980365,right,Tm3,338,-1,0,1,-1,"-1,0"
20787,720575940632395662,right,Tm3,340,-4,17,12,5,"-4,17"
20788,720575940630819944,right,Tm3,341,6,-17,-15,-2,"6,-17"
20789,720575940622444179,right,Tm3,342,2,-15,-10,-5,"2,-15"
20790,720575940627257469,right,Tm3,343,-3,27,16,11,"-3,27"
20791,720575940608914018,right,Tm3,344,-2,-15,-6,-9,"-2,-15"
20792,720575940627991812,right,Tm3,345,3,-12,-9,-3,"3,-12"
20793,720575940610066894,right,Tm3,346,-7,-9,2,-11,"-7,-9"
20794,720575940632077368,right,Tm3,347,-5,-13,-2,-11,"-5,-13"
20795,720575940616742517,right,Tm3,348,3,14,4,10,"3,14"
20796,720575940627181955,right,Tm3,349,-5,-14,-2,-12,"-5,-14"
20797,720575940615182759,right,Tm3,350,1,15,6,9,"1,15"
20798,720575940636966377,right,Tm3,351,-1,-17,-8,-9,"-1,-17"
20799,720575940627782673,right,Tm3,352,-2,28,16,12,"-2,28"
20800,720575940629716730,right,Tm3,353,2,24,10,14,"2,24"
20801,720575940623300134,right,Tm3,354,-2,-26,-11,-15,"-2,-26"
20802,720575940612763306,right,Tm3,355,-7,-6,4,-10,"-7,-6"
20803,720575940636793486,right,Tm3,356,0,22,11,11,"0,22"
20804,720575940623322637,right,Tm3,357,4,17,4,13,"4,17"
20805,720575940617566347,right,Tm3,358,-3,17,11,6,"-3,17"
20806,720575940627241865,right,Tm3,359,2,23,9,14,"2,23"
20807,720575940627745918,right,Tm3,360,-5,19,14,5,"-5,19"
20808,720575940616388831,right,Tm3,361,0,-7,-4,-3,"0,-7"
20809,720575940622993131,right,Tm3,362,2,-20,-12,-8,"2,-20"
20810,720575940615221354,right,Tm3,363,7,-4,-9,5,"7,-4"
20811,720575940639092713,right,Tm3,364,4,4,-2,6,"4,4"
20812,720575940628304394,right,Tm3,365,4,7,-1,8,"4,7"
20813,720575940629697834,right,Tm3,366,-5,-20,-5,-15,"-5,-20"
20814,720575940610768504,right,Tm3,367,-6,-15,-2,-13,"-6,-15"
20815,720575940619880692,right,Tm3,368,-4,-20,-6,-14,"-4,-20"
20816,720575940618277917,right,Tm3,369,5,-5,-8,3,"5,-5"
20817,720575940632073612,right,Tm3,370,-3,21,13,8,"-3,21"
20818,720575940635595444,right,Tm3,371,6,-5,-9,4,"6,-5"
20819,720575940638333749,right,Tm3,372,1,-2,-2,0,"1,-2"
20820,720575940615308906,right,Tm3,373,1,-21,-12,-9,"1,-21"
20821,720575940619623070,right,Tm3,374,2,13,4,9,"2,13"
20822,720575940605157990,right,Tm3,375,-6,7,9,-2,"-6,7"
20823,720575940613542314,right,Tm3,377,0,7,3,4,"0,7"
20824,720575940617846941,right,Tm3,378,-3,18,12,6,"-3,18"
20825,720575940629740538,right,Tm3,379,3,-17,-12,-5,"3,-17"
20826,720575940613865842,right,Tm3,380,-1,29,15,14,"-1,29"
20827,720575940647437956,right,Tm3,381,-8,-9,3,-12,"-8,-9"
20828,720575940618430923,right,Tm3,382,3,-6,-6,0,"3,-6"
20829,720575940642957860,right,Tm3,383,-6,11,11,0,"-6,11"
20830,720575940627642938,right,Tm3,384,-6,-2,5,-7,"-6,-2"
20831,720575940625769253,right,Tm3,385,-3,-18,-6,-12,"-3,-18"
20832,720575940612841890,right,Tm3,386,-6,19,15,4,"-6,19"
20833,720575940628476678,right,Tm3,387,-1,-15,-7,-8,"-1,-15"
20834,720575940626786490,right,Tm3,388,3,19,6,13,"3,19"
20835,720575940622224166,right,Tm3,390,-6,-9,1,-10,"-6,-9"
20836,720575940608828425,right,Tm3,391,4,-3,-6,3,"4,-3"
20837,720575940629480314,right,Tm3,392,-4,7,7,0,"-4,7"
20838,720575940619779288,right,Tm3,393,-1,22,12,10,"-1,22"
20839,720575940604341280,right,Tm3,394,-7,-8,3,-11,"-7,-8"
20840,720575940636888206,right,Tm3,395,0,-22,-11,-11,"0,-22"
20841,720575940615440295,right,Tm3,396,-1,10,6,4,"-1,10"
20842,720575940621659886,right,Tm3,397,-3,-19,-7,-12,"-3,-19"
20843,720575940619281249,right,Tm3,398,-3,22,14,8,"-3,22"
20844,720575940626708482,right,Tm3,399,-4,-24,-8,-16,"-4,-24"
20845,720575940625637048,right,Tm3,400,1,-29,-16,-13,"1,-29"
20846,720575940620950694,right,Tm3,401,-2,-19,-8,-11,"-2,-19"
20847,720575940614972583,right,Tm3,402,3,26,10,16,"3,26"
20848,720575940617550902,right,Tm3,403,-2,-12,-4,-8,"-2,-12"
20849,720575940614707879,right,Tm3,404,-1,20,11,9,"-1,20"
20850,720575940628473084,right,Tm3,405,3,10,2,8,"3,10"
20851,720575940632602415,right,Tm3,406,1,-25,-14,-11,"1,-25"
20852,720575940628164840,right,Tm3,407,-5,-10,0,-10,"-5,-10"
20853,720575940623481781,right,Tm3,408,-6,-4,4,-8,"-6,-4"
20854,720575940616792413,right,Tm3,409,0,-3,-2,-1,"0,-3"
20855,720575940629210668,right,Tm3,410,-2,-2,1,-3,"-2,-2"
20856,720575940630237239,right,Tm3,411,-5,-19,-5,-14,"-5,-19"
20857,720575940634533751,right,Tm3,412,-6,21,16,5,"-6,21"
20858,720575940606475465,right,Tm3,413,-2,-7,-2,-5,"-2,-7"
20859,720575940622763485,right,Tm3,414,4,21,6,15,"4,21"
20860,720575940622901033,right,Tm3,415,6,12,0,12,"6,12"
20861,720575940629028880,right,Tm3,416,3,-8,-7,-1,"3,-8"
20862,720575940607365129,right,Tm3,417,-6,-10,1,-11,"-6,-10"
20863,720575940627080236,right,Tm3,418,-2,15,9,6,"-2,15"
20864,720575940616166873,right,Tm3,419,-3,-11,-3,-8,"-3,-11"
20865,720575940627824458,right,Tm3,420,6,-3,-8,5,"6,-3"
20866,720575940611903346,right,Tm3,421,-1,12,7,5,"-1,12"
20867,720575940609313884,right,Tm3,423,3,-18,-12,-6,"3,-18"
20868,720575940631989049,right,Tm3,424,-3,-2,2,-4,"-3,-2"
20869,720575940605883494,right,Tm3,425,3,20,7,13,"3,20"
20870,720575940641172213,right,Tm3,426,-3,0,3,-3,"-3,0"
20871,720575940648701572,right,Tm3,427,5,-18,-14,-4,"5,-18"
20872,720575940640868560,right,Tm3,428,-2,23,13,10,"-2,23"
20873,720575940630266619,right,Tm3,429,-2,14,9,5,"-2,14"
20874,720575940621235952,right,Tm3,430,-3,-7,-1,-6,"-3,-7"
20875,720575940636727950,right,Tm3,431,-2,-10,-3,-7,"-2,-10"
20876,720575940612722661,right,Tm3,432,-5,7,8,-1,"-5,7"
20877,720575940619785351,right,Tm3,433,0,-8,-4,-4,"0,-8"
20878,720575940634929003,right,Tm3,434,-3,7,6,1,"-3,7"
20879,720575940627129346,right,Tm3,435,5,-17,-14,-3,"5,-17"
20880,720575940624874900,right,Tm3,436,0,-15,-8,-7,"0,-15"
20881,720575940607106761,right,Tm3,437,-3,12,9,3,"-3,12"
20882,720575940604897248,right,Tm3,438,2,27,11,16,"2,27"
20883,720575940611839893,right,Tm3,439,-3,-9,-2,-7,"-3,-9"
20884,720575940638848326,right,Tm3,440,1,23,10,13,"1,23"
20885,720575940629131516,right,Tm3,441,3,-16,-11,-5,"3,-16"
20886,720575940632464353,right,Tm3,442,-5,25,17,8,"-5,25"
20887,720575940612917922,right,Tm3,443,-6,4,8,-4,"-6,4"
20888,720575940612909029,right,Tm3,444,4,-10,-9,-1,"4,-10"
20889,720575940643512992,right,Tm3,445,-2,8,6,2,"-2,8"
20890,720575940627775019,right,Tm3,446,2,-14,-9,-5,"2,-14"
20891,720575940636343732,right,Tm3,447,-1,2,2,0,"-1,2"
20892,720575940629932666,right,Tm3,449,6,-16,-14,-2,"6,-16"
20893,720575940614653615,right,Tm3,450,2,-9,-7,-2,"2,-9"
20894,720575940607674034,right,Tm3,451,4,20,6,14,"4,20"
20895,720575940627938314,right,Tm3,452,1,-9,-6,-3,"1,-9"
20896,720575940626914429,right,Tm3,453,3,25,9,16,"3,25"
20897,720575940626078864,right,Tm3,454,5,-12,-11,-1,"5,-12"
20898,720575940655271585,right,Tm3,455,7,-7,-11,4,"7,-7"
20899,720575940621197900,right,Tm3,456,0,21,10,11,"0,21"
20900,720575940614948674,right,Tm3,457,-2,17,10,7,"-2,17"
20901,720575940624165815,right,Tm3,458,5,0,-5,5,"5,0"
20902,720575940641437173,right,Tm3,459,5,-3,-7,4,"5,-3"
20903,720575940645489518,right,Tm3,460,-3,-20,-7,-13,"-3,-20"
20904,720575940616629282,right,Tm3,461,7,-5,-10,5,"7,-5"
20905,720575940620826388,right,Tm3,462,-1,18,10,8,"-1,18"
20906,720575940610535492,right,Tm3,463,5,17,3,14,"5,17"
20907,720575940610463939,right,Tm3,464,4,0,-4,4,"4,0"
20908,720575940612483606,right,Tm3,465,3,0,-3,3,"3,0"
20909,720575940627071276,right,Tm3,466,1,14,6,8,"1,14"
20910,720575940630989655,right,Tm3,467,-2,-20,-8,-12,"-2,-20"
20911,720575940624067563,right,Tm3,468,-3,11,8,3,"-3,11"
20912,720575940642081440,right,Tm3,469,-7,13,13,0,"-7,13"
20913,720575940655067553,right,Tm3,470,4,-9,-9,0,"4,-9"
20914,720575940623319053,right,Tm3,472,1,25,11,14,"1,25"
20915,720575940615432415,right,Tm3,473,-4,23,15,8,"-4,23"
20916,720575940616646289,right,Tm3,474,-3,-17,-6,-11,"-3,-17"
20917,720575940652862198,right,Tm3,475,-4,-1,3,-4,"-4,-1"
20918,720575940622298326,right,Tm3,476,-1,15,8,7,"-1,15"
20919,720575940608430091,right,Tm3,477,-3,2,4,-2,"-3,2"
20920,720575940642581920,right,Tm3,478,-7,16,15,1,"-7,16"
20921,720575940629473918,right,Tm3,479,-2,10,7,3,"-2,10"
20922,720575940627850343,right,Tm3,480,3,-19,-13,-6,"3,-19"
20923,720575940631685162,right,Tm3,481,4,-8,-8,0,"4,-8"
20924,720575940623764774,right,Tm3,482,1,17,7,10,"1,17"
20925,720575940632834967,right,Tm3,483,2,-7,-6,-1,"2,-7"
20926,720575940625785617,right,Tm3,484,3,-9,-8,-1,"3,-9"
20927,720575940619502552,right,Tm3,485,-3,-3,1,-4,"-3,-3"
20928,720575940625650434,right,Tm3,486,0,1,0,1,"0,1"
20929,720575940608214852,right,Tm3,487,1,-1,-2,1,"1,-1"
20930,720575940609128405,right,Tm3,488,7,5,-5,10,"7,5"
20931,720575940616203318,right,Tm3,489,-3,10,8,2,"-3,10"
20932,720575940623376362,right,Tm3,490,-5,6,8,-2,"-5,6"
20933,720575940632810188,right,Tm3,491,7,-1,-8,7,"7,-1"
20934,720575940629764858,right,Tm3,492,-7,-2,6,-8,"-7,-2"
20935,720575940616310578,right,Tm3,493,-3,23,14,9,"-3,23"
20936,720575940608326274,right,Tm3,494,0,29,14,15,"0,29"
20937,720575940624797223,right,Tm3,497,6,1,-6,7,"6,1"
20938,720575940629947330,right,Tm3,498,6,10,-1,11,"6,10"
20939,720575940627198564,right,Tm3,499,5,10,0,10,"5,10"
20940,720575940622618913,right,Tm3,500,7,-8,-11,3,"7,-8"
20941,720575940644500334,right,Tm3,501,1,2,0,2,"1,2"
20942,720575940611106680,right,Tm3,502,5,8,-1,9,"5,8"
20943,720575940614608081,right,Tm3,503,3,17,5,12,"3,17"
20944,720575940628387898,right,Tm3,504,-2,9,6,3,"-2,9"
20945,720575940627704316,right,Tm3,506,1,-12,-7,-5,"1,-12"
20946,720575940636272270,right,Tm3,507,-5,-12,-1,-11,"-5,-12"
20947,720575940628127729,right,Tm3,508,-5,11,10,1,"-5,11"
20948,720575940606793906,right,Tm3,509,-4,10,9,1,"-4,10"
20949,720575940606496178,right,Tm3,510,-2,11,7,4,"-2,11"
20950,720575940625657786,right,Tm3,511,5,-11,-11,0,"5,-11"
20951,720575940622054832,right,Tm3,512,6,0,-6,6,"6,0"
20952,720575940627217563,right,Tm3,513,-4,-13,-3,-10,"-4,-13"
20953,720575940626282954,right,Tm3,514,-4,-10,-1,-9,"-4,-10"
20954,720575940635212280,right,Tm3,515,-8,-7,4,-11,"-8,-7"
20955,720575940624169165,right,Tm3,517,6,3,-5,8,"6,3"
20956,720575940621627062,right,Tm3,518,-4,22,15,7,"-4,22"
20957,720575940607527602,right,Tm3,519,-5,-5,2,-7,"-5,-5"
20958,720575940623416600,right,Tm3,520,-2,-22,-9,-13,"-2,-22"
20959,720575940615997663,right,Tm3,521,6,-9,-11,2,"6,-9"
20960,720575940624322599,right,Tm3,522,-4,0,4,-4,"-4,0"
20961,720575940646642979,right,Tm3,523,2,14,5,9,"2,14"
20962,720575940630780780,right,Tm3,524,4,-20,-14,-6,"4,-20"
20963,720575940635225791,right,Tm3,525,-1,-20,-9,-11,"-1,-20"
20964,720575940630641372,right,Tm3,526,0,-10,-5,-5,"0,-10"
20965,720575940622417697,right,Tm3,527,-4,-8,0,-8,"-4,-8"
20966,720575940622560244,right,Tm3,528,2,7,1,6,"2,7"
20967,720575940632065640,right,Tm3,529,2,-2,-3,1,"2,-2"
20968,720575940634263196,right,Tm3,530,-3,-13,-4,-9,"-3,-13"
20969,720575940615302818,right,Tm3,531,1,0,-1,1,"1,0"
20970,720575940611687488,right,Tm3,532,-8,7,11,-4,"-8,7"
20971,720575940630491899,right,Tm3,533,0,-16,-8,-8,"0,-16"
20972,720575940613801965,right,Tm3,534,3,2,-2,4,"3,2"
20973,720575940620697537,right,Tm3,535,8,-4,-10,6,"8,-4"
20974,720575940624202239,right,Tm3,536,3,4,-1,5,"3,4"
20975,720575940635281247,right,Tm3,537,0,-23,-12,-11,"0,-23"
20976,720575940630439016,right,Tm3,538,-4,1,4,-3,"-4,1"
20977,720575940625177090,right,Tm3,539,-6,15,13,2,"-6,15"
20978,720575940619105985,right,Tm3,540,-2,-9,-3,-6,"-2,-9"
20979,720575940633912718,right,Tm3,541,-4,14,11,3,"-4,14"
20980,720575940626533122,right,Tm3,542,6,-13,-13,0,"6,-13"
20981,720575940623318408,right,Tm3,543,-1,-4,-1,-3,"-1,-4"
20982,720575940625544435,right,Tm3,544,3,-13,-10,-3,"3,-13"
20983,720575940641294837,right,Tm3,545,5,11,0,11,"5,11"
20984,720575940618442917,right,Tm3,546,3,6,0,6,"3,6"
20985,720575940642269325,right,Tm3,547,-1,21,11,10,"-1,21"
20986,720575940626020752,right,Tm3,548,1,-16,-9,-7,"1,-16"
20987,720575940625990146,right,Tm3,549,0,-9,-5,-4,"0,-9"
20988,720575940628905802,right,Tm3,550,-2,3,3,0,"-2,3"
20989,720575940616151238,right,Tm3,551,-4,-9,-1,-8,"-4,-9"
20990,720575940611285858,right,Tm3,552,4,-1,-5,4,"4,-1"
20991,720575940639159273,right,Tm3,553,-3,16,11,5,"-3,16"
20992,720575940616336923,right,Tm3,555,-4,9,8,1,"-4,9"
20993,720575940619063892,right,Tm3,556,0,10,5,5,"0,10"
20994,720575940628455546,right,Tm3,557,6,-10,-11,1,"6,-10"
20995,720575940630559488,right,Tm3,558,-4,-21,-7,-14,"-4,-21"
20996,720575940645253155,right,Tm3,559,-6,22,17,5,"-6,22"
20997,720575940604076990,right,Tm3,560,-7,14,14,0,"-7,14"
20998,720575940631207468,right,Tm3,561,5,7,-2,9,"5,7"
20999,720575940635936613,right,Tm3,562,-5,-2,4,-6,"-5,-2"
21000,720575940631441464,right,Tm3,563,5,-13,-12,-1,"5,-13"
21001,720575940617808614,right,Tm3,564,3,-23,-15,-8,"3,-23"
21002,720575940612468965,right,Tm3,565,0,-26,-13,-13,"0,-26"
21003,720575940625025255,right,Tm3,566,5,-8,-9,1,"5,-8"
21004,720575940625319205,right,Tm3,567,-2,22,13,9,"-2,22"
21005,720575940626087568,right,Tm3,568,-6,-8,2,-10,"-6,-8"
21006,720575940625071548,right,Tm3,570,2,25,10,15,"2,25"
21007,720575940617582804,right,Tm3,571,0,-14,-7,-7,"0,-14"
21008,720575940635761144,right,Tm3,573,4,14,3,11,"4,14"
21009,720575940629684474,right,Tm3,575,6,9,-2,11,"6,9"
21010,720575940622206725,right,Tm3,576,0,28,14,14,"0,28"
21011,720575940639593038,right,Tm3,577,5,-14,-12,-2,"5,-14"
21012,720575940627302415,right,Tm3,578,4,-11,-10,-1,"4,-11"
21013,720575940606806193,right,Tm3,579,-3,-10,-2,-8,"-3,-10"
21014,720575940629573882,right,Tm3,580,-2,-23,-10,-13,"-2,-23"
21015,720575940632701011,right,Tm3,581,3,9,1,8,"3,9"
21016,720575940633117265,right,Tm3,582,-1,23,12,11,"-1,23"
21017,720575940607199945,right,Tm3,583,3,-25,-16,-9,"3,-25"
21018,720575940621173158,right,Tm3,584,4,23,7,16,"4,23"
21019,720575940634308322,right,Tm3,585,-1,-23,-11,-12,"-1,-23"
21020,720575940629900926,right,Tm3,586,2,18,7,11,"2,18"
21021,720575940612592626,right,Tm3,587,4,22,7,15,"4,22"
21022,720575940645190088,right,Tm3,588,1,4,1,3,"1,4"
21023,720575940629251966,right,Tm3,589,-1,-5,-2,-3,"-1,-5"
21024,720575940631099735,right,Tm3,590,1,9,3,6,"1,9"
21025,720575940609277230,right,Tm3,591,3,-3,-5,2,"3,-3"
21026,720575940631505679,right,Tm3,593,3,-14,-10,-4,"3,-14"
21027,720575940631425611,right,Tm3,594,7,-16,-15,-1,"7,-16"
21028,720575940641416181,right,Tm3,595,7,-12,-13,1,"7,-12"
21029,720575940628038908,right,Tm3,596,-4,-16,-4,-12,"-4,-16"
21030,720575940617472985,right,Tm3,597,4,1,-4,5,"4,1"
21031,720575940608830475,right,Tm3,598,2,-18,-11,-7,"2,-18"
21032,720575940619872933,right,Tm3,599,-1,9,5,4,"-1,9"
21033,720575940605310398,right,Tm3,600,3,-10,-8,-2,"3,-10"
21034,720575940624365129,right,Tm3,601,1,16,7,9,"1,16"
21035,720575940631193797,right,Tm3,602,4,-2,-5,3,"4,-2"
21036,720575940615419042,right,Tm3,603,-3,-23,-9,-14,"-3,-23"
21037,720575940620335380,right,Tm3,604,-6,-17,-3,-14,"-6,-17"
21038,720575940629849404,right,Tm3,605,3,15,4,11,"3,15"
21039,720575940619888075,right,Tm3,606,-1,-19,-9,-10,"-1,-19"
21040,720575940631316498,right,Tm3,607,1,18,8,10,"1,18"
21041,720575940618215773,right,Tm3,608,1,10,4,6,"1,10"
21042,720575940627218631,right,Tm3,609,-2,0,2,-2,"-2,0"
21043,720575940612662385,right,Tm3,610,2,-23,-14,-9,"2,-23"
21044,720575940618304216,right,Tm3,611,-1,-18,-8,-10,"-1,-18"
21045,720575940615637159,right,Tm3,612,-3,-26,-10,-16,"-3,-26"
21046,720575940630118200,right,Tm3,613,-8,-4,6,-10,"-8,-4"
21047,720575940627254354,right,Tm3,614,-2,-8,-2,-6,"-2,-8"
21048,720575940631341263,right,Tm3,615,-7,-7,3,-10,"-7,-7"
21049,720575940611569198,right,Tm3,616,-3,15,10,5,"-3,15"
21050,720575940639563123,right,Tm3,617,-2,-17,-7,-10,"-2,-17"
21051,720575940616710517,right,Tm3,618,-1,24,13,11,"-1,24"
21052,720575940630760296,right,Tm3,619,-4,-19,-6,-13,"-4,-19"
21053,720575940632199186,right,Tm3,620,7,1,-7,8,"7,1"
21054,720575940646617891,right,Tm3,621,1,24,11,13,"1,24"
21055,720575940634805344,right,Tm3,622,-5,20,15,5,"-5,20"
21056,720575940622201112,right,Tm3,623,1,13,5,8,"1,13"
21057,720575940629136970,right,Tm3,624,1,-17,-10,-7,"1,-17"
21058,720575940605917216,right,Tm3,625,-2,24,14,10,"-2,24"
21059,720575940623211022,right,Tm3,626,-5,-8,1,-9,"-5,-8"
21060,720575940639052888,right,Tm3,627,0,-1,-1,0,"0,-1"
21061,720575940621153306,right,Tm3,628,0,0,0,0,"0,0"
21062,720575940647522180,right,Tm3,629,4,24,8,16,"4,24"
21063,720575940607710421,right,Tm3,630,4,8,0,8,"4,8"
21064,720575940605799968,right,Tm3,631,1,26,12,14,"1,26"
21065,720575940630750283,right,Tm3,632,3,-20,-13,-7,"3,-20"
21066,720575940630665465,right,Tm3,634,-3,-15,-5,-10,"-3,-15"
21067,720575940649368441,right,Tm3,635,6,-6,-9,3,"6,-6"
21068,720575940611602090,right,Tm3,636,0,6,3,3,"0,6"
21069,720575940618375803,right,Tm3,637,3,-21,-14,-7,"3,-21"
21070,720575940635619263,right,Tm3,638,-1,7,4,3,"-1,7"
21071,720575940638445402,right,Tm3,639,-4,19,13,6,"-4,19"
21072,720575940623915957,right,Tm3,640,-1,-16,-7,-9,"-1,-16"
21073,720575940642518157,right,Tm3,641,-8,-5,5,-10,"-8,-5"
21074,720575940615120234,right,Tm3,642,-5,-11,-1,-10,"-5,-11"
21075,720575940607340555,right,Tm3,643,6,14,1,13,"6,14"
21076,720575940619571021,right,Tm3,644,-6,18,15,3,"-6,18"
21077,720575940624811582,right,Tm3,645,-4,27,17,10,"-4,27"
21078,720575940615765866,right,Tm3,646,6,17,2,15,"6,17"
21079,720575940632602195,right,Tm3,647,-4,-7,0,-7,"-4,-7"
21080,720575940638122468,right,Tm3,648,1,7,2,5,"1,7"
21081,720575940627767685,right,Tm3,649,-1,5,3,2,"-1,5"
21082,720575940624200701,right,Tm3,650,-3,-25,-10,-15,"-3,-25"
21083,720575940629976888,right,Tm3,651,-4,-5,1,-6,"-4,-5"
21084,720575940636058735,right,Tm3,652,-6,-11,0,-11,"-6,-11"
21085,720575940615087978,right,Tm3,653,-6,-12,0,-12,"-6,-12"
21086,720575940608373769,right,Tm3,654,-3,8,7,1,"-3,8"
21087,720575940614898850,right,Tm3,655,6,-1,-7,6,"6,-1"
21088,720575940632333103,right,Tm3,656,0,-11,-6,-5,"0,-11"
21089,720575940641226624,right,Tm3,657,-2,-25,-11,-14,"-2,-25"
21090,720575940626335761,right,Tm3,658,1,20,9,11,"1,20"
21091,720575940617714525,right,Tm3,659,-4,-6,1,-7,"-4,-6"
21092,720575940628411409,right,Tm3,660,2,28,12,16,"2,28"
21093,720575940626058128,right,Tm3,661,-3,14,10,4,"-3,14"
21094,720575940630266875,right,Tm3,662,2,-1,-3,2,"2,-1"
21095,720575940632170055,right,Tm3,663,0,8,4,4,"0,8"
21096,720575940632110392,right,Tm3,664,1,-27,-15,-12,"1,-27"
21097,720575940615705693,right,Tm3,665,7,-2,-8,6,"7,-2"
21098,720575940644127432,right,Tm3,668,1,19,8,11,"1,19"
21099,720575940628074345,right,Tm3,669,4,-16,-12,-4,"4,-16"
21100,720575940650461561,right,Tm3,670,5,5,-3,8,"5,5"
21101,720575940623520264,right,Tm3,671,-4,-23,-8,-15,"-4,-23"
21102,720575940633115859,right,Tm3,672,-8,11,13,-2,"-8,11"
21103,720575940627715407,right,Tm3,673,2,5,0,5,"2,5"
21104,720575940616630050,right,Tm3,674,-4,-14,-3,-11,"-4,-14"
21105,720575940613559525,right,Tm3,676,-3,-21,-8,-13,"-3,-21"
21106,720575940660865409,right,Tm3,677,0,11,5,6,"0,11"
21107,720575940606810633,right,Tm3,678,3,-7,-7,0,"3,-7"
21108,720575940627556233,right,Tm3,679,4,18,5,13,"4,18"
21109,720575940618011426,right,Tm3,680,-1,25,13,12,"-1,25"
21110,720575940625650736,right,Tm3,681,-2,-21,-9,-12,"-2,-21"
21111,720575940623655718,right,Tm3,682,6,-8,-10,2,"6,-8"
21112,720575940618551120,right,Tm3,684,-6,17,14,3,"-6,17"
21113,720575940630578396,right,Tm3,685,-5,-9,0,-9,"-5,-9"
21114,720575940641566965,right,Tm3,686,5,-22,-16,-6,"5,-22"
21115,720575940640900304,right,Tm3,687,-6,-3,4,-7,"-6,-3"
21116,720575940626671449,right,Tm3,688,-7,10,12,-2,"-7,10"
21117,720575940628138236,right,Tm3,689,-2,18,11,7,"-2,18"
21118,720575940611745230,right,Tm3,690,-7,-3,5,-8,"-7,-3"
21119,720575940636286042,right,Tm3,691,-9,4,11,-7,"-9,4"
21120,720575940636584567,right,Tm3,692,-4,24,16,8,"-4,24"
21121,720575940626096016,right,Tm3,693,-3,25,15,10,"-3,25"
21122,720575940616445323,right,Tm3,694,4,3,-3,6,"4,3"
21123,720575940618529927,right,Tm3,695,-6,10,11,-1,"-6,10"
21124,720575940631468306,right,Tm3,696,-2,16,10,6,"-2,16"
21125,720575940627897768,right,Tm3,697,1,-22,-12,-10,"1,-22"
21126,720575940609445474,right,Tm3,698,6,-7,-10,3,"6,-7"
21127,720575940616894235,right,Tm3,699,-5,0,5,-5,"-5,0"
21128,720575940625647404,right,Tm3,700,5,15,2,13,"5,15"
21129,720575940627179416,right,Tm3,701,0,-4,-2,-2,"0,-4"
21130,720575940633558158,right,Tm3,702,-5,23,16,7,"-5,23"
21131,720575940630682998,right,Tm3,703,-3,1,3,-2,"-3,1"
21132,720575940621541542,right,Tm3,704,-7,8,11,-3,"-7,8"
21133,720575940620963316,right,Tm3,705,1,1,-1,2,"1,1"
21134,720575940638795846,right,Tm3,707,-2,25,14,11,"-2,25"
21135,720575940620451974,right,Tm3,709,-2,-24,-10,-14,"-2,-24"
21136,720575940623894029,right,Tm3,710,4,-25,-17,-8,"4,-25"
21137,720575940623799477,right,Tm3,711,-1,19,10,9,"-1,19"
21138,720575940608957705,right,Tm3,712,-7,12,13,-1,"-7,12"
21139,720575940637207366,right,Tm3,713,-6,16,14,2,"-6,16"
21140,720575940607248514,right,Tm3,714,5,12,1,11,"5,12"
21141,720575940625851696,right,Tm3,715,4,10,1,9,"4,10"
21142,720575940631662952,right,Tm3,716,4,-6,-7,1,"4,-6"
21143,720575940619712049,right,Tm3,717,2,-22,-13,-9,"2,-22"
21144,720575940639466549,right,Tm3,718,-5,24,17,7,"-5,24"
21145,720575940632261516,right,Tm3,719,1,27,12,15,"1,27"
21146,720575940640905936,right,Tm3,720,-5,21,15,6,"-5,21"
21147,720575940617254261,right,Tm3,721,5,13,1,12,"5,13"
21148,720575940615242357,right,Tm3,722,6,-15,-14,-1,"6,-15"
21149,720575940627211401,right,Tm3,723,-2,-11,-4,-7,"-2,-11"
21150,720575940624047799,right,Tm3,724,4,2,-3,5,"4,2"
21151,720575940630341180,right,Tm3,725,-3,-24,-9,-15,"-3,-24"
21152,720575940631572588,right,Tm3,726,2,-28,-16,-12,"2,-28"
21153,720575940621112673,right,Tm3,728,7,12,-1,13,"7,12"
21154,720575940618869789,right,Tm3,729,-3,29,17,12,"-3,29"
21155,720575940628159464,right,Tm3,730,7,0,-7,7,"7,0"
21156,720575940616389789,right,Tm3,731,-6,9,10,-1,"-6,9"
21157,720575940621665732,right,Tm3,732,-3,6,6,0,"-3,6"
21158,720575940624037815,right,Tm3,733,-5,-17,-4,-13,"-5,-17"
21159,720575940655186081,right,Tm3,734,2,0,-2,2,"2,0"
21160,720575940625529843,right,Tm3,735,1,-23,-13,-10,"1,-23"
21161,720575940610879864,right,Tm3,737,0,19,9,10,"0,19"
21162,720575940632814623,right,Tm3,738,-3,13,9,4,"-3,13"
21163,720575940620878928,right,Tm3,739,-7,2,8,-6,"-7,2"
21164,720575940625073959,right,Tm3,740,2,-8,-6,-2,"2,-8"
21165,720575940612938914,right,Tm3,741,-2,-14,-5,-9,"-2,-14"
21166,720575940627095313,right,Tm3,742,-4,11,9,2,"-4,11"
21167,720575940622143159,right,Tm3,743,6,-19,-16,-3,"6,-19"
21168,720575940627141245,right,Tm3,744,-4,25,16,9,"-4,25"
21169,720575940632859020,right,Tm3,745,0,13,6,7,"0,13"
21170,720575940622110925,right,Tm3,746,-3,3,4,-1,"-3,3"
21171,720575940638925731,right,Tm3,747,0,2,1,1,"0,2"
21172,720575940622281686,right,Tm3,748,-4,20,14,6,"-4,20"
21173,720575940617762699,right,Tm3,749,-2,1,2,-1,"-2,1"
21174,720575940630234624,right,Tm3,750,4,-24,-16,-8,"4,-24"
21175,720575940605103806,right,Tm3,752,-2,7,5,2,"-2,7"
21176,720575940632428871,right,Tm3,753,-3,24,15,9,"-3,24"
21177,720575940633525985,right,Tm3,754,-1,-13,-6,-7,"-1,-13"
21178,720575940626377060,right,Tm3,755,4,19,5,14,"4,19"
21179,720575940633071260,right,Tm3,756,5,20,5,15,"5,20"
21180,720575940626365212,right,Tm3,757,0,-6,-3,-3,"0,-6"
21181,720575940627065606,right,Tm3,758,5,-1,-6,5,"5,-1"
21182,720575940632801709,right,Tm3,759,7,14,0,14,"7,14"
21183,720575940611648179,right,Tm3,760,0,17,8,9,"0,17"
21184,720575940631867223,right,Tm3,761,-4,-18,-5,-13,"-4,-18"
21185,720575940612019162,right,Tm3,762,0,14,7,7,"0,14"
21186,720575940628709740,right,Tm3,763,-5,14,12,2,"-5,14"
21187,720575940627535439,right,Tm3,765,-3,9,7,2,"-3,9"
21188,720575940635233972,right,Tm3,766,2,-4,-4,0,"2,-4"
21189,720575940608964363,right,Tm3,767,1,28,13,15,"1,28"
21190,720575940614096936,right,Tm3,768,3,5,-1,6,"3,5"
21191,720575940633660333,right,Tm3,769,4,-27,-18,-9,"4,-27"
21192,720575940623987480,right,Tm3,772,1,12,5,7,"1,12"
21193,720575940628003560,right,Tm3,773,5,-19,-15,-4,"5,-19"
21194,720575940621354888,right,Tm3,774,-8,6,11,-5,"-8,6"
21195,720575940631951004,right,Tm3,775,5,22,6,16,"5,22"
21196,720575940627942430,right,Tm3,776,5,21,5,16,"5,21"
21197,720575940615587222,right,Tm3,777,6,20,4,16,"6,20"
21198,720575940625404686,right,Tm3,779,5,24,7,17,"5,24"
21199,720575940618693965,right,Tm3,780,-6,25,18,7,"-6,25"
21200,720575940640214360,right,Tm3,782,-5,27,18,9,"-5,27"
21201,720575940610112068,right,Tm3,783,-4,28,18,10,"-4,28"
21202,720575940626475522,right,Tm3,784,-4,29,18,11,"-4,29"
21203,720575940620393131,right,Tm3,785,-3,30,18,12,"-3,30"
21204,720575940647105571,right,Tm3,786,-2,30,17,13,"-2,30"
21205,720575940623261654,right,Tm3,788,3,27,10,17,"3,27"
21206,720575940609486787,right,Tm3,790,-2,-27,-12,-15,"-2,-27"
21207,720575940625680060,right,Tm3,791,-1,-28,-13,-15,"-1,-28"
21208,720575940616182834,right,Tm3,793,8,-6,-11,5,"8,-6"
21209,720575940622127877,right,Tm3,794,5,-26,-18,-8,"5,-26"
21210,720575940608725259,right,Tm3,796,4,26,9,17,"4,26"
21211,720575940603384748,right,Tm4,1,-6,13,12,1,"-6,13"
21212,720575940623113802,right,Tm4,2,-8,2,9,-7,"-8,2"
21213,720575940621769409,right,Tm4,3,6,-12,-12,0,"6,-12"
21214,720575940629704062,right,Tm4,4,-5,-21,-6,-15,"-5,-21"
21215,720575940615013738,right,Tm4,6,-2,-4,0,-4,"-2,-4"
21216,720575940621018790,right,Tm4,7,-6,-6,3,-9,"-6,-6"
21217,720575940623645064,right,Tm4,8,-4,26,17,9,"-4,26"
21218,720575940632769361,right,Tm4,9,4,9,0,9,"4,9"
21219,720575940627501041,right,Tm4,10,5,-15,-13,-2,"5,-15"
21220,720575940619202497,right,Tm4,12,-7,9,11,-2,"-7,9"
21221,720575940606236192,right,Tm4,13,-1,-26,-12,-14,"-1,-26"
21222,720575940629443313,right,Tm4,14,0,-27,-14,-13,"0,-27"
21223,720575940635620203,right,Tm4,15,2,-3,-4,1,"2,-3"
21224,720575940606372798,right,Tm4,16,-2,-16,-6,-10,"-2,-16"
21225,720575940616272434,right,Tm4,17,1,-5,-4,-1,"1,-5"
21226,720575940633015981,right,Tm4,18,5,-16,-13,-3,"5,-16"
21227,720575940626684285,right,Tm4,19,-7,17,15,2,"-7,17"
21228,720575940621648566,right,Tm4,20,3,-11,-9,-2,"3,-11"
21229,720575940621251949,right,Tm4,21,-2,19,11,8,"-2,19"
21230,720575940622289101,right,Tm4,22,-1,3,2,1,"-1,3"
21231,720575940611214573,right,Tm4,23,-3,-16,-5,-11,"-3,-16"
21232,720575940630046780,right,Tm4,24,-1,-10,-4,-6,"-1,-10"
21233,720575940622960764,right,Tm4,26,1,-3,-3,0,"1,-3"
21234,720575940617685460,right,Tm4,27,0,-25,-13,-12,"0,-25"
21235,720575940613568493,right,Tm4,28,5,6,-2,8,"5,6"
21236,720575940623222221,right,Tm4,29,-1,-3,-1,-2,"-1,-3"
21237,720575940619087040,right,Tm4,30,6,16,2,14,"6,16"
21238,720575940633003053,right,Tm4,31,0,16,8,8,"0,16"
21239,720575940633199059,right,Tm4,32,0,12,6,6,"0,12"
21240,720575940642558605,right,Tm4,33,3,18,6,12,"3,18"
21241,720575940610744725,right,Tm4,34,6,18,3,15,"6,18"
21242,720575940606737254,right,Tm4,35,1,-24,-13,-11,"1,-24"
21243,720575940619087739,right,Tm4,36,6,8,-2,10,"6,8"
21244,720575940628538630,right,Tm4,37,1,5,1,4,"1,5"
21245,720575940638965155,right,Tm4,38,0,-2,-1,-1,"0,-2"
21246,720575940607342210,right,Tm4,39,0,20,10,10,"0,20"
21247,720575940618988190,right,Tm4,40,-2,-6,-1,-5,"-2,-6"
21248,720575940618041501,right,Tm4,41,-3,28,17,11,"-3,28"
21249,720575940628188392,right,Tm4,42,-1,14,8,6,"-1,14"
21250,720575940615707078,right,Tm4,43,-5,18,14,4,"-5,18"
21251,720575940612203889,right,Tm4,44,5,-10,-10,0,"5,-10"
21252,720575940624183733,right,Tm4,45,-5,-1,4,-5,"-5,-1"
21253,720575940633131418,right,Tm4,46,-5,15,12,3,"-5,15"
21254,720575940626497352,right,Tm4,47,-9,-1,8,-9,"-9,-1"
21255,720575940610734229,right,Tm4,48,-4,-22,-7,-15,"-4,-22"
21256,720575940613481955,right,Tm4,49,4,-4,-6,2,"4,-4"
21257,720575940611194322,right,Tm4,50,-2,21,12,9,"-2,21"
21258,720575940633356369,right,Tm4,51,0,-19,-10,-9,"0,-19"
21259,720575940619639419,right,Tm4,52,-1,-22,-10,-12,"-1,-22"
21260,720575940626197690,right,Tm4,53,5,14,2,12,"5,14"
21261,720575940608857099,right,Tm4,54,-4,3,5,-2,"-4,3"
21262,720575940623207949,right,Tm4,55,-4,-11,-2,-9,"-4,-11"
21263,720575940636498862,right,Tm4,56,1,-13,-8,-5,"1,-13"
21264,720575940606615473,right,Tm4,57,6,-11,-12,1,"6,-11"
21265,720575940641971419,right,Tm4,58,3,12,3,9,"3,12"
21266,720575940623260599,right,Tm4,59,-2,2,3,-1,"-2,2"
21267,720575940606727945,right,Tm4,60,-8,8,12,-4,"-8,8"
21268,720575940615204714,right,Tm4,61,-4,-4,2,-6,"-4,-4"
21269,720575940625058889,right,Tm4,62,0,-29,-15,-14,"0,-29"
21270,720575940621897968,right,Tm4,63,4,12,2,10,"4,12"
21271,720575940623236566,right,Tm4,64,4,-23,-16,-7,"4,-23"
21272,720575940619359611,right,Tm4,65,-1,28,15,13,"-1,28"
21273,720575940618630469,right,Tm4,66,2,15,5,10,"2,15"
21274,720575940654980769,right,Tm4,67,-2,-13,-5,-8,"-2,-13"
21275,720575940625308174,right,Tm4,68,3,16,5,11,"3,16"
21276,720575940621915486,right,Tm4,70,-4,21,14,7,"-4,21"
21277,720575940629314682,right,Tm4,71,-2,-3,0,-3,"-2,-3"
21278,720575940629886423,right,Tm4,72,0,-28,-14,-14,"0,-28"
21279,720575940619221041,right,Tm4,73,2,2,-1,3,"2,2"
21280,720575940628593143,right,Tm4,75,-6,14,13,1,"-6,14"
21281,720575940633371232,right,Tm4,76,-3,-4,1,-5,"-3,-4"
21282,720575940616333874,right,Tm4,77,2,-5,-5,0,"2,-5"
21283,720575940644197064,right,Tm4,78,2,20,8,12,"2,20"
21284,720575940627167640,right,Tm4,79,2,1,-2,3,"2,1"
21285,720575940632510094,right,Tm4,80,4,13,2,11,"4,13"
21286,720575940639488976,right,Tm4,81,6,-2,-7,5,"6,-2"
21287,720575940630958122,right,Tm4,82,-7,7,10,-3,"-7,7"
21288,720575940635066475,right,Tm4,83,2,-21,-13,-8,"2,-21"
21289,720575940638750542,right,Tm4,84,-2,12,8,4,"-2,12"
21290,720575940617681108,right,Tm4,85,4,-22,-15,-7,"4,-22"
21291,720575940612531442,right,Tm4,86,-5,-7,1,-8,"-5,-7"
21292,720575940614477999,right,Tm4,87,1,11,4,7,"1,11"
21293,720575940623930153,right,Tm4,88,7,4,-5,9,"7,4"
21294,720575940631653317,right,Tm4,89,1,-19,-11,-8,"1,-19"
21295,720575940630193146,right,Tm4,90,-4,5,6,-1,"-4,5"
21296,720575940625823577,right,Tm4,91,-1,6,4,2,"-1,6"
21297,720575940619923797,right,Tm4,94,5,18,4,14,"5,18"
21298,720575940612460211,right,Tm4,95,4,-21,-15,-6,"4,-21"
21299,720575940621373678,right,Tm4,96,1,-10,-6,-4,"1,-10"
21300,720575940630598927,right,Tm4,97,-5,2,6,-4,"-5,2"
21301,720575940638901181,right,Tm4,98,-1,-12,-5,-7,"-1,-12"
21302,720575940607287170,right,Tm4,99,4,15,3,12,"4,15"
21303,720575940623445580,right,Tm4,100,2,-10,-7,-3,"2,-10"
21304,720575940622680772,right,Tm4,101,-7,6,10,-4,"-7,6"
21305,720575940612135010,right,Tm4,102,3,13,3,10,"3,13"
21306,720575940606600638,right,Tm4,104,-1,-27,-13,-14,"-1,-27"
21307,720575940626025104,right,Tm4,105,3,22,8,14,"3,22"
21308,720575940626091672,right,Tm4,106,-7,11,12,-1,"-7,11"
21309,720575940620224116,right,Tm4,107,8,-2,-9,7,"8,-2"
21310,720575940624132605,right,Tm4,108,-3,-12,-3,-9,"-3,-12"
21311,720575940633824225,right,Tm4,109,4,-5,-7,2,"4,-5"
21312,720575940630155003,right,Tm4,110,-7,0,7,-7,"-7,0"
21313,720575940617432025,right,Tm4,111,2,-24,-14,-10,"2,-24"
21314,720575940640665077,right,Tm4,112,-6,1,6,-5,"-6,1"
21315,720575940618623572,right,Tm4,113,-2,4,4,0,"-2,4"
21316,720575940616529894,right,Tm4,114,2,-13,-9,-4,"2,-13"
21317,720575940624656142,right,Tm4,116,-1,-8,-3,-5,"-1,-8"
21318,720575940614051326,right,Tm4,117,-8,-2,7,-9,"-8,-2"
21319,720575940644232904,right,Tm4,118,3,1,-3,4,"3,1"
21320,720575940610897762,right,Tm4,119,-2,6,5,1,"-2,6"
21321,720575940629915641,right,Tm4,120,-1,-1,0,-1,"-1,-1"
21322,720575940619674790,right,Tm4,122,-5,9,9,0,"-5,9"
21323,720575940621576624,right,Tm4,124,1,-7,-5,-2,"1,-7"
21324,720575940622633200,right,Tm4,125,5,9,-1,10,"5,9"
21325,720575940612626650,right,Tm4,126,3,11,2,9,"3,11"
21326,720575940614271903,right,Tm4,127,0,15,7,8,"0,15"
21327,720575940626612228,right,Tm4,128,3,-22,-14,-8,"3,-22"
21328,720575940633241937,right,Tm4,129,0,-13,-7,-6,"0,-13"
21329,720575940623711305,right,Tm4,130,2,12,4,8,"2,12"
21330,720575940626475526,right,Tm4,131,-6,20,16,4,"-6,20"
21331,720575940622239265,right,Tm4,132,2,4,0,4,"2,4"
21332,720575940614166634,right,Tm4,133,-3,20,13,7,"-3,20"
21333,720575940641621979,right,Tm4,134,-5,-18,-4,-14,"-5,-18"
21334,720575940636074863,right,Tm4,135,-3,-22,-8,-14,"-3,-22"
21335,720575940628133714,right,Tm4,136,0,3,1,2,"0,3"
21336,720575940642596256,right,Tm4,137,5,-7,-9,2,"5,-7"
21337,720575940621582401,right,Tm4,138,0,27,13,14,"0,27"
21338,720575940612507890,right,Tm4,139,1,-14,-8,-6,"1,-14"
21339,720575940627962142,right,Tm4,140,3,8,1,7,"3,8"
21340,720575940615452063,right,Tm4,142,-2,-18,-7,-11,"-2,-18"
21341,720575940636819374,right,Tm4,143,-4,16,12,4,"-4,16"
21342,720575940631015505,right,Tm4,144,7,-11,-13,2,"7,-11"
21343,720575940620323121,right,Tm4,146,1,-6,-4,-2,"1,-6"
21344,720575940605223340,right,Tm4,147,1,21,9,12,"1,21"
21345,720575940622775907,right,Tm4,148,-7,-11,1,-12,"-7,-11"
21346,720575940648274052,right,Tm4,149,6,-14,-13,-1,"6,-14"
21347,720575940646285876,right,Tm4,150,-8,5,10,-5,"-8,5"
21348,720575940624229449,right,Tm4,151,-3,-14,-4,-10,"-3,-14"
21349,720575940623042253,right,Tm4,152,3,-15,-11,-4,"3,-15"
21350,720575940639752509,right,Tm4,153,8,0,-8,8,"8,0"
21351,720575940631730759,right,Tm4,154,-8,0,8,-8,"-8,0"
21352,720575940610289114,right,Tm4,155,-8,13,14,-1,"-8,13"
21353,720575940643520200,right,Tm4,156,-9,1,9,-8,"-9,1"
21354,720575940621985776,right,Tm4,157,-1,-7,-3,-4,"-1,-7"
21355,720575940620350844,right,Tm4,158,3,-5,-6,1,"3,-5"
21356,720575940621886448,right,Tm4,160,-2,20,12,8,"-2,20"
21357,720575940619077174,right,Tm4,161,4,-14,-11,-3,"4,-14"
21358,720575940628204028,right,Tm4,162,-4,-2,3,-5,"-4,-2"
21359,720575940610799566,right,Tm4,163,-9,7,12,-5,"-9,7"
21360,720575940637968496,right,Tm4,164,-1,-2,0,-2,"-1,-2"
21361,720575940628623977,right,Tm4,165,4,16,4,12,"4,16"
21362,720575940622933453,right,Tm4,167,0,-17,-9,-8,"0,-17"
21363,720575940629955840,right,Tm4,168,-1,17,9,8,"-1,17"
21364,720575940622406825,right,Tm4,169,0,-18,-9,-9,"0,-18"
21365,720575940629172303,right,Tm4,170,-5,1,5,-4,"-5,1"
21366,720575940645403502,right,Tm4,171,6,-20,-16,-4,"6,-20"
21367,720575940613092466,right,Tm4,172,1,22,10,12,"1,22"
21368,720575940612502245,right,Tm4,173,2,-25,-15,-10,"2,-25"
21369,720575940647145012,right,Tm4,174,4,-15,-12,-3,"4,-15"
21370,720575940618753565,right,Tm4,175,-6,-7,2,-9,"-6,-7"
21371,720575940617726272,right,Tm4,176,-2,13,8,5,"-2,13"
21372,720575940626675538,right,Tm4,177,-2,-1,1,-2,"-2,-1"
21373,720575940617572642,right,Tm4,178,2,11,3,8,"2,11"
21374,720575940620254891,right,Tm4,179,-5,-16,-3,-13,"-5,-16"
21375,720575940633496268,right,Tm4,180,2,-27,-16,-11,"2,-27"
21376,720575940623920664,right,Tm4,181,1,-4,-3,-1,"1,-4"
21377,720575940642459789,right,Tm4,182,7,-10,-12,2,"7,-10"
21378,720575940626850393,right,Tm4,183,-5,-15,-3,-12,"-5,-15"
21379,720575940626366782,right,Tm4,184,-6,-5,3,-8,"-6,-5"
21380,720575940632837992,right,Tm4,185,2,-11,-8,-3,"2,-11"
21381,720575940627035198,right,Tm4,186,-1,26,14,12,"-1,26"
21382,720575940605584318,right,Tm4,187,3,21,7,14,"3,21"
21383,720575940642570125,right,Tm4,188,-5,17,13,4,"-5,17"
21384,720575940627891784,right,Tm4,189,6,13,0,13,"6,13"
21385,720575940641460944,right,Tm4,190,-3,-5,0,-5,"-3,-5"
21386,720575940632905017,right,Tm4,191,-1,-11,-5,-6,"-1,-11"
21387,720575940616061301,right,Tm4,192,7,10,-2,12,"7,10"
21388,720575940631239491,right,Tm4,193,-5,4,7,-3,"-5,4"
21389,720575940627372540,right,Tm4,194,0,-5,-3,-2,"0,-5"
21390,720575940624248317,right,Tm4,195,-3,-1,2,-3,"-3,-1"
21391,720575940620804267,right,Tm4,196,-1,8,5,3,"-1,8"
21392,720575940639685491,right,Tm4,197,0,-20,-10,-10,"0,-20"
21393,720575940631250652,right,Tm4,198,6,2,-5,7,"6,2"
21394,720575940631545923,right,Tm4,199,0,-12,-6,-6,"0,-12"
21395,720575940624919482,right,Tm4,200,-5,12,11,1,"-5,12"
21396,720575940634622560,right,Tm4,201,-8,9,12,-3,"-8,9"
21397,720575940614824338,right,Tm4,202,-1,27,14,13,"-1,27"
21398,720575940627465226,right,Tm4,203,3,-1,-4,3,"3,-1"
21399,720575940636049775,right,Tm4,204,5,-2,-6,4,"5,-2"
21400,720575940617621460,right,Tm4,205,5,-6,-8,2,"5,-6"
21401,720575940614224031,right,Tm4,206,-3,5,5,0,"-3,5"
21402,720575940622692732,right,Tm4,207,1,29,13,16,"1,29"
21403,720575940624493862,right,Tm4,208,5,-21,-16,-5,"5,-21"
21404,720575940604818144,right,Tm4,209,-3,-8,-1,-7,"-3,-8"
21405,720575940636201061,right,Tm4,210,-6,8,10,-2,"-6,8"
21406,720575940636586932,right,Tm4,211,-7,-1,6,-7,"-7,-1"
21407,720575940637060270,right,Tm4,212,2,-16,-10,-6,"2,-16"
21408,720575940626345305,right,Tm4,213,3,-4,-5,1,"3,-4"
21409,720575940613964962,right,Tm4,214,-5,3,6,-3,"-5,3"
21410,720575940612083427,right,Tm4,216,2,19,7,12,"2,19"
21411,720575940615674770,right,Tm4,218,2,10,3,7,"2,10"
21412,720575940620701978,right,Tm4,219,6,-4,-8,4,"6,-4"
21413,720575940627707785,right,Tm4,220,2,-6,-5,-1,"2,-6"
21414,720575940627045455,right,Tm4,221,-7,3,8,-5,"-7,3"
21415,720575940621893590,right,Tm4,222,-3,26,16,10,"-3,26"
21416,720575940627357801,right,Tm4,223,-2,26,15,11,"-2,26"
21417,720575940623384344,right,Tm4,224,0,5,2,3,"0,5"
21418,720575940620604399,right,Tm4,225,2,-26,-15,-11,"2,-26"
21419,720575940604627889,right,Tm4,226,5,19,4,15,"5,19"
21420,720575940658274433,right,Tm4,228,-7,1,7,-6,"-7,1"
21421,720575940621927094,right,Tm4,229,5,2,-4,6,"5,2"
21422,720575940641658357,right,Tm4,230,2,9,2,7,"2,9"
21423,720575940623655974,right,Tm4,231,4,-12,-10,-2,"4,-12"
21424,720575940626417027,right,Tm4,232,-4,13,10,3,"-4,13"
21425,720575940616565919,right,Tm4,233,4,-13,-11,-2,"4,-13"
21426,720575940626407001,right,Tm4,234,1,3,0,3,"1,3"
21427,720575940636543095,right,Tm4,235,4,11,1,10,"4,11"
21428,720575940622287309,right,Tm4,236,-1,4,3,1,"-1,4"
21429,720575940624406199,right,Tm4,237,-2,27,15,12,"-2,27"
21430,720575940628244094,right,Tm4,238,-8,-3,6,-9,"-8,-3"
21431,720575940620430574,right,Tm4,239,-6,6,9,-3,"-6,6"
21432,720575940640698357,right,Tm4,240,-4,-3,2,-5,"-4,-3"
21433,720575940644777252,right,Tm4,241,2,-17,-11,-6,"2,-17"
21434,720575940618803136,right,Tm4,242,-4,6,7,-1,"-4,6"
21435,720575940645207332,right,Tm4,243,-1,-21,-10,-11,"-1,-21"
21436,720575940622736169,right,Tm4,244,-4,-12,-2,-10,"-4,-12"
21437,720575940626100112,right,Tm4,245,-5,-3,3,-6,"-5,-3"
21438,720575940634262684,right,Tm4,247,-4,-15,-4,-11,"-4,-15"
21439,720575940646292276,right,Tm4,248,-6,0,6,-6,"-6,0"
21440,720575940618800088,right,Tm4,249,2,-12,-8,-4,"2,-12"
21441,720575940609993592,right,Tm4,250,-1,1,1,0,"-1,1"
21442,720575940612566634,right,Tm4,251,-1,-14,-6,-8,"-1,-14"
21443,720575940616542169,right,Tm4,252,3,23,8,15,"3,23"
21444,720575940639534158,right,Tm4,253,5,16,3,13,"5,16"
21445,720575940638341860,right,Tm4,254,3,-24,-15,-9,"3,-24"
21446,720575940633417299,right,Tm4,255,-6,-13,-1,-12,"-6,-13"
21447,720575940629697530,right,Tm4,256,5,-20,-15,-5,"5,-20"
21448,720575940619602648,right,Tm4,257,2,21,8,13,"2,21"
21449,720575940639243573,right,Tm4,258,-4,-17,-5,-12,"-4,-17"
21450,720575940605258668,right,Tm4,259,-7,-5,4,-9,"-7,-5"
21451,720575940620069396,right,Tm4,260,-3,19,12,7,"-3,19"
21452,720575940629971578,right,Tm4,262,1,-11,-7,-4,"1,-11"
21453,720575940625768340,right,Tm4,263,-3,4,5,-1,"-3,4"
21454,720575940618568502,right,Tm4,264,-1,-6,-2,-4,"-1,-6"
21455,720575940620666800,right,Tm4,265,-6,-1,5,-6,"-6,-1"
21456,720575940644167584,right,Tm4,266,-1,-25,-12,-13,"-1,-25"
21457,720575940617743429,right,Tm4,267,-6,2,7,-5,"-6,2"
21458,720575940617854438,right,Tm4,268,7,-6,-10,4,"7,-6"
21459,720575940620518821,right,Tm4,269,2,-19,-12,-7,"2,-19"
21460,720575940630220414,right,Tm4,270,1,-8,-5,-3,"1,-8"
21461,720575940627862549,right,Tm4,271,4,6,-1,7,"4,6"
21462,720575940635543648,right,Tm4,272,3,-2,-4,2,"3,-2"
21463,720575940624867646,right,Tm4,273,-6,23,17,6,"-6,23"
21464,720575940615845014,right,Tm4,274,6,4,-4,8,"6,4"
21465,720575940612184872,right,Tm4,275,-8,-1,7,-8,"-8,-1"
21466,720575940614506961,right,Tm4,276,2,3,-1,4,"2,3"
21467,720575940621819775,right,Tm4,277,7,-3,-9,6,"7,-3"
21468,720575940637211189,right,Tm4,278,-5,10,10,0,"-5,10"
21469,720575940617435110,right,Tm4,279,-4,8,8,0,"-4,8"
21470,720575940629161371,right,Tm4,280,-6,-14,-1,-13,"-6,-14"
21471,720575940646505326,right,Tm4,281,-9,2,10,-8,"-9,2"
21472,720575940620782171,right,Tm4,282,0,26,13,13,"0,26"
21473,720575940630939643,right,Tm4,283,-4,4,6,-2,"-4,4"
21474,720575940615720258,right,Tm4,284,0,25,12,13,"0,25"
21475,720575940613568739,right,Tm4,285,6,-18,-15,-3,"6,-18"
21476,720575940618097181,right,Tm4,286,0,-24,-12,-12,"0,-24"
21477,720575940628171752,right,Tm4,287,-5,13,11,2,"-5,13"
21478,720575940627982353,right,Tm4,289,-1,11,6,5,"-1,11"
21479,720575940621477296,right,Tm4,290,5,-24,-17,-7,"5,-24"
21480,720575940619197504,right,Tm4,291,7,2,-6,8,"7,2"
21481,720575940624215736,right,Tm4,292,-4,18,13,5,"-4,18"
21482,720575940644880932,right,Tm4,293,4,-17,-13,-4,"4,-17"
21483,720575940630544758,right,Tm4,295,-2,29,16,13,"-2,29"
21484,720575940628638146,right,Tm4,296,1,-18,-10,-8,"1,-18"
21485,720575940622720517,right,Tm4,298,-5,5,7,-2,"-5,5"
21486,720575940636516983,right,Tm4,299,-4,12,10,2,"-4,12"
21487,720575940639457333,right,Tm4,300,4,-18,-13,-5,"4,-18"
21488,720575940619250415,right,Tm4,301,-5,16,13,3,"-5,16"
21489,720575940645220119,right,Tm4,302,2,17,6,11,"2,17"
21490,720575940620113741,right,Tm4,303,-5,22,16,6,"-5,22"
21491,720575940616024833,right,Tm4,305,-7,4,9,-5,"-7,4"
21492,720575940632372811,right,Tm4,306,3,7,0,7,"3,7"
21493,720575940622145449,right,Tm4,307,5,-25,-18,-7,"5,-25"
21494,720575940632443731,right,Tm4,308,-5,8,9,-1,"-5,8"
21495,720575940622287031,right,Tm4,309,-6,12,12,0,"-6,12"
21496,720575940627415050,right,Tm4,310,2,22,9,13,"2,22"
21497,720575940636290296,right,Tm4,312,4,-7,-8,1,"4,-7"
21498,720575940630102010,right,Tm4,313,7,3,-6,9,"7,3"
21499,720575940627065167,right,Tm4,314,-9,5,11,-6,"-9,5"
21500,720575940633359187,right,Tm4,315,-3,-6,0,-6,"-3,-6"
21501,720575940623002136,right,Tm4,316,5,-4,-7,3,"5,-4"
21502,720575940635270495,right,Tm4,317,-5,-4,3,-7,"-5,-4"
21503,720575940625717944,right,Tm4,318,4,-19,-14,-5,"4,-19"
21504,720575940633696096,right,Tm4,319,-2,5,4,1,"-2,5"
21505,720575940626154629,right,Tm4,320,-2,-5,-1,-4,"-2,-5"
21506,720575940640776819,right,Tm4,322,2,26,11,15,"2,26"
21507,720575940616942678,right,Tm4,324,3,24,9,15,"3,24"
21508,720575940627923272,right,Tm4,325,5,1,-5,6,"5,1"
21509,720575940632365454,right,Tm4,326,2,16,6,10,"2,16"
21510,720575940620460660,right,Tm4,328,5,-9,-10,1,"5,-9"
21511,720575940605942974,right,Tm4,329,0,24,12,12,"0,24"
21512,720575940628769972,right,Tm4,330,3,3,-2,5,"3,3"
21513,720575940627643005,right,Tm4,331,1,-15,-9,-6,"1,-15"
21514,720575940631045079,right,Tm4,332,4,-26,-17,-9,"4,-26"
21515,720575940625679106,right,Tm4,333,0,-21,-11,-10,"0,-21"
21516,720575940630527191,right,Tm4,334,1,-26,-14,-12,"1,-26"
21517,720575940638273513,right,Tm4,336,0,23,11,12,"0,23"
21518,720575940620396969,right,Tm4,337,-5,-6,2,-8,"-5,-6"
21519,720575940606569406,right,Tm4,338,-1,0,1,-1,"-1,0"
21520,720575940621140463,right,Tm4,340,-4,17,12,5,"-4,17"
21521,720575940627061690,right,Tm4,341,6,-17,-15,-2,"6,-17"
21522,720575940617019321,right,Tm4,342,2,-15,-10,-5,"2,-15"
21523,720575940638924863,right,Tm4,343,-3,27,16,11,"-3,27"
21524,720575940641717133,right,Tm4,344,-2,-15,-6,-9,"-2,-15"
21525,720575940634824303,right,Tm4,345,3,-12,-9,-3,"3,-12"
21526,720575940626054032,right,Tm4,346,-7,-9,2,-11,"-7,-9"
21527,720575940622186785,right,Tm4,347,-5,-13,-2,-11,"-5,-13"
21528,720575940624519399,right,Tm4,348,3,14,4,10,"3,14"
21529,720575940633496033,right,Tm4,349,-5,-14,-2,-12,"-5,-14"
21530,720575940619665323,right,Tm4,350,1,15,6,9,"1,15"
21531,720575940606005682,right,Tm4,351,-1,-17,-8,-9,"-1,-17"
21532,720575940616082630,right,Tm4,352,-2,28,16,12,"-2,28"
21533,720575940634402143,right,Tm4,353,2,24,10,14,"2,24"
21534,720575940619655488,right,Tm4,354,-2,-26,-11,-15,"-2,-26"
21535,720575940637748669,right,Tm4,355,-7,-6,4,-10,"-7,-6"
21536,720575940638140506,right,Tm4,356,0,22,11,11,"0,22"
21537,720575940622409712,right,Tm4,357,4,17,4,13,"4,17"
21538,720575940623419627,right,Tm4,358,-3,17,11,6,"-3,17"
21539,720575940635902047,right,Tm4,359,2,23,9,14,"2,23"
21540,720575940614484530,right,Tm4,360,-5,19,14,5,"-5,19"
21541,720575940639342963,right,Tm4,361,0,-7,-4,-3,"0,-7"
21542,720575940621146221,right,Tm4,362,2,-20,-12,-8,"2,-20"
21543,720575940616166075,right,Tm4,363,7,-4,-9,5,"7,-4"
21544,720575940618670370,right,Tm4,365,4,7,-1,8,"4,7"
21545,720575940621754885,right,Tm4,367,-6,-15,-2,-13,"-6,-15"
21546,720575940620551662,right,Tm4,368,-4,-20,-6,-14,"-4,-20"
21547,720575940636051311,right,Tm4,369,5,-5,-8,3,"5,-5"
21548,720575940622290570,right,Tm4,370,-3,21,13,8,"-3,21"
21549,720575940638074958,right,Tm4,371,6,-5,-9,4,"6,-5"
21550,720575940636099435,right,Tm4,372,1,-2,-2,0,"1,-2"
21551,720575940616303249,right,Tm4,373,1,-21,-12,-9,"1,-21"
21552,720575940620444436,right,Tm4,374,2,13,4,9,"2,13"
21553,720575940621685859,right,Tm4,375,-6,7,9,-2,"-6,7"
21554,720575940612723314,right,Tm4,376,-7,-10,2,-12,"-7,-10"
21555,720575940623440716,right,Tm4,378,-3,18,12,6,"-3,18"
21556,720575940620607424,right,Tm4,379,3,-17,-12,-5,"3,-17"
21557,720575940621721844,right,Tm4,380,-1,29,15,14,"-1,29"
21558,720575940613510038,right,Tm4,381,-8,-9,3,-12,"-8,-9"
21559,720575940623809212,right,Tm4,382,3,-6,-6,0,"3,-6"
21560,720575940627400039,right,Tm4,383,-6,11,11,0,"-6,11"
21561,720575940612766873,right,Tm4,384,-6,-2,5,-7,"-6,-2"
21562,720575940604829152,right,Tm4,385,-3,-18,-6,-12,"-3,-18"
21563,720575940618511297,right,Tm4,386,-6,19,15,4,"-6,19"
21564,720575940628288241,right,Tm4,387,-1,-15,-7,-8,"-1,-15"
21565,720575940626315820,right,Tm4,388,3,19,6,13,"3,19"
21566,720575940616022066,right,Tm4,389,-6,-16,-2,-14,"-6,-16"
21567,720575940631205071,right,Tm4,390,-6,-9,1,-10,"-6,-9"
21568,720575940632442439,right,Tm4,391,4,-3,-6,3,"4,-3"
21569,720575940605523145,right,Tm4,392,-4,7,7,0,"-4,7"
21570,720575940606202290,right,Tm4,393,-1,22,12,10,"-1,22"
21571,720575940612157041,right,Tm4,394,-7,-8,3,-11,"-7,-8"
21572,720575940626884926,right,Tm4,395,0,-22,-11,-11,"0,-22"
21573,720575940625137336,right,Tm4,396,-1,10,6,4,"-1,10"
21574,720575940636370807,right,Tm4,397,-3,-19,-7,-12,"-3,-19"
21575,720575940629906748,right,Tm4,398,-3,22,14,8,"-3,22"
21576,720575940637148016,right,Tm4,399,-4,-24,-8,-16,"-4,-24"
21577,720575940625847783,right,Tm4,400,1,-29,-16,-13,"1,-29"
21578,720575940606058668,right,Tm4,401,-2,-19,-8,-11,"-2,-19"
21579,720575940620873045,right,Tm4,402,3,26,10,16,"3,26"
21580,720575940622620599,right,Tm4,403,-2,-12,-4,-8,"-2,-12"
21581,720575940627106200,right,Tm4,404,-1,20,11,9,"-1,20"
21582,720575940629307648,right,Tm4,405,3,10,2,8,"3,10"
21583,720575940630400719,right,Tm4,406,1,-25,-14,-11,"1,-25"
21584,720575940634378265,right,Tm4,407,-5,-10,0,-10,"-5,-10"
21585,720575940629406971,right,Tm4,408,-6,-4,4,-8,"-6,-4"
21586,720575940629860603,right,Tm4,409,0,-3,-2,-1,"0,-3"
21587,720575940617530717,right,Tm4,410,-2,-2,1,-3,"-2,-2"
21588,720575940636462313,right,Tm4,412,-6,21,16,5,"-6,21"
21589,720575940632086120,right,Tm4,413,-2,-7,-2,-5,"-2,-7"
21590,720575940620685190,right,Tm4,415,6,12,0,12,"6,12"
21591,720575940627298831,right,Tm4,416,3,-8,-7,-1,"3,-8"
21592,720575940615673739,right,Tm4,417,-6,-10,1,-11,"-6,-10"
21593,720575940623279871,right,Tm4,418,-2,15,9,6,"-2,15"
21594,720575940614474642,right,Tm4,419,-3,-11,-3,-8,"-3,-11"
21595,720575940621455598,right,Tm4,420,6,-3,-8,5,"6,-3"
21596,720575940644828782,right,Tm4,422,-7,-4,5,-9,"-7,-4"
21597,720575940610563374,right,Tm4,423,3,-18,-12,-6,"3,-18"
21598,720575940624709564,right,Tm4,424,-3,-2,2,-4,"-3,-2"
21599,720575940626299436,right,Tm4,425,3,20,7,13,"3,20"
21600,720575940626827353,right,Tm4,426,-3,0,3,-3,"-3,0"
21601,720575940630251564,right,Tm4,427,5,-18,-14,-4,"5,-18"
21602,720575940617633117,right,Tm4,428,-2,23,13,10,"-2,23"
21603,720575940632355384,right,Tm4,429,-2,14,9,5,"-2,14"
21604,720575940624724204,right,Tm4,430,-3,-7,-1,-6,"-3,-7"
21605,720575940630991119,right,Tm4,432,-5,7,8,-1,"-5,7"
21606,720575940635419060,right,Tm4,433,0,-8,-4,-4,"0,-8"
21607,720575940637763812,right,Tm4,434,-3,7,6,1,"-3,7"
21608,720575940625579804,right,Tm4,435,5,-17,-14,-3,"5,-17"
21609,720575940614665726,right,Tm4,436,0,-15,-8,-7,"0,-15"
21610,720575940618625620,right,Tm4,437,-3,12,9,3,"-3,12"
21611,720575940628134312,right,Tm4,438,2,27,11,16,"2,27"
21612,720575940608674825,right,Tm4,439,-3,-9,-2,-7,"-3,-9"
21613,720575940632469329,right,Tm4,440,1,23,10,13,"1,23"
21614,720575940627825937,right,Tm4,441,3,-16,-11,-5,"3,-16"
21615,720575940620300167,right,Tm4,442,-5,25,17,8,"-5,25"
21616,720575940627267855,right,Tm4,444,4,-10,-9,-1,"4,-10"
21617,720575940652152310,right,Tm4,445,-2,8,6,2,"-2,8"
21618,720575940623431411,right,Tm4,446,2,-14,-9,-5,"2,-14"
21619,720575940627775562,right,Tm4,447,-1,2,2,0,"-1,2"
21620,720575940632578468,right,Tm4,448,0,30,15,15,"0,30"
21621,720575940626489744,right,Tm4,449,6,-16,-14,-2,"6,-16"
21622,720575940630510031,right,Tm4,450,2,-9,-7,-2,"2,-9"
21623,720575940614724147,right,Tm4,451,4,20,6,14,"4,20"
21624,720575940627963409,right,Tm4,452,1,-9,-6,-3,"1,-9"
21625,720575940629572081,right,Tm4,453,3,25,9,16,"3,25"
21626,720575940626752796,right,Tm4,454,5,-12,-11,-1,"5,-12"
21627,720575940632255116,right,Tm4,455,7,-7,-11,4,"7,-7"
21628,720575940625171495,right,Tm4,456,0,21,10,11,"0,21"
21629,720575940618274845,right,Tm4,457,-2,17,10,7,"-2,17"
21630,720575940631397394,right,Tm4,458,5,0,-5,5,"5,0"
21631,720575940612560051,right,Tm4,459,5,-3,-7,4,"5,-3"
21632,720575940642595232,right,Tm4,460,-3,-20,-7,-13,"-3,-20"
21633,720575940640884944,right,Tm4,461,7,-5,-10,5,"7,-5"
21634,720575940616312626,right,Tm4,462,-1,18,10,8,"-1,18"
21635,720575940623152639,right,Tm4,463,5,17,3,14,"5,17"
21636,720575940638240090,right,Tm4,464,4,0,-4,4,"4,0"
21637,720575940607480962,right,Tm4,465,3,0,-3,3,"3,0"
21638,720575940620636075,right,Tm4,466,1,14,6,8,"1,14"
21639,720575940629757050,right,Tm4,467,-2,-20,-8,-12,"-2,-20"
21640,720575940633849998,right,Tm4,468,-3,11,8,3,"-3,11"
21641,720575940629132239,right,Tm4,469,-7,13,13,0,"-7,13"
21642,720575940614910626,right,Tm4,470,4,-9,-9,0,"4,-9"
21643,720575940619968561,right,Tm4,471,3,-26,-16,-10,"3,-26"
21644,720575940613610642,right,Tm4,472,1,25,11,14,"1,25"
21645,720575940638255081,right,Tm4,473,-4,23,15,8,"-4,23"
21646,720575940608363100,right,Tm4,474,-3,-17,-6,-11,"-3,-17"
21647,720575940627319464,right,Tm4,475,-4,-1,3,-4,"-4,-1"
21648,720575940617530485,right,Tm4,477,-3,2,4,-2,"-3,2"
21649,720575940627131692,right,Tm4,479,-2,10,7,3,"-2,10"
21650,720575940624058409,right,Tm4,480,3,-19,-13,-6,"3,-19"
21651,720575940636585079,right,Tm4,481,4,-8,-8,0,"4,-8"
21652,720575940631912775,right,Tm4,482,1,17,7,10,"1,17"
21653,720575940640620240,right,Tm4,483,2,-7,-6,-1,"2,-7"
21654,720575940622742279,right,Tm4,484,3,-9,-8,-1,"3,-9"
21655,720575940615790139,right,Tm4,485,-3,-3,1,-4,"-3,-3"
21656,720575940642947636,right,Tm4,487,1,-1,-2,1,"1,-1"
21657,720575940634061664,right,Tm4,489,-3,10,8,2,"-3,10"
21658,720575940624478901,right,Tm4,490,-5,6,8,-2,"-5,6"
21659,720575940620390741,right,Tm4,491,7,-1,-8,7,"7,-1"
21660,720575940642958884,right,Tm4,492,-7,-2,6,-8,"-7,-2"
21661,720575940620760923,right,Tm4,493,-3,23,14,9,"-3,23"
21662,720575940637976666,right,Tm4,494,0,29,14,15,"0,29"
21663,720575940614848977,right,Tm4,497,6,1,-6,7,"6,1"
21664,720575940616911243,right,Tm4,498,6,10,-1,11,"6,10"
21665,720575940626038416,right,Tm4,499,5,10,0,10,"5,10"
21666,720575940621839130,right,Tm4,500,7,-8,-11,3,"7,-8"
21667,720575940628718097,right,Tm4,501,1,2,0,2,"1,2"
21668,720575940630013690,right,Tm4,502,5,8,-1,9,"5,8"
21669,720575940605914470,right,Tm4,503,3,17,5,12,"3,17"
21670,720575940650413177,right,Tm4,504,-2,9,6,3,"-2,9"
21671,720575940637967728,right,Tm4,506,1,-12,-7,-5,"1,-12"
21672,720575940628882960,right,Tm4,507,-5,-12,-1,-11,"-5,-12"
21673,720575940622088375,right,Tm4,508,-5,11,10,1,"-5,11"
21674,720575940624056979,right,Tm4,509,-4,10,9,1,"-4,10"
21675,720575940622158889,right,Tm4,510,-2,11,7,4,"-2,11"
21676,720575940609819950,right,Tm4,511,5,-11,-11,0,"5,-11"
21677,720575940623820643,right,Tm4,512,6,0,-6,6,"6,0"
21678,720575940626378896,right,Tm4,513,-4,-13,-3,-10,"-4,-13"
21679,720575940636681358,right,Tm4,514,-4,-10,-1,-9,"-4,-10"
21680,720575940627138545,right,Tm4,515,-8,-7,4,-11,"-8,-7"
21681,720575940619453204,right,Tm4,517,6,3,-5,8,"6,3"
21682,720575940639890365,right,Tm4,518,-4,22,15,7,"-4,22"
21683,720575940641596891,right,Tm4,519,-5,-5,2,-7,"-5,-5"
21684,720575940635529140,right,Tm4,520,-2,-22,-9,-13,"-2,-22"
21685,720575940621960063,right,Tm4,521,6,-9,-11,2,"6,-9"
21686,720575940619982501,right,Tm4,522,-4,0,4,-4,"-4,0"
21687,720575940627400220,right,Tm4,523,2,14,5,9,"2,14"
21688,720575940622269418,right,Tm4,524,4,-20,-14,-6,"4,-20"
21689,720575940635344279,right,Tm4,525,-1,-20,-9,-11,"-1,-20"
21690,720575940621806113,right,Tm4,526,0,-10,-5,-5,"0,-10"
21691,720575940620319215,right,Tm4,527,-4,-8,0,-8,"-4,-8"
21692,720575940632337170,right,Tm4,528,2,7,1,6,"2,7"
21693,720575940616178293,right,Tm4,529,2,-2,-3,1,"2,-2"
21694,720575940633639776,right,Tm4,530,-3,-13,-4,-9,"-3,-13"
21695,720575940623982435,right,Tm4,531,1,0,-1,1,"1,0"
21696,720575940628457410,right,Tm4,532,-8,7,11,-4,"-8,7"
21697,720575940614191535,right,Tm4,533,0,-16,-8,-8,"0,-16"
21698,720575940624288148,right,Tm4,534,3,2,-2,4,"3,2"
21699,720575940622177630,right,Tm4,535,8,-4,-10,6,"8,-4"
21700,720575940616524731,right,Tm4,536,3,4,-1,5,"3,4"
21701,720575940639869501,right,Tm4,537,0,-23,-12,-11,"0,-23"
21702,720575940613777662,right,Tm4,538,-4,1,4,-3,"-4,1"
21703,720575940633394830,right,Tm4,539,-6,15,13,2,"-6,15"
21704,720575940631150556,right,Tm4,540,-2,-9,-3,-6,"-2,-9"
21705,720575940630712028,right,Tm4,541,-4,14,11,3,"-4,14"
21706,720575940618252445,right,Tm4,542,6,-13,-13,0,"6,-13"
21707,720575940637137520,right,Tm4,543,-1,-4,-1,-3,"-1,-4"
21708,720575940639645766,right,Tm4,544,3,-13,-10,-3,"3,-13"
21709,720575940617421083,right,Tm4,545,5,11,0,11,"5,11"
21710,720575940631923754,right,Tm4,546,3,6,0,6,"3,6"
21711,720575940620989632,right,Tm4,547,-1,21,11,10,"-1,21"
21712,720575940628337171,right,Tm4,548,1,-16,-9,-7,"1,-16"
21713,720575940612219761,right,Tm4,549,0,-9,-5,-4,"0,-9"
21714,720575940627052681,right,Tm4,551,-4,-9,-1,-8,"-4,-9"
21715,720575940631708921,right,Tm4,552,4,-1,-5,4,"4,-1"
21716,720575940623714186,right,Tm4,553,-3,16,11,5,"-3,16"
21717,720575940616971193,right,Tm4,554,-9,-3,7,-10,"-9,-3"
21718,720575940629962693,right,Tm4,555,-4,9,8,1,"-4,9"
21719,720575940611174354,right,Tm4,556,0,10,5,5,"0,10"
21720,720575940627418122,right,Tm4,557,6,-10,-11,1,"6,-10"
21721,720575940616866699,right,Tm4,558,-4,-21,-7,-14,"-4,-21"
21722,720575940610602213,right,Tm4,559,-6,22,17,5,"-6,22"
21723,720575940617177211,right,Tm4,560,-7,14,14,0,"-7,14"
21724,720575940627450899,right,Tm4,561,5,7,-2,9,"5,7"
21725,720575940616844761,right,Tm4,562,-5,-2,4,-6,"-5,-2"
21726,720575940614780327,right,Tm4,563,5,-13,-12,-1,"5,-13"
21727,720575940606292512,right,Tm4,564,3,-23,-15,-8,"3,-23"
21728,720575940629694330,right,Tm4,565,0,-26,-13,-13,"0,-26"
21729,720575940633761188,right,Tm4,566,5,-8,-9,1,"5,-8"
21730,720575940626792292,right,Tm4,567,-2,22,13,9,"-2,22"
21731,720575940639017279,right,Tm4,568,-6,-8,2,-10,"-6,-8"
21732,720575940618867357,right,Tm4,569,6,6,-3,9,"6,6"
21733,720575940625041639,right,Tm4,570,2,25,10,15,"2,25"
21734,720575940606216480,right,Tm4,571,0,-14,-7,-7,"0,-14"
21735,720575940606197961,right,Tm4,572,-8,3,9,-6,"-8,3"
21736,720575940618165917,right,Tm4,573,4,14,3,11,"4,14"
21737,720575940628073216,right,Tm4,574,-6,5,8,-3,"-6,5"
21738,720575940649445753,right,Tm4,575,6,9,-2,11,"6,9"
21739,720575940620745163,right,Tm4,576,0,28,14,14,"0,28"
21740,720575940624738231,right,Tm4,577,5,-14,-12,-2,"5,-14"
21741,720575940632959443,right,Tm4,578,4,-11,-10,-1,"4,-11"
21742,720575940626176458,right,Tm4,579,-3,-10,-2,-8,"-3,-10"
21743,720575940614469010,right,Tm4,580,-2,-23,-10,-13,"-2,-23"
21744,720575940638118622,right,Tm4,581,3,9,1,8,"3,9"
21745,720575940618211101,right,Tm4,582,-1,23,12,11,"-1,23"
21746,720575940619096886,right,Tm4,583,3,-25,-16,-9,"3,-25"
21747,720575940635971679,right,Tm4,584,4,23,7,16,"4,23"
21748,720575940641250944,right,Tm4,585,-1,-23,-11,-12,"-1,-23"
21749,720575940646228788,right,Tm4,586,2,18,7,11,"2,18"
21750,720575940617707328,right,Tm4,587,4,22,7,15,"4,22"
21751,720575940624630279,right,Tm4,588,1,4,1,3,"1,4"
21752,720575940622076329,right,Tm4,589,-1,-5,-2,-3,"-1,-5"
21753,720575940623255821,right,Tm4,590,1,9,3,6,"1,9"
21754,720575940618622804,right,Tm4,591,3,-3,-5,2,"3,-3"
21755,720575940605477041,right,Tm4,593,3,-14,-10,-4,"3,-14"
21756,720575940604658912,right,Tm4,594,7,-16,-15,-1,"7,-16"
21757,720575940618157908,right,Tm4,595,7,-12,-13,1,"7,-12"
21758,720575940618037845,right,Tm4,596,-4,-16,-4,-12,"-4,-16"
21759,720575940624280317,right,Tm4,597,4,1,-4,5,"4,1"
21760,720575940620940015,right,Tm4,598,2,-18,-11,-7,"2,-18"
21761,720575940615737503,right,Tm4,599,-1,9,5,4,"-1,9"
21762,720575940622476156,right,Tm4,600,3,-10,-8,-2,"3,-10"
21763,720575940630267035,right,Tm4,601,1,16,7,9,"1,16"
21764,720575940643520564,right,Tm4,602,4,-2,-5,3,"4,-2"
21765,720575940610200533,right,Tm4,603,-3,-23,-9,-14,"-3,-23"
21766,720575940614936682,right,Tm4,604,-6,-17,-3,-14,"-6,-17"
21767,720575940645654638,right,Tm4,605,3,15,4,11,"3,15"
21768,720575940618490929,right,Tm4,606,-1,-19,-9,-10,"-1,-19"
21769,720575940640259662,right,Tm4,608,1,10,4,6,"1,10"
21770,720575940616128907,right,Tm4,609,-2,0,2,-2,"-2,0"
21771,720575940618171165,right,Tm4,610,2,-23,-14,-9,"2,-23"
21772,720575940613863599,right,Tm4,611,-1,-18,-8,-10,"-1,-18"
21773,720575940620244053,right,Tm4,614,-2,-8,-2,-6,"-2,-8"
21774,720575940642701256,right,Tm4,615,-7,-7,3,-10,"-7,-7"
21775,720575940640081240,right,Tm4,616,-3,15,10,5,"-3,15"
21776,720575940634844351,right,Tm4,617,-2,-17,-7,-10,"-2,-17"
21777,720575940631619468,right,Tm4,618,-1,24,13,11,"-1,24"
21778,720575940618981534,right,Tm4,620,7,1,-7,8,"7,1"
21779,720575940625442492,right,Tm4,621,1,24,11,13,"1,24"
21780,720575940644879908,right,Tm4,622,-5,20,15,5,"-5,20"
21781,720575940637405614,right,Tm4,624,1,-17,-10,-7,"1,-17"
21782,720575940610178884,right,Tm4,625,-2,24,14,10,"-2,24"
21783,720575940616735605,right,Tm4,626,-5,-8,1,-9,"-5,-8"
21784,720575940627810576,right,Tm4,627,0,-1,-1,0,"0,-1"
21785,720575940623683854,right,Tm4,628,0,0,0,0,"0,0"
21786,720575940636757902,right,Tm4,629,4,24,8,16,"4,24"
21787,720575940608384860,right,Tm4,630,4,8,0,8,"4,8"
21788,720575940640871376,right,Tm4,631,1,26,12,14,"1,26"
21789,720575940618371028,right,Tm4,632,3,-20,-13,-7,"3,-20"
21790,720575940631102295,right,Tm4,633,-1,-24,-11,-13,"-1,-24"
21791,720575940622407050,right,Tm4,634,-3,-15,-5,-10,"-3,-15"
21792,720575940623682440,right,Tm4,635,6,-6,-9,3,"6,-6"
21793,720575940623170774,right,Tm4,636,0,6,3,3,"0,6"
21794,720575940603934892,right,Tm4,637,3,-21,-14,-7,"3,-21"
21795,720575940621087470,right,Tm4,639,-4,19,13,6,"-4,19"
21796,720575940623233100,right,Tm4,640,-1,-16,-7,-9,"-1,-16"
21797,720575940622977002,right,Tm4,641,-8,-5,5,-10,"-8,-5"
21798,720575940613685043,right,Tm4,642,-5,-11,-1,-10,"-5,-11"
21799,720575940605962370,right,Tm4,643,6,14,1,13,"6,14"
21800,720575940625995780,right,Tm4,644,-6,18,15,3,"-6,18"
21801,720575940612775065,right,Tm4,645,-4,27,17,10,"-4,27"
21802,720575940652662262,right,Tm4,647,-4,-7,0,-7,"-4,-7"
21803,720575940617111894,right,Tm4,650,-3,-25,-10,-15,"-3,-25"
21804,720575940618290077,right,Tm4,651,-4,-5,1,-6,"-4,-5"
21805,720575940622956131,right,Tm4,652,-6,-11,0,-11,"-6,-11"
21806,720575940619386203,right,Tm4,653,-6,-12,0,-12,"-6,-12"
21807,720575940633940366,right,Tm4,654,-3,8,7,1,"-3,8"
21808,720575940627872503,right,Tm4,655,6,-1,-7,6,"6,-1"
21809,720575940630344300,right,Tm4,656,0,-11,-6,-5,"0,-11"
21810,720575940640304437,right,Tm4,657,-2,-25,-11,-14,"-2,-25"
21811,720575940638258522,right,Tm4,658,1,20,9,11,"1,20"
21812,720575940624796874,right,Tm4,659,-4,-6,1,-7,"-4,-6"
21813,720575940624923320,right,Tm4,660,2,28,12,16,"2,28"
21814,720575940624215477,right,Tm4,661,-3,14,10,4,"-3,14"
21815,720575940652141558,right,Tm4,662,2,-1,-3,2,"2,-1"
21816,720575940623432572,right,Tm4,663,0,8,4,4,"0,8"
21817,720575940623304216,right,Tm4,664,1,-27,-15,-12,"1,-27"
21818,720575940623115107,right,Tm4,665,7,-2,-8,6,"7,-2"
21819,720575940635025599,right,Tm4,667,1,-28,-15,-13,"1,-28"
21820,720575940625827476,right,Tm4,668,1,19,8,11,"1,19"
21821,720575940609045443,right,Tm4,669,4,-16,-12,-4,"4,-16"
21822,720575940620309419,right,Tm4,671,-4,-23,-8,-15,"-4,-23"
21823,720575940628727556,right,Tm4,672,-8,11,13,-2,"-8,11"
21824,720575940612819891,right,Tm4,673,2,5,0,5,"2,5"
21825,720575940626653188,right,Tm4,674,-4,-14,-3,-11,"-4,-14"
21826,720575940611482226,right,Tm4,675,-7,19,16,3,"-7,19"
21827,720575940623322879,right,Tm4,676,-3,-21,-8,-13,"-3,-21"
21828,720575940634726079,right,Tm4,677,0,11,5,6,"0,11"
21829,720575940616415419,right,Tm4,678,3,-7,-7,0,"3,-7"
21830,720575940627069242,right,Tm4,679,4,18,5,13,"4,18"
21831,720575940639445582,right,Tm4,680,-1,25,13,12,"-1,25"
21832,720575940617608053,right,Tm4,681,-2,-21,-9,-12,"-2,-21"
21833,720575940637511869,right,Tm4,682,6,-8,-10,2,"6,-8"
21834,720575940620093489,right,Tm4,683,2,6,1,5,"2,6"
21835,720575940626335588,right,Tm4,684,-6,17,14,3,"-6,17"
21836,720575940620557446,right,Tm4,685,-5,-9,0,-9,"-5,-9"
21837,720575940620409364,right,Tm4,686,5,-22,-16,-6,"5,-22"
21838,720575940626893208,right,Tm4,687,-6,-3,4,-7,"-6,-3"
21839,720575940616130719,right,Tm4,688,-7,10,12,-2,"-7,10"
21840,720575940622314665,right,Tm4,689,-2,18,11,7,"-2,18"
21841,720575940619455829,right,Tm4,690,-7,-3,5,-8,"-7,-3"
21842,720575940630540599,right,Tm4,691,-9,4,11,-7,"-9,4"
21843,720575940631930334,right,Tm4,692,-4,24,16,8,"-4,24"
21844,720575940623806908,right,Tm4,693,-3,25,15,10,"-3,25"
21845,720575940630736844,right,Tm4,695,-6,10,11,-1,"-6,10"
21846,720575940616606550,right,Tm4,696,-2,16,10,6,"-2,16"
21847,720575940612925866,right,Tm4,697,1,-22,-12,-10,"1,-22"
21848,720575940607090633,right,Tm4,698,6,-7,-10,3,"6,-7"
21849,720575940646325300,right,Tm4,699,-5,0,5,-5,"-5,0"
21850,720575940629317376,right,Tm4,700,5,15,2,13,"5,15"
21851,720575940617182235,right,Tm4,701,0,-4,-2,-2,"0,-4"
21852,720575940623713939,right,Tm4,702,-5,23,16,7,"-5,23"
21853,720575940636783727,right,Tm4,703,-3,1,3,-2,"-3,1"
21854,720575940607111893,right,Tm4,704,-7,8,11,-3,"-7,8"
21855,720575940630390826,right,Tm4,705,1,1,-1,2,"1,1"
21856,720575940632637999,right,Tm4,707,-2,25,14,11,"-2,25"
21857,720575940639660110,right,Tm4,709,-2,-24,-10,-14,"-2,-24"
21858,720575940633195053,right,Tm4,710,4,-25,-17,-8,"4,-25"
21859,720575940629192527,right,Tm4,711,-1,19,10,9,"-1,19"
21860,720575940614095144,right,Tm4,712,-7,12,13,-1,"-7,12"
21861,720575940629800645,right,Tm4,714,5,12,1,11,"5,12"
21862,720575940607129218,right,Tm4,715,4,10,1,9,"4,10"
21863,720575940624217269,right,Tm4,716,4,-6,-7,1,"4,-6"
21864,720575940611419512,right,Tm4,717,2,-22,-13,-9,"2,-22"
21865,720575940633570702,right,Tm4,720,-5,21,15,6,"-5,21"
21866,720575940620063435,right,Tm4,722,6,-15,-14,-1,"6,-15"
21867,720575940616292241,right,Tm4,723,-2,-11,-4,-7,"-2,-11"
21868,720575940632177706,right,Tm4,724,4,2,-3,5,"4,2"
21869,720575940635171947,right,Tm4,725,-3,-24,-9,-15,"-3,-24"
21870,720575940626761561,right,Tm4,728,7,12,-1,13,"7,12"
21871,720575940640089984,right,Tm4,729,-3,29,17,12,"-3,29"
21872,720575940628747564,right,Tm4,730,7,0,-7,7,"7,0"
21873,720575940625704714,right,Tm4,731,-6,9,10,-1,"-6,9"
21874,720575940617637003,right,Tm4,732,-3,6,6,0,"-3,6"
21875,720575940641601499,right,Tm4,733,-5,-17,-4,-13,"-5,-17"
21876,720575940619073334,right,Tm4,734,2,0,-2,2,"2,0"
21877,720575940630229760,right,Tm4,735,1,-23,-13,-10,"1,-23"
21878,720575940623218360,right,Tm4,736,-8,1,8,-7,"-8,1"
21879,720575940628223996,right,Tm4,737,0,19,9,10,"0,19"
21880,720575940635194778,right,Tm4,738,-3,13,9,4,"-3,13"
21881,720575940630831738,right,Tm4,740,2,-8,-6,-2,"2,-8"
21882,720575940630218967,right,Tm4,741,-2,-14,-5,-9,"-2,-14"
21883,720575940625197351,right,Tm4,742,-4,11,9,2,"-4,11"
21884,720575940614354129,right,Tm4,744,-4,25,16,9,"-4,25"
21885,720575940632205330,right,Tm4,745,0,13,6,7,"0,13"
21886,720575940642461837,right,Tm4,746,-3,3,4,-1,"-3,3"
21887,720575940612667042,right,Tm4,747,0,2,1,1,"0,2"
21888,720575940634888343,right,Tm4,748,-4,20,14,6,"-4,20"
21889,720575940625337290,right,Tm4,749,-2,1,2,-1,"-2,1"
21890,720575940620157269,right,Tm4,750,4,-24,-16,-8,"4,-24"
21891,720575940609772757,right,Tm4,751,1,6,2,4,"1,6"
21892,720575940623260853,right,Tm4,752,-2,7,5,2,"-2,7"
21893,720575940616025100,right,Tm4,753,-3,24,15,9,"-3,24"
21894,720575940622102966,right,Tm4,754,-1,-13,-6,-7,"-1,-13"
21895,720575940620725952,right,Tm4,755,4,19,5,14,"4,19"
21896,720575940628346186,right,Tm4,756,5,20,5,15,"5,20"
21897,720575940614125822,right,Tm4,757,0,-6,-3,-3,"0,-6"
21898,720575940612701354,right,Tm4,758,5,-1,-6,5,"5,-1"
21899,720575940609482947,right,Tm4,759,7,14,0,14,"7,14"
21900,720575940633809306,right,Tm4,760,0,17,8,9,"0,17"
21901,720575940612394931,right,Tm4,761,-4,-18,-5,-13,"-4,-18"
21902,720575940617266571,right,Tm4,762,0,14,7,7,"0,14"
21903,720575940636835910,right,Tm4,763,-5,14,12,2,"-5,14"
21904,720575940607594197,right,Tm4,764,-8,-6,5,-11,"-8,-6"
21905,720575940629975868,right,Tm4,765,-3,9,7,2,"-3,9"
21906,720575940613165223,right,Tm4,766,2,-4,-4,0,"2,-4"
21907,720575940617429977,right,Tm4,767,1,28,13,15,"1,28"
21908,720575940639908467,right,Tm4,768,3,5,-1,6,"3,5"
21909,720575940624218119,right,Tm4,769,4,-27,-18,-9,"4,-27"
21910,720575940610646897,right,Tm4,771,3,-27,-17,-10,"3,-27"
21911,720575940634686304,right,Tm4,772,1,12,5,7,"1,12"
21912,720575940628006824,right,Tm4,773,5,-19,-15,-4,"5,-19"
21913,720575940611706176,right,Tm4,774,-8,6,11,-5,"-8,6"
21914,720575940632069944,right,Tm4,775,5,22,6,16,"5,22"
21915,720575940621070318,right,Tm4,776,5,21,5,16,"5,21"
21916,720575940629385086,right,Tm4,777,6,20,4,16,"6,20"
21917,720575940616852411,right,Tm4,778,4,25,8,17,"4,25"
21918,720575940614230993,right,Tm4,779,5,24,7,17,"5,24"
21919,720575940624633783,right,Tm4,780,-6,25,18,7,"-6,25"
21920,720575940611025784,right,Tm4,781,-5,26,18,8,"-5,26"
21921,720575940623959852,right,Tm4,783,-4,28,18,10,"-4,28"
21922,720575940633520526,right,Tm4,784,-4,29,18,11,"-4,29"
21923,720575940623976803,right,Tm4,786,-2,30,17,13,"-2,30"
21924,720575940636521591,right,Tm4,787,3,28,11,17,"3,28"
21925,720575940628593169,right,Tm4,790,-2,-27,-12,-15,"-2,-27"
21926,720575940624310013,right,Tm4,791,-1,-28,-13,-15,"-1,-28"
21927,720575940626781672,right,Tm4,792,8,2,-7,9,"8,2"
21928,720575940624016362,right,Tm4,795,6,-21,-17,-4,"6,-21"
21929,720575940625842320,right,Tm4,796,4,26,9,17,"4,26"
21930,720575940622927541,right,Tm9,1,-6,13,12,1,"-6,13"
21931,720575940630930259,right,Tm9,2,-8,2,9,-7,"-8,2"
21932,720575940631502035,right,Tm9,3,6,-12,-12,0,"6,-12"
21933,720575940638773062,right,Tm9,4,-5,-21,-6,-15,"-5,-21"
21934,720575940634202780,right,Tm9,5,-1,16,9,7,"-1,16"
21935,720575940615681804,right,Tm9,6,-2,-4,0,-4,"-2,-4"
21936,720575940645323630,right,Tm9,7,-6,-6,3,-9,"-6,-6"
21937,720575940630086188,right,Tm9,8,-4,26,17,9,"-4,26"
21938,720575940625679596,right,Tm9,9,4,9,0,9,"4,9"
21939,720575940615234015,right,Tm9,10,5,-15,-13,-2,"5,-15"
21940,720575940626039315,right,Tm9,11,7,-14,-14,0,"7,-14"
21941,720575940631997752,right,Tm9,13,-1,-26,-12,-14,"-1,-26"
21942,720575940631177231,right,Tm9,14,0,-27,-14,-13,"0,-27"
21943,720575940638584372,right,Tm9,15,2,-3,-4,1,"2,-3"
21944,720575940646763316,right,Tm9,16,-2,-16,-6,-10,"-2,-16"
21945,720575940628906795,right,Tm9,17,1,-5,-4,-1,"1,-5"
21946,720575940627471887,right,Tm9,18,5,-16,-13,-3,"5,-16"
21947,720575940618601729,right,Tm9,19,-7,17,15,2,"-7,17"
21948,720575940637550221,right,Tm9,20,3,-11,-9,-2,"3,-11"
21949,720575940633362131,right,Tm9,21,-2,19,11,8,"-2,19"
21950,720575940611600298,right,Tm9,22,-1,3,2,1,"-1,3"
21951,720575940634723735,right,Tm9,23,-3,-16,-5,-11,"-3,-16"
21952,720575940622941181,right,Tm9,24,-1,-10,-4,-6,"-1,-10"
21953,720575940646290228,right,Tm9,25,-9,3,10,-7,"-9,3"
21954,720575940643866528,right,Tm9,26,1,-3,-3,0,"1,-3"
21955,720575940622505332,right,Tm9,27,0,-25,-13,-12,"0,-25"
21956,720575940636902767,right,Tm9,28,5,6,-2,8,"5,6"
21957,720575940638249791,right,Tm9,29,-1,-3,-1,-2,"-1,-3"
21958,720575940630779919,right,Tm9,30,6,16,2,14,"6,16"
21959,720575940620810406,right,Tm9,31,0,16,8,8,"0,16"
21960,720575940611754850,right,Tm9,32,0,12,6,6,"0,12"
21961,720575940620425808,right,Tm9,33,3,18,6,12,"3,18"
21962,720575940628437736,right,Tm9,34,6,18,3,15,"6,18"
21963,720575940624735207,right,Tm9,35,1,-24,-13,-11,"1,-24"
21964,720575940619989383,right,Tm9,36,6,8,-2,10,"6,8"
21965,720575940628791568,right,Tm9,38,0,-2,-1,-1,"0,-2"
21966,720575940641374861,right,Tm9,39,0,20,10,10,"0,20"
21967,720575940623305107,right,Tm9,40,-2,-6,-1,-5,"-2,-6"
21968,720575940605017260,right,Tm9,41,-3,28,17,11,"-3,28"
21969,720575940625355853,right,Tm9,43,-5,18,14,4,"-5,18"
21970,720575940618377029,right,Tm9,44,5,-10,-10,0,"5,-10"
21971,720575940632685516,right,Tm9,45,-5,-1,4,-5,"-5,-1"
21972,720575940615901115,right,Tm9,46,-5,15,12,3,"-5,15"
21973,720575940612424470,right,Tm9,47,-9,-1,8,-9,"-9,-1"
21974,720575940627756304,right,Tm9,48,-4,-22,-7,-15,"-4,-22"
21975,720575940624447015,right,Tm9,49,4,-4,-6,2,"4,-4"
21976,720575940612657522,right,Tm9,50,-2,21,12,9,"-2,21"
21977,720575940622375894,right,Tm9,51,0,-19,-10,-9,"0,-19"
21978,720575940622375382,right,Tm9,52,-1,-22,-10,-12,"-1,-22"
21979,720575940627175671,right,Tm9,53,5,14,2,12,"5,14"
21980,720575940623407556,right,Tm9,54,-4,3,5,-2,"-4,3"
21981,720575940619815559,right,Tm9,55,-4,-11,-2,-9,"-4,-11"
21982,720575940627342408,right,Tm9,56,1,-13,-8,-5,"1,-13"
21983,720575940612911283,right,Tm9,57,6,-11,-12,1,"6,-11"
21984,720575940622001833,right,Tm9,58,3,12,3,9,"3,12"
21985,720575940629202298,right,Tm9,59,-2,2,3,-1,"-2,2"
21986,720575940626856496,right,Tm9,61,-4,-4,2,-6,"-4,-4"
21987,720575940611861710,right,Tm9,62,0,-29,-15,-14,"0,-29"
21988,720575940626036922,right,Tm9,63,4,12,2,10,"4,12"
21989,720575940624794888,right,Tm9,64,4,-23,-16,-7,"4,-23"
21990,720575940621332406,right,Tm9,65,-1,28,15,13,"-1,28"
21991,720575940616025542,right,Tm9,66,2,15,5,10,"2,15"
21992,720575940627187849,right,Tm9,67,-2,-13,-5,-8,"-2,-13"
21993,720575940635034719,right,Tm9,68,3,16,5,11,"3,16"
21994,720575940613052330,right,Tm9,69,1,8,3,5,"1,8"
21995,720575940614848658,right,Tm9,70,-4,21,14,7,"-4,21"
21996,720575940631225943,right,Tm9,71,-2,-3,0,-3,"-2,-3"
21997,720575940637894110,right,Tm9,72,0,-28,-14,-14,"0,-28"
21998,720575940628721307,right,Tm9,73,2,2,-1,3,"2,2"
21999,720575940614110673,right,Tm9,74,-1,-9,-4,-5,"-1,-9"
22000,720575940652191990,right,Tm9,75,-6,14,13,1,"-6,14"
22001,720575940629883077,right,Tm9,76,-3,-4,1,-5,"-3,-4"
22002,720575940638314330,right,Tm9,77,2,-5,-5,0,"2,-5"
22003,720575940615655730,right,Tm9,78,2,20,8,12,"2,20"
22004,720575940642642996,right,Tm9,79,2,1,-2,3,"2,1"
22005,720575940627990020,right,Tm9,80,4,13,2,11,"4,13"
22006,720575940622223273,right,Tm9,81,6,-2,-7,5,"6,-2"
22007,720575940620017573,right,Tm9,82,-7,7,10,-3,"-7,7"
22008,720575940635068441,right,Tm9,83,2,-21,-13,-8,"2,-21"
22009,720575940629989635,right,Tm9,84,-2,12,8,4,"-2,12"
22010,720575940627787780,right,Tm9,85,4,-22,-15,-7,"4,-22"
22011,720575940616030770,right,Tm9,86,-5,-7,1,-8,"-5,-7"
22012,720575940640913037,right,Tm9,87,1,11,4,7,"1,11"
22013,720575940635061695,right,Tm9,88,7,4,-5,9,"7,4"
22014,720575940617195579,right,Tm9,89,1,-19,-11,-8,"1,-19"
22015,720575940632213646,right,Tm9,90,-4,5,6,-1,"-4,5"
22016,720575940620556225,right,Tm9,91,-1,6,4,2,"-1,6"
22017,720575940629161724,right,Tm9,92,0,9,4,5,"0,9"
22018,720575940625903678,right,Tm9,93,-6,3,7,-4,"-6,3"
22019,720575940623045512,right,Tm9,94,5,18,4,14,"5,18"
22020,720575940619677166,right,Tm9,95,4,-21,-15,-6,"4,-21"
22021,720575940620413376,right,Tm9,96,1,-10,-6,-4,"1,-10"
22022,720575940612404502,right,Tm9,97,-5,2,6,-4,"-5,2"
22023,720575940631381975,right,Tm9,98,-1,-12,-5,-7,"-1,-12"
22024,720575940630862799,right,Tm9,99,4,15,3,12,"4,15"
22025,720575940626098725,right,Tm9,100,2,-10,-7,-3,"2,-10"
22026,720575940617597597,right,Tm9,101,-7,6,10,-4,"-7,6"
22027,720575940627513105,right,Tm9,102,3,13,3,10,"3,13"
22028,720575940638752838,right,Tm9,104,-1,-27,-13,-14,"-1,-27"
22029,720575940626549020,right,Tm9,105,3,22,8,14,"3,22"
22030,720575940638607167,right,Tm9,106,-7,11,12,-1,"-7,11"
22031,720575940639898420,right,Tm9,107,8,-2,-9,7,"8,-2"
22032,720575940608295726,right,Tm9,108,-3,-12,-3,-9,"-3,-12"
22033,720575940624919994,right,Tm9,109,4,-5,-7,2,"4,-5"
22034,720575940633726364,right,Tm9,110,-7,0,7,-7,"-7,0"
22035,720575940624636647,right,Tm9,111,2,-24,-14,-10,"2,-24"
22036,720575940638698842,right,Tm9,112,-6,1,6,-5,"-6,1"
22037,720575940604810208,right,Tm9,113,-2,4,4,0,"-2,4"
22038,720575940632565075,right,Tm9,114,2,-13,-9,-4,"2,-13"
22039,720575940615974854,right,Tm9,115,-4,2,5,-3,"-4,2"
22040,720575940621899269,right,Tm9,116,-1,-8,-3,-5,"-1,-8"
22041,720575940659627137,right,Tm9,117,-8,-2,7,-9,"-8,-2"
22042,720575940623629035,right,Tm9,118,3,1,-3,4,"3,1"
22043,720575940610445922,right,Tm9,119,-2,6,5,1,"-2,6"
22044,720575940616301497,right,Tm9,120,-1,-1,0,-1,"-1,-1"
22045,720575940612645234,right,Tm9,121,-8,4,10,-6,"-8,4"
22046,720575940619169752,right,Tm9,122,-5,9,9,0,"-5,9"
22047,720575940612989297,right,Tm9,124,1,-7,-5,-2,"1,-7"
22048,720575940619409232,right,Tm9,125,5,9,-1,10,"5,9"
22049,720575940623245053,right,Tm9,126,3,11,2,9,"3,11"
22050,720575940609798386,right,Tm9,127,0,15,7,8,"0,15"
22051,720575940635099487,right,Tm9,128,3,-22,-14,-8,"3,-22"
22052,720575940647336068,right,Tm9,129,0,-13,-7,-6,"0,-13"
22053,720575940614168291,right,Tm9,130,2,12,4,8,"2,12"
22054,720575940631014487,right,Tm9,131,-6,20,16,4,"-6,20"
22055,720575940626884652,right,Tm9,133,-3,20,13,7,"-3,20"
22056,720575940645463406,right,Tm9,134,-5,-18,-4,-14,"-5,-18"
22057,720575940621211584,right,Tm9,135,-3,-22,-8,-14,"-3,-22"
22058,720575940633243949,right,Tm9,136,0,3,1,2,"0,3"
22059,720575940618294557,right,Tm9,137,5,-7,-9,2,"5,-7"
22060,720575940609254851,right,Tm9,138,0,27,13,14,"0,27"
22061,720575940622773375,right,Tm9,139,1,-14,-8,-6,"1,-14"
22062,720575940624161975,right,Tm9,140,3,8,1,7,"3,8"
22063,720575940630982711,right,Tm9,142,-2,-18,-7,-11,"-2,-18"
22064,720575940612399986,right,Tm9,143,-4,16,12,4,"-4,16"
22065,720575940612861462,right,Tm9,144,7,-11,-13,2,"7,-11"
22066,720575940633004755,right,Tm9,145,0,4,2,2,"0,4"
22067,720575940635000767,right,Tm9,146,1,-6,-4,-2,"1,-6"
22068,720575940617991764,right,Tm9,147,1,21,9,12,"1,21"
22069,720575940628793329,right,Tm9,148,-7,-11,1,-12,"-7,-11"
22070,720575940633825505,right,Tm9,149,6,-14,-13,-1,"6,-14"
22071,720575940613479074,right,Tm9,150,-8,5,10,-5,"-8,5"
22072,720575940627807877,right,Tm9,151,-3,-14,-4,-10,"-3,-14"
22073,720575940618093888,right,Tm9,152,3,-15,-11,-4,"3,-15"
22074,720575940606095550,right,Tm9,153,8,0,-8,8,"8,0"
22075,720575940630668871,right,Tm9,154,-8,0,8,-8,"-8,0"
22076,720575940628703079,right,Tm9,156,-9,1,9,-8,"-9,1"
22077,720575940609936139,right,Tm9,157,-1,-7,-3,-4,"-1,-7"
22078,720575940632064331,right,Tm9,158,3,-5,-6,1,"3,-5"
22079,720575940620517312,right,Tm9,159,7,7,-4,11,"7,7"
22080,720575940631873863,right,Tm9,160,-2,20,12,8,"-2,20"
22081,720575940618727760,right,Tm9,161,4,-14,-11,-3,"4,-14"
22082,720575940628552091,right,Tm9,162,-4,-2,3,-5,"-4,-2"
22083,720575940622621990,right,Tm9,164,-1,-2,0,-2,"-1,-2"
22084,720575940617507001,right,Tm9,165,4,16,4,12,"4,16"
22085,720575940623442824,right,Tm9,166,0,18,9,9,"0,18"
22086,720575940630925686,right,Tm9,167,0,-17,-9,-8,"0,-17"
22087,720575940647564932,right,Tm9,168,-1,17,9,8,"-1,17"
22088,720575940617143611,right,Tm9,169,0,-18,-9,-9,"0,-18"
22089,720575940640967413,right,Tm9,170,-5,1,5,-4,"-5,1"
22090,720575940626001296,right,Tm9,171,6,-20,-16,-4,"6,-20"
22091,720575940636348011,right,Tm9,172,1,22,10,12,"1,22"
22092,720575940626935378,right,Tm9,173,2,-25,-15,-10,"2,-25"
22093,720575940620204678,right,Tm9,174,4,-15,-12,-3,"4,-15"
22094,720575940610014674,right,Tm9,175,-6,-7,2,-9,"-6,-7"
22095,720575940626010652,right,Tm9,176,-2,13,8,5,"-2,13"
22096,720575940639136600,right,Tm9,177,-2,-1,1,-2,"-2,-1"
22097,720575940624240580,right,Tm9,178,2,11,3,8,"2,11"
22098,720575940640311971,right,Tm9,179,-5,-16,-3,-13,"-5,-16"
22099,720575940616973836,right,Tm9,180,2,-27,-16,-11,"2,-27"
22100,720575940632916783,right,Tm9,181,1,-4,-3,-1,"1,-4"
22101,720575940616410909,right,Tm9,182,7,-10,-12,2,"7,-10"
22102,720575940638118975,right,Tm9,183,-5,-15,-3,-12,"-5,-15"
22103,720575940621858943,right,Tm9,184,-6,-5,3,-8,"-6,-5"
22104,720575940616149209,right,Tm9,185,2,-11,-8,-3,"2,-11"
22105,720575940633303648,right,Tm9,186,-1,26,14,12,"-1,26"
22106,720575940614873775,right,Tm9,187,3,21,7,14,"3,21"
22107,720575940643763656,right,Tm9,188,-5,17,13,4,"-5,17"
22108,720575940630386679,right,Tm9,189,6,13,0,13,"6,13"
22109,720575940615463327,right,Tm9,190,-3,-5,0,-5,"-3,-5"
22110,720575940626985482,right,Tm9,191,-1,-11,-5,-6,"-1,-11"
22111,720575940617614809,right,Tm9,192,7,10,-2,12,"7,10"
22112,720575940625529381,right,Tm9,193,-5,4,7,-3,"-5,4"
22113,720575940624434320,right,Tm9,194,0,-5,-3,-2,"0,-5"
22114,720575940616682530,right,Tm9,195,-3,-1,2,-3,"-3,-1"
22115,720575940630638073,right,Tm9,196,-1,8,5,3,"-1,8"
22116,720575940619812555,right,Tm9,197,0,-20,-10,-10,"0,-20"
22117,720575940631049291,right,Tm9,198,6,2,-5,7,"6,2"
22118,720575940623587939,right,Tm9,199,0,-12,-6,-6,"0,-12"
22119,720575940621711128,right,Tm9,200,-5,12,11,1,"-5,12"
22120,720575940639382131,right,Tm9,201,-8,9,12,-3,"-8,9"
22121,720575940630942551,right,Tm9,202,-1,27,14,13,"-1,27"
22122,720575940642871604,right,Tm9,203,3,-1,-4,3,"3,-1"
22123,720575940642371981,right,Tm9,204,5,-2,-6,4,"5,-2"
22124,720575940640435152,right,Tm9,205,5,-6,-8,2,"5,-6"
22125,720575940618689950,right,Tm9,206,-3,5,5,0,"-3,5"
22126,720575940616384742,right,Tm9,207,1,29,13,16,"1,29"
22127,720575940614705319,right,Tm9,208,5,-21,-16,-5,"5,-21"
22128,720575940620285861,right,Tm9,209,-3,-8,-1,-7,"-3,-8"
22129,720575940612782899,right,Tm9,210,-6,8,10,-2,"-6,8"
22130,720575940621360349,right,Tm9,211,-7,-1,6,-7,"-7,-1"
22131,720575940627174415,right,Tm9,212,2,-16,-10,-6,"2,-16"
22132,720575940626344510,right,Tm9,213,3,-4,-5,1,"3,-4"
22133,720575940621683494,right,Tm9,214,-5,3,6,-3,"-5,3"
22134,720575940621218324,right,Tm9,215,6,7,-3,10,"6,7"
22135,720575940624613680,right,Tm9,216,2,19,7,12,"2,19"
22136,720575940623720842,right,Tm9,217,6,15,1,14,"6,15"
22137,720575940620083280,right,Tm9,218,2,10,3,7,"2,10"
22138,720575940608690443,right,Tm9,219,6,-4,-8,4,"6,-4"
22139,720575940637834867,right,Tm9,220,2,-6,-5,-1,"2,-6"
22140,720575940609437653,right,Tm9,221,-7,3,8,-5,"-7,3"
22141,720575940625006855,right,Tm9,222,-3,26,16,10,"-3,26"
22142,720575940619959472,right,Tm9,223,-2,26,15,11,"-2,26"
22143,720575940621766365,right,Tm9,224,0,5,2,3,"0,5"
22144,720575940615680874,right,Tm9,225,2,-26,-15,-11,"2,-26"
22145,720575940621678463,right,Tm9,226,5,19,4,15,"5,19"
22146,720575940614270189,right,Tm9,227,-7,5,9,-4,"-7,5"
22147,720575940614233263,right,Tm9,228,-7,1,7,-6,"-7,1"
22148,720575940623444723,right,Tm9,229,5,2,-4,6,"5,2"
22149,720575940631542646,right,Tm9,230,2,9,2,7,"2,9"
22150,720575940622667784,right,Tm9,231,4,-12,-10,-2,"4,-12"
22151,720575940647437108,right,Tm9,232,-4,13,10,3,"-4,13"
22152,720575940619784545,right,Tm9,233,4,-13,-11,-2,"4,-13"
22153,720575940642842676,right,Tm9,234,1,3,0,3,"1,3"
22154,720575940608543580,right,Tm9,235,4,11,1,10,"4,11"
22155,720575940620550491,right,Tm9,236,-1,4,3,1,"-1,4"
22156,720575940628857387,right,Tm9,237,-2,27,15,12,"-2,27"
22157,720575940619813217,right,Tm9,238,-8,-3,6,-9,"-8,-3"
22158,720575940632014673,right,Tm9,239,-6,6,9,-3,"-6,6"
22159,720575940626401869,right,Tm9,240,-4,-3,2,-5,"-4,-3"
22160,720575940605783584,right,Tm9,241,2,-17,-11,-6,"2,-17"
22161,720575940613618216,right,Tm9,242,-4,6,7,-1,"-4,6"
22162,720575940610726776,right,Tm9,243,-1,-21,-10,-11,"-1,-21"
22163,720575940624063669,right,Tm9,244,-4,-12,-2,-10,"-4,-12"
22164,720575940639983192,right,Tm9,245,-5,-3,3,-6,"-5,-3"
22165,720575940625769418,right,Tm9,246,-4,15,11,4,"-4,15"
22166,720575940638641478,right,Tm9,247,-4,-15,-4,-11,"-4,-15"
22167,720575940614527594,right,Tm9,248,-6,0,6,-6,"-6,0"
22168,720575940629511874,right,Tm9,249,2,-12,-8,-4,"2,-12"
22169,720575940641625741,right,Tm9,250,-1,1,1,0,"-1,1"
22170,720575940608295433,right,Tm9,251,-1,-14,-6,-8,"-1,-14"
22171,720575940634666847,right,Tm9,252,3,23,8,15,"3,23"
22172,720575940618549061,right,Tm9,253,5,16,3,13,"5,16"
22173,720575940605128550,right,Tm9,254,3,-24,-15,-9,"3,-24"
22174,720575940616141785,right,Tm9,255,-6,-13,-1,-12,"-6,-13"
22175,720575940631087311,right,Tm9,256,5,-20,-15,-5,"5,-20"
22176,720575940623573292,right,Tm9,257,2,21,8,13,"2,21"
22177,720575940620433345,right,Tm9,258,-4,-17,-5,-12,"-4,-17"
22178,720575940635742063,right,Tm9,259,-7,-5,4,-9,"-7,-5"
22179,720575940637854015,right,Tm9,260,-3,19,12,7,"-3,19"
22180,720575940627291578,right,Tm9,261,-1,13,7,6,"-1,13"
22181,720575940602880736,right,Tm9,262,1,-11,-7,-4,"1,-11"
22182,720575940628821520,right,Tm9,263,-3,4,5,-1,"-3,4"
22183,720575940612908054,right,Tm9,264,-1,-6,-2,-4,"-1,-6"
22184,720575940630105964,right,Tm9,265,-6,-1,5,-6,"-6,-1"
22185,720575940616575500,right,Tm9,266,-1,-25,-12,-13,"-1,-25"
22186,720575940616595515,right,Tm9,267,-6,2,7,-5,"-6,2"
22187,720575940640563315,right,Tm9,268,7,-6,-10,4,"7,-6"
22188,720575940644891927,right,Tm9,269,2,-19,-12,-7,"2,-19"
22189,720575940635266411,right,Tm9,270,1,-8,-5,-3,"1,-8"
22190,720575940642701876,right,Tm9,272,3,-2,-4,2,"3,-2"
22191,720575940626258874,right,Tm9,273,-6,23,17,6,"-6,23"
22192,720575940642562267,right,Tm9,274,6,4,-4,8,"6,4"
22193,720575940629900252,right,Tm9,275,-8,-1,7,-8,"-8,-1"
22194,720575940633538771,right,Tm9,276,2,3,-1,4,"2,3"
22195,720575940630462684,right,Tm9,277,7,-3,-9,6,"7,-3"
22196,720575940629851514,right,Tm9,278,-5,10,10,0,"-5,10"
22197,720575940614667462,right,Tm9,279,-4,8,8,0,"-4,8"
22198,720575940626579087,right,Tm9,280,-6,-14,-1,-13,"-6,-14"
22199,720575940636216553,right,Tm9,281,-9,2,10,-8,"-9,2"
22200,720575940626578965,right,Tm9,282,0,26,13,13,"0,26"
22201,720575940622802695,right,Tm9,283,-4,4,6,-2,"-4,4"
22202,720575940626242348,right,Tm9,284,0,25,12,13,"0,25"
22203,720575940635924190,right,Tm9,285,6,-18,-15,-3,"6,-18"
22204,720575940632783673,right,Tm9,286,0,-24,-12,-12,"0,-24"
22205,720575940630963275,right,Tm9,287,-5,13,11,2,"-5,13"
22206,720575940655683489,right,Tm9,288,-1,30,16,14,"-1,30"
22207,720575940623472068,right,Tm9,291,7,2,-6,8,"7,2"
22208,720575940621810949,right,Tm9,292,-4,18,13,5,"-4,18"
22209,720575940621604822,right,Tm9,293,4,-17,-13,-4,"4,-17"
22210,720575940627284666,right,Tm9,294,1,-20,-11,-9,"1,-20"
22211,720575940616813142,right,Tm9,295,-2,29,16,13,"-2,29"
22212,720575940621703920,right,Tm9,296,1,-18,-10,-8,"1,-18"
22213,720575940637504653,right,Tm9,297,7,-9,-12,3,"7,-9"
22214,720575940619699068,right,Tm9,298,-5,5,7,-2,"-5,5"
22215,720575940642273677,right,Tm9,299,-4,12,10,2,"-4,12"
22216,720575940627067919,right,Tm9,300,4,-18,-13,-5,"4,-18"
22217,720575940618076902,right,Tm9,301,-5,16,13,3,"-5,16"
22218,720575940609274563,right,Tm9,302,2,17,6,11,"2,17"
22219,720575940615972294,right,Tm9,303,-5,22,16,6,"-5,22"
22220,720575940619717872,right,Tm9,305,-7,4,9,-5,"-7,4"
22221,720575940616246228,right,Tm9,307,5,-25,-18,-7,"5,-25"
22222,720575940643781320,right,Tm9,308,-5,8,9,-1,"-5,8"
22223,720575940652963830,right,Tm9,309,-6,12,12,0,"-6,12"
22224,720575940629892663,right,Tm9,310,2,22,9,13,"2,22"
22225,720575940637446990,right,Tm9,311,-7,15,14,1,"-7,15"
22226,720575940603557920,right,Tm9,312,4,-7,-8,1,"4,-7"
22227,720575940638124265,right,Tm9,313,7,3,-6,9,"7,3"
22228,720575940624407740,right,Tm9,314,-9,5,11,-6,"-9,5"
22229,720575940629678718,right,Tm9,315,-3,-6,0,-6,"-3,-6"
22230,720575940623803114,right,Tm9,316,5,-4,-7,3,"5,-4"
22231,720575940626513173,right,Tm9,317,-5,-4,3,-7,"-5,-4"
22232,720575940627086863,right,Tm9,318,4,-19,-14,-5,"4,-19"
22233,720575940608983235,right,Tm9,319,-2,5,4,1,"-2,5"
22234,720575940632157711,right,Tm9,320,-2,-5,-1,-4,"-2,-5"
22235,720575940620641300,right,Tm9,322,2,26,11,15,"2,26"
22236,720575940632133516,right,Tm9,323,-7,-13,0,-13,"-7,-13"
22237,720575940621952392,right,Tm9,324,3,24,9,15,"3,24"
22238,720575940638320256,right,Tm9,325,5,1,-5,6,"5,1"
22239,720575940614703522,right,Tm9,326,2,16,6,10,"2,16"
22240,720575940622198652,right,Tm9,327,5,3,-4,7,"5,3"
22241,720575940638358643,right,Tm9,328,5,-9,-10,1,"5,-9"
22242,720575940610056654,right,Tm9,329,0,24,12,12,"0,24"
22243,720575940630537078,right,Tm9,330,3,3,-2,5,"3,3"
22244,720575940617931604,right,Tm9,331,1,-15,-9,-6,"1,-15"
22245,720575940629799362,right,Tm9,332,4,-26,-17,-9,"4,-26"
22246,720575940635762842,right,Tm9,333,0,-21,-11,-10,"0,-21"
22247,720575940604668094,right,Tm9,334,1,-26,-14,-12,"1,-26"
22248,720575940621336173,right,Tm9,335,2,8,2,6,"2,8"
22249,720575940625797936,right,Tm9,336,0,23,11,12,"0,23"
22250,720575940617561017,right,Tm9,337,-5,-6,2,-8,"-5,-6"
22251,720575940622600644,right,Tm9,338,-1,0,1,-1,"-1,0"
22252,720575940618836737,right,Tm9,339,6,11,-1,12,"6,11"
22253,720575940628945640,right,Tm9,340,-4,17,12,5,"-4,17"
22254,720575940607251292,right,Tm9,341,6,-17,-15,-2,"6,-17"
22255,720575940627250532,right,Tm9,342,2,-15,-10,-5,"2,-15"
22256,720575940615223199,right,Tm9,343,-3,27,16,11,"-3,27"
22257,720575940618326875,right,Tm9,344,-2,-15,-6,-9,"-2,-15"
22258,720575940627437327,right,Tm9,345,3,-12,-9,-3,"3,-12"
22259,720575940615018146,right,Tm9,346,-7,-9,2,-11,"-7,-9"
22260,720575940620570715,right,Tm9,347,-5,-13,-2,-11,"-5,-13"
22261,720575940629010947,right,Tm9,348,3,14,4,10,"3,14"
22262,720575940626521820,right,Tm9,349,-5,-14,-2,-12,"-5,-14"
22263,720575940633455052,right,Tm9,350,1,15,6,9,"1,15"
22264,720575940631675693,right,Tm9,351,-1,-17,-8,-9,"-1,-17"
22265,720575940622104745,right,Tm9,352,-2,28,16,12,"-2,28"
22266,720575940621054324,right,Tm9,353,2,24,10,14,"2,24"
22267,720575940611501154,right,Tm9,354,-2,-26,-11,-15,"-2,-26"
22268,720575940636474286,right,Tm9,355,-7,-6,4,-10,"-7,-6"
22269,720575940637539806,right,Tm9,356,0,22,11,11,"0,22"
22270,720575940623166669,right,Tm9,357,4,17,4,13,"4,17"
22271,720575940626292226,right,Tm9,358,-3,17,11,6,"-3,17"
22272,720575940621012929,right,Tm9,359,2,23,9,14,"2,23"
22273,720575940627300485,right,Tm9,360,-5,19,14,5,"-5,19"
22274,720575940610477688,right,Tm9,361,0,-7,-4,-3,"0,-7"
22275,720575940624548332,right,Tm9,362,2,-20,-12,-8,"2,-20"
22276,720575940618334001,right,Tm9,363,7,-4,-9,5,"7,-4"
22277,720575940632399119,right,Tm9,364,4,4,-2,6,"4,4"
22278,720575940627658259,right,Tm9,365,4,7,-1,8,"4,7"
22279,720575940612568549,right,Tm9,366,-5,-20,-5,-15,"-5,-20"
22280,720575940632526244,right,Tm9,367,-6,-15,-2,-13,"-6,-15"
22281,720575940621398237,right,Tm9,368,-4,-20,-6,-14,"-4,-20"
22282,720575940624427498,right,Tm9,369,5,-5,-8,3,"5,-5"
22283,720575940626912556,right,Tm9,370,-3,21,13,8,"-3,21"
22284,720575940616958347,right,Tm9,371,6,-5,-9,4,"6,-5"
22285,720575940613140442,right,Tm9,372,1,-2,-2,0,"1,-2"
22286,720575940624154355,right,Tm9,373,1,-21,-12,-9,"1,-21"
22287,720575940619301766,right,Tm9,374,2,13,4,9,"2,13"
22288,720575940625164076,right,Tm9,375,-6,7,9,-2,"-6,7"
22289,720575940617341657,right,Tm9,376,-7,-10,2,-12,"-7,-10"
22290,720575940637762879,right,Tm9,378,-3,18,12,6,"-3,18"
22291,720575940633269971,right,Tm9,379,3,-17,-12,-5,"3,-17"
22292,720575940612563891,right,Tm9,380,-1,29,15,14,"-1,29"
22293,720575940634679191,right,Tm9,381,-8,-9,3,-12,"-8,-9"
22294,720575940620189934,right,Tm9,382,3,-6,-6,0,"3,-6"
22295,720575940629083215,right,Tm9,383,-6,11,11,0,"-6,11"
22296,720575940608057353,right,Tm9,384,-6,-2,5,-7,"-6,-2"
22297,720575940617315033,right,Tm9,385,-3,-18,-6,-12,"-3,-18"
22298,720575940620053707,right,Tm9,386,-6,19,15,4,"-6,19"
22299,720575940623045133,right,Tm9,387,-1,-15,-7,-8,"-1,-15"
22300,720575940630497986,right,Tm9,388,3,19,6,13,"3,19"
22301,720575940637324870,right,Tm9,389,-6,-16,-2,-14,"-6,-16"
22302,720575940624783335,right,Tm9,390,-6,-9,1,-10,"-6,-9"
22303,720575940618439478,right,Tm9,391,4,-3,-6,3,"4,-3"
22304,720575940610307886,right,Tm9,392,-4,7,7,0,"-4,7"
22305,720575940630041615,right,Tm9,394,-7,-8,3,-11,"-7,-8"
22306,720575940632810797,right,Tm9,395,0,-22,-11,-11,"0,-22"
22307,720575940646534254,right,Tm9,396,-1,10,6,4,"-1,10"
22308,720575940625443315,right,Tm9,397,-3,-19,-7,-12,"-3,-19"
22309,720575940626196456,right,Tm9,398,-3,22,14,8,"-3,22"
22310,720575940629865015,right,Tm9,399,-4,-24,-8,-16,"-4,-24"
22311,720575940609981123,right,Tm9,401,-2,-19,-8,-11,"-2,-19"
22312,720575940613445101,right,Tm9,402,3,26,10,16,"3,26"
22313,720575940610735970,right,Tm9,403,-2,-12,-4,-8,"-2,-12"
22314,720575940638007642,right,Tm9,404,-1,20,11,9,"-1,20"
22315,720575940613338341,right,Tm9,405,3,10,2,8,"3,10"
22316,720575940639136701,right,Tm9,406,1,-25,-14,-11,"1,-25"
22317,720575940627600271,right,Tm9,407,-5,-10,0,-10,"-5,-10"
22318,720575940632200007,right,Tm9,408,-6,-4,4,-8,"-6,-4"
22319,720575940616487099,right,Tm9,409,0,-3,-2,-1,"0,-3"
22320,720575940612487405,right,Tm9,410,-2,-2,1,-3,"-2,-2"
22321,720575940612551141,right,Tm9,411,-5,-19,-5,-14,"-5,-19"
22322,720575940616191572,right,Tm9,412,-6,21,16,5,"-6,21"
22323,720575940604494694,right,Tm9,413,-2,-7,-2,-5,"-2,-7"
22324,720575940623176233,right,Tm9,414,4,21,6,15,"4,21"
22325,720575940637631333,right,Tm9,415,6,12,0,12,"6,12"
22326,720575940604080318,right,Tm9,416,3,-8,-7,-1,"3,-8"
22327,720575940634532247,right,Tm9,417,-6,-10,1,-11,"-6,-10"
22328,720575940628430065,right,Tm9,418,-2,15,9,6,"-2,15"
22329,720575940606996354,right,Tm9,419,-3,-11,-3,-8,"-3,-11"
22330,720575940641389275,right,Tm9,420,6,-3,-8,5,"6,-3"
22331,720575940631182592,right,Tm9,421,-1,12,7,5,"-1,12"
22332,720575940626174522,right,Tm9,422,-7,-4,5,-9,"-7,-4"
22333,720575940619831499,right,Tm9,423,3,-18,-12,-6,"3,-18"
22334,720575940608800451,right,Tm9,424,-3,-2,2,-4,"-3,-2"
22335,720575940623338474,right,Tm9,426,-3,0,3,-3,"-3,0"
22336,720575940620358253,right,Tm9,427,5,-18,-14,-4,"5,-18"
22337,720575940613033907,right,Tm9,428,-2,23,13,10,"-2,23"
22338,720575940617429131,right,Tm9,429,-2,14,9,5,"-2,14"
22339,720575940622199688,right,Tm9,430,-3,-7,-1,-6,"-3,-7"
22340,720575940617451409,right,Tm9,431,-2,-10,-3,-7,"-2,-10"
22341,720575940614323106,right,Tm9,432,-5,7,8,-1,"-5,7"
22342,720575940626471196,right,Tm9,433,0,-8,-4,-4,"0,-8"
22343,720575940625199900,right,Tm9,434,-3,7,6,1,"-3,7"
22344,720575940623784940,right,Tm9,435,5,-17,-14,-3,"5,-17"
22345,720575940635858544,right,Tm9,436,0,-15,-8,-7,"0,-15"
22346,720575940627095340,right,Tm9,437,-3,12,9,3,"-3,12"
22347,720575940612568499,right,Tm9,438,2,27,11,16,"2,27"
22348,720575940614599318,right,Tm9,439,-3,-9,-2,-7,"-3,-9"
22349,720575940621776664,right,Tm9,440,1,23,10,13,"1,23"
22350,720575940659650945,right,Tm9,441,3,-16,-11,-5,"3,-16"
22351,720575940625266616,right,Tm9,442,-5,25,17,8,"-5,25"
22352,720575940626674988,right,Tm9,443,-6,4,8,-4,"-6,4"
22353,720575940623588109,right,Tm9,444,4,-10,-9,-1,"4,-10"
22354,720575940639049038,right,Tm9,445,-2,8,6,2,"-2,8"
22355,720575940632804453,right,Tm9,446,2,-14,-9,-5,"2,-14"
22356,720575940625889155,right,Tm9,447,-1,2,2,0,"-1,2"
22357,720575940624558087,right,Tm9,448,0,30,15,15,"0,30"
22358,720575940616417653,right,Tm9,449,6,-16,-14,-2,"6,-16"
22359,720575940612630130,right,Tm9,450,2,-9,-7,-2,"2,-9"
22360,720575940629612158,right,Tm9,451,4,20,6,14,"4,20"
22361,720575940629904939,right,Tm9,452,1,-9,-6,-3,"1,-9"
22362,720575940605776672,right,Tm9,453,3,25,9,16,"3,25"
22363,720575940630818422,right,Tm9,454,5,-12,-11,-1,"5,-12"
22364,720575940637127053,right,Tm9,455,7,-7,-11,4,"7,-7"
22365,720575940614704290,right,Tm9,456,0,21,10,11,"0,21"
22366,720575940613881775,right,Tm9,457,-2,17,10,7,"-2,17"
22367,720575940638538804,right,Tm9,458,5,0,-5,5,"5,0"
22368,720575940614368175,right,Tm9,459,5,-3,-7,4,"5,-3"
22369,720575940636791386,right,Tm9,460,-3,-20,-7,-13,"-3,-20"
22370,720575940617452774,right,Tm9,461,7,-5,-10,5,"7,-5"
22371,720575940635391480,right,Tm9,462,-1,18,10,8,"-1,18"
22372,720575940605922993,right,Tm9,463,5,17,3,14,"5,17"
22373,720575940648050553,right,Tm9,464,4,0,-4,4,"4,0"
22374,720575940607121794,right,Tm9,465,3,0,-3,3,"3,0"
22375,720575940629750844,right,Tm9,466,1,14,6,8,"1,14"
22376,720575940626223716,right,Tm9,467,-2,-20,-8,-12,"-2,-20"
22377,720575940621687073,right,Tm9,468,-3,11,8,3,"-3,11"
22378,720575940629424254,right,Tm9,469,-7,13,13,0,"-7,13"
22379,720575940637255821,right,Tm9,470,4,-9,-9,0,"4,-9"
22380,720575940649782393,right,Tm9,471,3,-26,-16,-10,"3,-26"
22381,720575940626254892,right,Tm9,472,1,25,11,14,"1,25"
22382,720575940618034747,right,Tm9,473,-4,23,15,8,"-4,23"
22383,720575940622056572,right,Tm9,474,-3,-17,-6,-11,"-3,-17"
22384,720575940614678431,right,Tm9,475,-4,-1,3,-4,"-4,-1"
22385,720575940614557708,right,Tm9,476,-1,15,8,7,"-1,15"
22386,720575940626614202,right,Tm9,477,-3,2,4,-2,"-3,2"
22387,720575940625942372,right,Tm9,479,-2,10,7,3,"-2,10"
22388,720575940633285739,right,Tm9,480,3,-19,-13,-6,"3,-19"
22389,720575940637612429,right,Tm9,481,4,-8,-8,0,"4,-8"
22390,720575940640252800,right,Tm9,482,1,17,7,10,"1,17"
22391,720575940631685587,right,Tm9,483,2,-7,-6,-1,"2,-7"
22392,720575940625142525,right,Tm9,484,3,-9,-8,-1,"3,-9"
22393,720575940606093490,right,Tm9,485,-3,-3,1,-4,"-3,-3"
22394,720575940639565475,right,Tm9,486,0,1,0,1,"0,1"
22395,720575940600084489,right,Tm9,487,1,-1,-2,1,"1,-1"
22396,720575940634829463,right,Tm9,488,7,5,-5,10,"7,5"
22397,720575940610985058,right,Tm9,489,-3,10,8,2,"-3,10"
22398,720575940631531562,right,Tm9,490,-5,6,8,-2,"-5,6"
22399,720575940609255875,right,Tm9,491,7,-1,-8,7,"7,-1"
22400,720575940617372673,right,Tm9,492,-7,-2,6,-8,"-7,-2"
22401,720575940623180799,right,Tm9,493,-3,23,14,9,"-3,23"
22402,720575940624565296,right,Tm9,494,0,29,14,15,"0,29"
22403,720575940645555252,right,Tm9,497,6,1,-6,7,"6,1"
22404,720575940622440150,right,Tm9,498,6,10,-1,11,"6,10"
22405,720575940622466584,right,Tm9,499,5,10,0,10,"5,10"
22406,720575940618751312,right,Tm9,500,7,-8,-11,3,"7,-8"
22407,720575940625428286,right,Tm9,501,1,2,0,2,"1,2"
22408,720575940617618971,right,Tm9,502,5,8,-1,9,"5,8"
22409,720575940617251387,right,Tm9,503,3,17,5,12,"3,17"
22410,720575940626440492,right,Tm9,504,-2,9,6,3,"-2,9"
22411,720575940634615959,right,Tm9,506,1,-12,-7,-5,"1,-12"
22412,720575940628004358,right,Tm9,507,-5,-12,-1,-11,"-5,-12"
22413,720575940638769990,right,Tm9,508,-5,11,10,1,"-5,11"
22414,720575940618650166,right,Tm9,509,-4,10,9,1,"-4,10"
22415,720575940609620747,right,Tm9,510,-2,11,7,4,"-2,11"
22416,720575940627331599,right,Tm9,511,5,-11,-11,0,"5,-11"
22417,720575940641658676,right,Tm9,512,6,0,-6,6,"6,0"
22418,720575940615494303,right,Tm9,513,-4,-13,-3,-10,"-4,-13"
22419,720575940606796489,right,Tm9,514,-4,-10,-1,-9,"-4,-10"
22420,720575940622139844,right,Tm9,515,-8,-7,4,-11,"-8,-7"
22421,720575940622687751,right,Tm9,516,7,-18,-16,-2,"7,-18"
22422,720575940630712151,right,Tm9,518,-4,22,15,7,"-4,22"
22423,720575940630130176,right,Tm9,519,-5,-5,2,-7,"-5,-5"
22424,720575940634424056,right,Tm9,520,-2,-22,-9,-13,"-2,-22"
22425,720575940616225209,right,Tm9,521,6,-9,-11,2,"6,-9"
22426,720575940630811723,right,Tm9,522,-4,0,4,-4,"-4,0"
22427,720575940617414585,right,Tm9,523,2,14,5,9,"2,14"
22428,720575940626393858,right,Tm9,524,4,-20,-14,-6,"4,-20"
22429,720575940620955201,right,Tm9,525,-1,-20,-9,-11,"-1,-20"
22430,720575940633880415,right,Tm9,526,0,-10,-5,-5,"0,-10"
22431,720575940628551680,right,Tm9,527,-4,-8,0,-8,"-4,-8"
22432,720575940614972839,right,Tm9,528,2,7,1,6,"2,7"
22433,720575940642834740,right,Tm9,529,2,-2,-3,1,"2,-2"
22434,720575940627300618,right,Tm9,530,-3,-13,-4,-9,"-3,-13"
22435,720575940618883032,right,Tm9,531,1,0,-1,1,"1,0"
22436,720575940645275939,right,Tm9,532,-8,7,11,-4,"-8,7"
22437,720575940639142589,right,Tm9,533,0,-16,-8,-8,"0,-16"
22438,720575940636669582,right,Tm9,534,3,2,-2,4,"3,2"
22439,720575940629591930,right,Tm9,535,8,-4,-10,6,"8,-4"
22440,720575940638409700,right,Tm9,536,3,4,-1,5,"3,4"
22441,720575940636288887,right,Tm9,537,0,-23,-12,-11,"0,-23"
22442,720575940605480369,right,Tm9,538,-4,1,4,-3,"-4,1"
22443,720575940633810367,right,Tm9,539,-6,15,13,2,"-6,15"
22444,720575940660103553,right,Tm9,540,-2,-9,-3,-6,"-2,-9"
22445,720575940620204422,right,Tm9,541,-4,14,11,3,"-4,14"
22446,720575940620470187,right,Tm9,542,6,-13,-13,0,"6,-13"
22447,720575940638027965,right,Tm9,543,-1,-4,-1,-3,"-1,-4"
22448,720575940632920621,right,Tm9,544,3,-13,-10,-3,"3,-13"
22449,720575940627182327,right,Tm9,545,5,11,0,11,"5,11"
22450,720575940612052578,right,Tm9,546,3,6,0,6,"3,6"
22451,720575940618287064,right,Tm9,547,-1,21,11,10,"-1,21"
22452,720575940608822281,right,Tm9,548,1,-16,-9,-7,"1,-16"
22453,720575940623302035,right,Tm9,549,0,-9,-5,-4,"0,-9"
22454,720575940618481733,right,Tm9,550,-2,3,3,0,"-2,3"
22455,720575940607889609,right,Tm9,551,-4,-9,-1,-8,"-4,-9"
22456,720575940623866556,right,Tm9,552,4,-1,-5,4,"4,-1"
22457,720575940640670928,right,Tm9,553,-3,16,11,5,"-3,16"
22458,720575940639951182,right,Tm9,554,-9,-3,7,-10,"-9,-3"
22459,720575940631777676,right,Tm9,555,-4,9,8,1,"-4,9"
22460,720575940639044942,right,Tm9,557,6,-10,-11,1,"6,-10"
22461,720575940632179783,right,Tm9,558,-4,-21,-7,-14,"-4,-21"
22462,720575940621485739,right,Tm9,559,-6,22,17,5,"-6,22"
22463,720575940640962805,right,Tm9,560,-7,14,14,0,"-7,14"
22464,720575940608058889,right,Tm9,562,-5,-2,4,-6,"-5,-2"
22465,720575940623320873,right,Tm9,563,5,-13,-12,-1,"5,-13"
22466,720575940625753744,right,Tm9,564,3,-23,-15,-8,"3,-23"
22467,720575940639690301,right,Tm9,565,0,-26,-13,-13,"0,-26"
22468,720575940620030633,right,Tm9,566,5,-8,-9,1,"5,-8"
22469,720575940630186571,right,Tm9,567,-2,22,13,9,"-2,22"
22470,720575940632118668,right,Tm9,568,-6,-8,2,-10,"-6,-8"
22471,720575940623115213,right,Tm9,570,2,25,10,15,"2,25"
22472,720575940626804825,right,Tm9,571,0,-14,-7,-7,"0,-14"
22473,720575940615404812,right,Tm9,572,-8,3,9,-6,"-8,3"
22474,720575940618170653,right,Tm9,573,4,14,3,11,"4,14"
22475,720575940645592628,right,Tm9,574,-6,5,8,-3,"-6,5"
22476,720575940625477507,right,Tm9,575,6,9,-2,11,"6,9"
22477,720575940630425564,right,Tm9,576,0,28,14,14,"0,28"
22478,720575940627273487,right,Tm9,577,5,-14,-12,-2,"5,-14"
22479,720575940628133864,right,Tm9,578,4,-11,-10,-1,"4,-11"
22480,720575940632968860,right,Tm9,579,-3,-10,-2,-8,"-3,-10"
22481,720575940620002068,right,Tm9,580,-2,-23,-10,-13,"-2,-23"
22482,720575940629942019,right,Tm9,581,3,9,1,8,"3,9"
22483,720575940620680277,right,Tm9,582,-1,23,12,11,"-1,23"
22484,720575940626710799,right,Tm9,583,3,-25,-16,-9,"3,-25"
22485,720575940620597586,right,Tm9,584,4,23,7,16,"4,23"
22486,720575940624500372,right,Tm9,585,-1,-23,-11,-12,"-1,-23"
22487,720575940630702188,right,Tm9,586,2,18,7,11,"2,18"
22488,720575940637867241,right,Tm9,587,4,22,7,15,"4,22"
22489,720575940615329602,right,Tm9,588,1,4,1,3,"1,4"
22490,720575940632411410,right,Tm9,589,-1,-5,-2,-3,"-1,-5"
22491,720575940624348100,right,Tm9,590,1,9,3,6,"1,9"
22492,720575940639766606,right,Tm9,591,3,-3,-5,2,"3,-3"
22493,720575940614473011,right,Tm9,592,3,-28,-17,-11,"3,-28"
22494,720575940645130775,right,Tm9,593,3,-14,-10,-4,"3,-14"
22495,720575940613268915,right,Tm9,594,7,-16,-15,-1,"7,-16"
22496,720575940627055204,right,Tm9,595,7,-12,-13,1,"7,-12"
22497,720575940611805845,right,Tm9,596,-4,-16,-4,-12,"-4,-16"
22498,720575940628564042,right,Tm9,597,4,1,-4,5,"4,1"
22499,720575940631817539,right,Tm9,598,2,-18,-11,-7,"2,-18"
22500,720575940608683017,right,Tm9,600,3,-10,-8,-2,"3,-10"
22501,720575940632870701,right,Tm9,601,1,16,7,9,"1,16"
22502,720575940615785834,right,Tm9,602,4,-2,-5,3,"4,-2"
22503,720575940608677641,right,Tm9,603,-3,-23,-9,-14,"-3,-23"
22504,720575940623374377,right,Tm9,604,-6,-17,-3,-14,"-6,-17"
22505,720575940628445425,right,Tm9,605,3,15,4,11,"3,15"
22506,720575940636694117,right,Tm9,606,-1,-19,-9,-10,"-1,-19"
22507,720575940632532536,right,Tm9,607,1,18,8,10,"1,18"
22508,720575940612896682,right,Tm9,608,1,10,4,6,"1,10"
22509,720575940612646826,right,Tm9,609,-2,0,2,-2,"-2,0"
22510,720575940622202582,right,Tm9,610,2,-23,-14,-9,"2,-23"
22511,720575940626564964,right,Tm9,611,-1,-18,-8,-10,"-1,-18"
22512,720575940619730590,right,Tm9,612,-3,-26,-10,-16,"-3,-26"
22513,720575940630438850,right,Tm9,613,-8,-4,6,-10,"-8,-4"
22514,720575940629856471,right,Tm9,614,-2,-8,-2,-6,"-2,-8"
22515,720575940627335557,right,Tm9,615,-7,-7,3,-10,"-7,-7"
22516,720575940631324985,right,Tm9,616,-3,15,10,5,"-3,15"
22517,720575940610797010,right,Tm9,617,-2,-17,-7,-10,"-2,-17"
22518,720575940653151649,right,Tm9,618,-1,24,13,11,"-1,24"
22519,720575940623853565,right,Tm9,619,-4,-19,-6,-13,"-4,-19"
22520,720575940617488541,right,Tm9,620,7,1,-7,8,"7,1"
22521,720575940623771061,right,Tm9,621,1,24,11,13,"1,24"
22522,720575940627458618,right,Tm9,622,-5,20,15,5,"-5,20"
22523,720575940635525215,right,Tm9,623,1,13,5,8,"1,13"
22524,720575940612881381,right,Tm9,624,1,-17,-10,-7,"1,-17"
22525,720575940623580659,right,Tm9,625,-2,24,14,10,"-2,24"
22526,720575940645816099,right,Tm9,626,-5,-8,1,-9,"-5,-8"
22527,720575940617188923,right,Tm9,627,0,-1,-1,0,"0,-1"
22528,720575940617634772,right,Tm9,628,0,0,0,0,"0,0"
22529,720575940646766883,right,Tm9,629,4,24,8,16,"4,24"
22530,720575940632645401,right,Tm9,630,4,8,0,8,"4,8"
22531,720575940620814356,right,Tm9,631,1,26,12,14,"1,26"
22532,720575940616591755,right,Tm9,632,3,-20,-13,-7,"3,-20"
22533,720575940607291314,right,Tm9,633,-1,-24,-11,-13,"-1,-24"
22534,720575940618082077,right,Tm9,634,-3,-15,-5,-10,"-3,-15"
22535,720575940635503540,right,Tm9,635,6,-6,-9,3,"6,-6"
22536,720575940628769040,right,Tm9,637,3,-21,-14,-7,"3,-21"
22537,720575940610254275,right,Tm9,638,-1,7,4,3,"-1,7"
22538,720575940641730549,right,Tm9,639,-4,19,13,6,"-4,19"
22539,720575940630679670,right,Tm9,640,-1,-16,-7,-9,"-1,-16"
22540,720575940611350882,right,Tm9,641,-8,-5,5,-10,"-8,-5"
22541,720575940622953485,right,Tm9,642,-5,-11,-1,-10,"-5,-11"
22542,720575940633908194,right,Tm9,643,6,14,1,13,"6,14"
22543,720575940629148145,right,Tm9,644,-6,18,15,3,"-6,18"
22544,720575940633682574,right,Tm9,645,-4,27,17,10,"-4,27"
22545,720575940625744944,right,Tm9,646,6,17,2,15,"6,17"
22546,720575940618268061,right,Tm9,647,-4,-7,0,-7,"-4,-7"
22547,720575940620452544,right,Tm9,648,1,7,2,5,"1,7"
22548,720575940632323640,right,Tm9,650,-3,-25,-10,-15,"-3,-25"
22549,720575940644367396,right,Tm9,651,-4,-5,1,-6,"-4,-5"
22550,720575940635098266,right,Tm9,652,-6,-11,0,-11,"-6,-11"
22551,720575940608856533,right,Tm9,653,-6,-12,0,-12,"-6,-12"
22552,720575940617727645,right,Tm9,654,-3,8,7,1,"-3,8"
22553,720575940623069208,right,Tm9,655,6,-1,-7,6,"6,-1"
22554,720575940617570358,right,Tm9,656,0,-11,-6,-5,"0,-11"
22555,720575940620016464,right,Tm9,657,-2,-25,-11,-14,"-2,-25"
22556,720575940623897066,right,Tm9,658,1,20,9,11,"1,20"
22557,720575940616789734,right,Tm9,659,-4,-6,1,-7,"-4,-6"
22558,720575940628740039,right,Tm9,660,2,28,12,16,"2,28"
22559,720575940627112748,right,Tm9,661,-3,14,10,4,"-3,14"
22560,720575940625520442,right,Tm9,662,2,-1,-3,2,"2,-1"
22561,720575940618568768,right,Tm9,664,1,-27,-15,-12,"1,-27"
22562,720575940650176889,right,Tm9,665,7,-2,-8,6,"7,-2"
22563,720575940621429620,right,Tm9,666,7,-13,-14,1,"7,-13"
22564,720575940628713732,right,Tm9,667,1,-28,-15,-13,"1,-28"
22565,720575940637942837,right,Tm9,668,1,19,8,11,"1,19"
22566,720575940605191340,right,Tm9,669,4,-16,-12,-4,"4,-16"
22567,720575940638900352,right,Tm9,671,-4,-23,-8,-15,"-4,-23"
22568,720575940629531002,right,Tm9,672,-8,11,13,-2,"-8,11"
22569,720575940626923070,right,Tm9,673,2,5,0,5,"2,5"
22570,720575940630241239,right,Tm9,674,-4,-14,-3,-11,"-4,-14"
22571,720575940621682017,right,Tm9,675,-7,19,16,3,"-7,19"
22572,720575940636607716,right,Tm9,676,-3,-21,-8,-13,"-3,-21"
22573,720575940638132058,right,Tm9,677,0,11,5,6,"0,11"
22574,720575940620974171,right,Tm9,678,3,-7,-7,0,"3,-7"
22575,720575940622028528,right,Tm9,679,4,18,5,13,"4,18"
22576,720575940631934039,right,Tm9,680,-1,25,13,12,"-1,25"
22577,720575940620577518,right,Tm9,681,-2,-21,-9,-12,"-2,-21"
22578,720575940622030106,right,Tm9,682,6,-8,-10,2,"6,-8"
22579,720575940622899745,right,Tm9,683,2,6,1,5,"2,6"
22580,720575940634783898,right,Tm9,684,-6,17,14,3,"-6,17"
22581,720575940632250439,right,Tm9,685,-5,-9,0,-9,"-5,-9"
22582,720575940623640600,right,Tm9,686,5,-22,-16,-6,"5,-22"
22583,720575940618985432,right,Tm9,687,-6,-3,4,-7,"-6,-3"
22584,720575940635241908,right,Tm9,688,-7,10,12,-2,"-7,10"
22585,720575940628279292,right,Tm9,689,-2,18,11,7,"-2,18"
22586,720575940614954143,right,Tm9,690,-7,-3,5,-8,"-7,-3"
22587,720575940614317499,right,Tm9,691,-9,4,11,-7,"-9,4"
22588,720575940629846784,right,Tm9,692,-4,24,16,8,"-4,24"
22589,720575940632747801,right,Tm9,693,-3,25,15,10,"-3,25"
22590,720575940605444966,right,Tm9,695,-6,10,11,-1,"-6,10"
22591,720575940636491877,right,Tm9,696,-2,16,10,6,"-2,16"
22592,720575940604872416,right,Tm9,697,1,-22,-12,-10,"1,-22"
22593,720575940627031570,right,Tm9,698,6,-7,-10,3,"6,-7"
22594,720575940611758834,right,Tm9,699,-5,0,5,-5,"-5,0"
22595,720575940625950245,right,Tm9,700,5,15,2,13,"5,15"
22596,720575940640432848,right,Tm9,701,0,-4,-2,-2,"0,-4"
22597,720575940623285005,right,Tm9,702,-5,23,16,7,"-5,23"
22598,720575940629831806,right,Tm9,703,-3,1,3,-2,"-3,1"
22599,720575940625529232,right,Tm9,704,-7,8,11,-3,"-7,8"
22600,720575940610175381,right,Tm9,705,1,1,-1,2,"1,1"
22601,720575940626245676,right,Tm9,707,-2,25,14,11,"-2,25"
22602,720575940627272122,right,Tm9,708,-4,-25,-9,-16,"-4,-25"
22603,720575940606551217,right,Tm9,709,-2,-24,-10,-14,"-2,-24"
22604,720575940634071659,right,Tm9,710,4,-25,-17,-8,"4,-25"
22605,720575940627687496,right,Tm9,711,-1,19,10,9,"-1,19"
22606,720575940630610852,right,Tm9,712,-7,12,13,-1,"-7,12"
22607,720575940625959610,right,Tm9,713,-6,16,14,2,"-6,16"
22608,720575940612125914,right,Tm9,714,5,12,1,11,"5,12"
22609,720575940618919837,right,Tm9,715,4,10,1,9,"4,10"
22610,720575940619897680,right,Tm9,716,4,-6,-7,1,"4,-6"
22611,720575940635672500,right,Tm9,717,2,-22,-13,-9,"2,-22"
22612,720575940623610867,right,Tm9,718,-5,24,17,7,"-5,24"
22613,720575940617906589,right,Tm9,719,1,27,12,15,"1,27"
22614,720575940619852397,right,Tm9,720,-5,21,15,6,"-5,21"
22615,720575940634430456,right,Tm9,721,5,13,1,12,"5,13"
22616,720575940612198835,right,Tm9,722,6,-15,-14,-1,"6,-15"
22617,720575940643778208,right,Tm9,723,-2,-11,-4,-7,"-2,-11"
22618,720575940617854420,right,Tm9,724,4,2,-3,5,"4,2"
22619,720575940617043542,right,Tm9,725,-3,-24,-9,-15,"-3,-24"
22620,720575940622926853,right,Tm9,726,2,-28,-16,-12,"2,-28"
22621,720575940625298064,right,Tm9,728,7,12,-1,13,"7,12"
22622,720575940638766720,right,Tm9,729,-3,29,17,12,"-3,29"
22623,720575940624013749,right,Tm9,730,7,0,-7,7,"7,0"
22624,720575940624791596,right,Tm9,731,-6,9,10,-1,"-6,9"
22625,720575940625523856,right,Tm9,732,-3,6,6,0,"-3,6"
22626,720575940620757231,right,Tm9,733,-5,-17,-4,-13,"-5,-17"
22627,720575940629309339,right,Tm9,734,2,0,-2,2,"2,0"
22628,720575940609853963,right,Tm9,735,1,-23,-13,-10,"1,-23"
22629,720575940614212754,right,Tm9,736,-8,1,8,-7,"-8,1"
22630,720575940626345772,right,Tm9,737,0,19,9,10,"0,19"
22631,720575940614207903,right,Tm9,738,-3,13,9,4,"-3,13"
22632,720575940616954297,right,Tm9,739,-7,2,8,-6,"-7,2"
22633,720575940622388458,right,Tm9,740,2,-8,-6,-2,"2,-8"
22634,720575940612371941,right,Tm9,741,-2,-14,-5,-9,"-2,-14"
22635,720575940623070051,right,Tm9,742,-4,11,9,2,"-4,11"
22636,720575940631616975,right,Tm9,743,6,-19,-16,-3,"6,-19"
22637,720575940631729987,right,Tm9,744,-4,25,16,9,"-4,25"
22638,720575940620229467,right,Tm9,746,-3,3,4,-1,"-3,3"
22639,720575940635145241,right,Tm9,747,0,2,1,1,"0,2"
22640,720575940625756208,right,Tm9,748,-4,20,14,6,"-4,20"
22641,720575940621069812,right,Tm9,749,-2,1,2,-1,"-2,1"
22642,720575940608117699,right,Tm9,750,4,-24,-16,-8,"4,-24"
22643,720575940639232575,right,Tm9,751,1,6,2,4,"1,6"
22644,720575940605034161,right,Tm9,752,-2,7,5,2,"-2,7"
22645,720575940625188042,right,Tm9,753,-3,24,15,9,"-3,24"
22646,720575940624511940,right,Tm9,754,-1,-13,-6,-7,"-1,-13"
22647,720575940640152448,right,Tm9,755,4,19,5,14,"4,19"
22648,720575940620627538,right,Tm9,756,5,20,5,15,"5,20"
22649,720575940615440543,right,Tm9,757,0,-6,-3,-3,"0,-6"
22650,720575940625762708,right,Tm9,758,5,-1,-6,5,"5,-1"
22651,720575940617040245,right,Tm9,759,7,14,0,14,"7,14"
22652,720575940659599233,right,Tm9,760,0,17,8,9,"0,17"
22653,720575940631940712,right,Tm9,761,-4,-18,-5,-13,"-4,-18"
22654,720575940624226795,right,Tm9,762,0,14,7,7,"0,14"
22655,720575940627084332,right,Tm9,763,-5,14,12,2,"-5,14"
22656,720575940618837332,right,Tm9,764,-8,-6,5,-11,"-8,-6"
22657,720575940626434348,right,Tm9,765,-3,9,7,2,"-3,9"
22658,720575940622129832,right,Tm9,766,2,-4,-4,0,"2,-4"
22659,720575940613374873,right,Tm9,767,1,28,13,15,"1,28"
22660,720575940624344516,right,Tm9,768,3,5,-1,6,"3,5"
22661,720575940634593436,right,Tm9,769,4,-27,-18,-9,"4,-27"
22662,720575940631295020,right,Tm9,771,3,-27,-17,-10,"3,-27"
22663,720575940612048753,right,Tm9,773,5,-19,-15,-4,"5,-19"
22664,720575940630474307,right,Tm9,775,5,22,6,16,"5,22"
22665,720575940624051381,right,Tm9,776,5,21,5,16,"5,21"
22666,720575940610760312,right,Tm9,777,6,20,4,16,"6,20"
22667,720575940616812315,right,Tm9,778,4,25,8,17,"4,25"
22668,720575940635388607,right,Tm9,779,5,24,7,17,"5,24"
22669,720575940618782797,right,Tm9,780,-6,25,18,7,"-6,25"
22670,720575940612556401,right,Tm9,781,-5,26,18,8,"-5,26"
22671,720575940626113061,right,Tm9,783,-4,28,18,10,"-4,28"
22672,720575940637461934,right,Tm9,784,-4,29,18,11,"-4,29"
22673,720575940629860664,right,Tm9,785,-3,30,18,12,"-3,30"
22674,720575940624614704,right,Tm9,786,-2,30,17,13,"-2,30"
22675,720575940629702699,right,Tm9,787,3,28,11,17,"3,28"
22676,720575940626660298,right,Tm9,788,3,27,10,17,"3,27"
22677,720575940639383349,right,Tm9,789,-3,-27,-11,-16,"-3,-27"
22678,720575940640543603,right,Tm9,790,-2,-27,-12,-15,"-2,-27"
22679,720575940614768179,right,Tm9,791,-1,-28,-13,-15,"-1,-28"
22680,720575940617322101,right,Tm9,792,8,2,-7,9,"8,2"
22681,720575940629639674,right,Tm9,793,8,-6,-11,5,"8,-6"
22682,720575940634654945,right,Tm9,795,6,-21,-17,-4,"6,-21"
22683,720575940616321602,right,Tm9,796,4,26,9,17,"4,26"
